,Date,Year,Country_1,Country_2,Score_1,Score_2,Competition,Location,Elo_Score_Change_1,Elo_Score_Change_2,Elo_Score_New_1,Elo_Score_New_2,Rank_Change_1,Rank_Change_2,Rank_New_1,Rank_New_2,Elo_Score_Before_1,Elo_Score_Before_2,Outcome
0,January 2,2010,Iran,North Korea,1,0,Friendly tournament,in Qatar,12,-12,1646,1543,1,-6,49,79,1634,1555,T1
1,January 2,2010,Qatar,Mali,0,0,Friendly tournament,in Qatar,-3,3,1527,1574,-1,0,83,68,1530,1571,draw
2,January 2,2010,Syria,Zimbabwe,6,0,Friendly,in Malaysia,10,-10,1556,1332,4,-3,73,124,1546,1342,T1
3,January 2,2010,Yemen,Tajikistan,0,1,Friendly,in Yemen,-12,12,1222,1277,-2,2,151,135,1234,1265,T2
4,January 3,2010,Angola,Gambia,1,1,Friendly,in Portugal,-1,1,1445,1395,0,0,101,113,1446,1394,draw
5,January 3,2010,Gabon,Mozambique,1,0,Friendly,in South Africa,7,-7,1540,1420,1,-1,80,107,1533,1427,T1
6,January 4,2010,Egypt,Mali,1,0,Friendly,in the United Arab Emirates,7,-7,1703,1567,0,-2,41,70,1696,1574,T1
7,January 4,2010,Tanzania,Ivory Coast,0,1,Friendly,in Tanzania,-3,3,1342,1764,0,0,120,28,1345,1761,T2
8,January 5,2010,Ghana,Malawi,0,0,Friendly,in Swaziland,-7,7,1679,1364,-1,1,43,118,1686,1357,draw
9,January 6,2010,Bahrain,Hong Kong,4,0,Asian Cup qualifier,in Bahrain,4,-4,1620,1218,0,-2,54,153,1616,1222,T1
10,January 6,2010,Benin,Libya,1,0,Friendly,in Benin,8,-8,1466,1484,2,-2,94,89,1458,1492,T1
11,January 6,2010,China,Syria,0,0,Asian Cup qualifier,in China,-5,5,1540,1561,-3,1,80,72,1545,1556,draw
12,January 6,2010,Gabon,Mozambique,2,0,Friendly,in South Africa,10,-10,1550,1410,5,-2,75,109,1540,1420,T1
13,January 6,2010,Indonesia,Oman,1,2,Asian Cup qualifier,in Indonesia,-8,8,1259,1605,-1,1,138,58,1267,1597,T2
14,January 6,2010,Kuwait,Australia,2,2,Asian Cup qualifier,in Kuwait,11,-11,1487,1779,3,-4,87,23,1476,1790,draw
15,January 6,2010,Lebanon,Vietnam,1,1,Asian Cup qualifier,in Lebanon,2,-2,1227,1361,0,0,150,119,1225,1363,draw
16,January 6,2010,Nigeria,Zambia,0,0,Friendly,in South Africa,-6,6,1742,1503,-3,0,36,86,1748,1497,draw
17,January 6,2010,Singapore,Iran,1,3,Asian Cup qualifier,in Singapore,-18,18,1379,1664,-3,0,115,49,1397,1646,T2
18,January 6,2010,Thailand,Jordan,0,0,Asian Cup qualifier,in Thailand,-6,6,1470,1466,-2,1,92,94,1476,1460,draw
19,January 6,2010,United Arab Emirates,Malaysia,1,0,Asian Cup qualifier,in the United Arab Emirates,5,-5,1403,1168,0,0,111,164,1398,1173,T1
20,January 6,2010,Yemen,Japan,2,3,Asian Cup qualifier,in Yemen,-3,3,1219,1792,0,2,151,18,1222,1789,T2
21,January 7,2010,Ivory Coast,Rwanda,2,0,Friendly,in Tanzania,3,-3,1767,1402,1,-1,27,111,1764,1405,T1
22,January 9,2010,Kenya,Cameroon,1,3,Friendly,in Kenya,-4,4,1335,1779,0,1,122,23,1339,1775,T2
23,January 9,2010,Tunisia,Gambia,1,2,Friendly,in Tunisia,-17,17,1610,1412,-3,3,55,109,1627,1395,T2
24,January 9,2010,Zambia,South Korea,4,2,Friendly,in South Africa,24,-24,1527,1725,3,-4,83,36,1503,1749,T1
25,January 10,2010,Angola,Mali,4,4,African Nations Cup,in Angola,2,-2,1447,1565,1,0,100,70,1445,1567,draw
26,January 11,2010,Burkina Faso,Ivory Coast,0,0,African Nations Cup,in Angola,17,-17,1493,1750,4,-4,87,31,1476,1767,draw
27,January 11,2010,Malawi,Algeria,3,0,African Nations Cup,in Angola,68,-68,1432,1517,13,-21,105,85,1364,1585,T1
28,January 12,2010,Benin,Mozambique,2,2,African Nations Cup,in Angola,-4,4,1462,1414,-2,1,96,110,1466,1410,draw
29,January 12,2010,Egypt,Nigeria,3,1,African Nations Cup,in Angola,42,-42,1745,1700,6,-6,35,41,1703,1742,T1
30,January 13,2010,Gabon,Cameroon,1,0,African Nations Cup,in Angola,39,-39,1589,1740,14,-12,60,35,1550,1779,T1
31,January 13,2010,Tunisia,Zambia,1,1,African Nations Cup,in Angola,-6,6,1604,1533,-3,1,58,81,1610,1527,draw
32,January 14,2010,Algeria,Mali,1,0,African Nations Cup,in Angola,28,-28,1545,1537,9,-11,76,81,1517,1565,T1
33,January 14,2010,Angola,Malawi,2,0,African Nations Cup,in Angola,26,-26,1473,1406,8,-6,92,111,1447,1432,T1
34,January 15,2010,Ivory Coast,Ghana,3,1,African Nations Cup,in Angola,30,-30,1780,1649,7,-6,23,49,1750,1679,T1
35,January 15,2010,Yemen,Kenya,3,1,Friendly,in Yemen,16,-16,1235,1319,3,-4,148,126,1219,1335,T1
36,January 16,2010,Egypt,Mozambique,2,0,African Nations Cup,in Angola,10,-10,1755,1404,3,-2,31,111,1745,1414,T1
37,January 16,2010,Nigeria,Benin,1,0,African Nations Cup,in Angola,10,-10,1710,1452,1,-1,40,98,1700,1462,T1
38,January 16,2010,Taiwan,Philippines,0,0,Friendly,in Taiwan,-5,5,923,821,-1,0,195,205,928,816,draw
39,January 17,2010,Cameroon,Zambia,3,2,African Nations Cup,in Angola,12,-12,1752,1521,3,-2,32,84,1740,1533,T1
40,January 17,2010,Gabon,Tunisia,0,0,African Nations Cup,in Angola,1,-1,1590,1603,0,0,60,58,1589,1604,draw
41,January 17,2010,Thailand,Singapore,1,0,King's Cup,in Thailand,7,-7,1477,1372,1,-1,92,117,1470,1379,T1
42,January 17,2010,Vietnam,China,1,2,Asian Cup qualifier,in Vietnam,-16,16,1345,1556,0,6,119,73,1361,1540,T2
43,January 18,2010,Angola,Algeria,0,0,African Nations Cup,in Angola,-2,2,1471,1547,0,-1,93,78,1473,1545,draw
44,January 18,2010,Mali,Malawi,3,1,African Nations Cup,in Angola,24,-24,1561,1382,10,-4,71,114,1537,1406,T1
45,January 18,2010,South Korea,Finland,2,0,Friendly,in Spain,13,-13,1738,1666,0,-2,36,45,1725,1679,T1
46,January 19,2010,Ghana,Burkina Faso,1,0,African Nations Cup,in Angola,14,-14,1663,1479,0,-3,49,90,1649,1493,T1
47,January 20,2010,Chile,Panama,2,1,Friendly,in Chile,2,-2,1883,1551,0,0,11,75,1881,1553,T1
48,January 20,2010,Egypt,Benin,2,0,African Nations Cup,in Angola,11,-11,1766,1441,3,-4,28,102,1755,1452,T1
49,January 20,2010,Nigeria,Mozambique,3,0,African Nations Cup,in Angola,13,-13,1723,1391,3,-2,37,112,1710,1404,T1
50,January 20,2010,Oman,Sweden,0,1,Friendly,in Oman,-8,8,1597,1781,-1,2,58,23,1605,1773,T2
51,January 20,2010,Thailand,Poland,1,3,King's Cup,in Thailand,-19,19,1458,1652,-4,1,96,50,1477,1633,T2
52,January 20,2010,Yemen,Bahrain,3,0,Asian Cup qualifier,in Yemen,59,-59,1294,1561,15,-17,133,70,1235,1620,T1
53,January 21,2010,Cameroon,Tunisia,2,2,African Nations Cup,in Angola,-10,10,1742,1613,-3,3,35,53,1752,1603,draw
54,January 21,2010,Zambia,Gabon,2,1,African Nations Cup,in Angola,30,-30,1551,1560,9,-13,75,72,1521,1590,T1
55,January 22,2010,South Korea,Latvia,1,0,Friendly,in Spain,6,-6,1744,1564,1,-1,35,67,1738,1570,T1
56,January 23,2010,Poland,Singapore,6,1,King's Cup,in Thailand,10,-10,1662,1362,0,-1,50,118,1652,1372,T1
57,January 23,2010,South Africa,Swaziland,6,2,Friendly,in South Africa,3,-3,1523,1171,0,0,85,163,1520,1174,T1
58,January 23,2010,Syria,Sweden,1,1,Friendly,in Syria,3,-3,1564,1778,2,-2,67,25,1561,1781,draw
59,January 23,2010,United States,Honduras,1,3,Friendly,in the United States,-21,21,1783,1769,-3,5,20,27,1804,1748,T2
60,January 24,2010,Algeria,Ivory Coast,3,2,African Nations Cup,in Angola,40,-40,1587,1740,19,-13,60,36,1547,1780,T1
61,January 24,2010,Angola,Ghana,0,1,African Nations Cup,in Angola,-19,19,1452,1682,-5,6,97,43,1471,1663,T2
62,January 25,2010,Egypt,Cameroon,3,1,African Nations Cup,in Angola,35,-35,1801,1707,11,-5,17,40,1766,1742,T1
63,January 25,2010,Nigeria,Zambia,0,0,African Nations Cup,in Angola,-11,11,1712,1562,-2,5,39,71,1723,1551,draw
64,January 26,2010,Argentina,Costa Rica,3,2,Friendly,in Argentina,3,-3,1899,1701,0,0,7,41,1896,1704,T1
65,January 27,2010,South Africa,Zimbabwe,3,0,Friendly,in South Africa,6,-6,1529,1326,2,0,83,123,1523,1332,T1
66,January 28,2010,Egypt,Algeria,4,0,African Nations Cup,in Angola,21,-21,1822,1566,2,-7,15,67,1801,1587,T1
67,January 28,2010,Ghana,Nigeria,1,0,African Nations Cup,in Angola,27,-27,1709,1685,4,-3,39,42,1682,1712,T1
68,January 30,2010,Nigeria,Algeria,1,0,African Nations Cup,in Angola,17,-17,1702,1549,1,-10,41,77,1685,1566,T1
69,January 31,2010,Egypt,Ghana,1,0,African Nations Cup,in Angola,17,-17,1839,1692,1,-3,14,42,1822,1709,T1
70,January 31,2010,Jamaica,Canada,1,0,Friendly,in Jamaica,7,-7,1629,1600,0,-2,52,57,1622,1607,T1
71,February 2,2010,Japan,Venezuela,0,0,Friendly,in Japan,-5,5,1787,1727,-1,0,19,36,1792,1722,draw
72,February 6,2010,Japan,China,0,0,East Asian Cup,in Japan,-15,15,1772,1571,-7,9,26,66,1787,1556,draw
73,February 7,2010,South Korea,Hong Kong,5,0,East Asian Cup,in Japan,4,-4,1748,1214,2,0,32,153,1744,1218,T1
74,February 10,2010,Argentina,Jamaica,2,1,Friendly tournament,in Argentina,3,-3,1902,1626,0,0,7,52,1899,1629,T1
75,February 10,2010,China,South Korea,3,0,East Asian Cup,in Japan,51,-51,1622,1697,13,-9,53,41,1571,1748,T1
76,February 11,2010,Japan,Hong Kong,3,0,East Asian Cup,in Japan,2,-2,1774,1212,1,-2,25,155,1772,1214,T1
77,February 14,2010,China,Hong Kong,2,0,East Asian Cup,in Japan,5,-5,1627,1207,1,-1,52,156,1622,1212,T1
78,February 14,2010,Japan,South Korea,1,3,East Asian Cup,in Japan,-44,44,1730,1741,-10,8,35,33,1774,1697,T2
79,February 16,2010,Bangladesh,Tajikistan,2,1,Asian Cup qual &amp; Asian Challenge Cup,in Sri Lanka,35,-35,976,1242,2,-9,188,145,941,1277,T1
80,February 16,2010,Sri Lanka,Myanmar,0,4,Asian Cup qual &amp; Asian Challenge Cup,in Sri Lanka,-22,22,912,1211,-5,2,197,156,934,1189,T2
81,February 17,2010,Kosovo,Albania,2,3,Friendly,in Kosovo,-10,10,1379,1497,-2,0,115,87,1389,1487,T2
82,February 17,2010,Kyrgyzstan,India,2,1,Asian Cup qual &amp; Asian Challenge Cup,in Sri Lanka,25,-25,1187,1220,6,-9,159,151,1162,1245,T1
83,February 17,2010,North Korea,Turkmenistan,1,1,Asian Cup qual &amp; Asian Challenge Cup,in Sri Lanka,-12,12,1531,1310,-1,1,82,130,1543,1298,draw
84,February 18,2010,Myanmar,Bangladesh,2,1,Asian Cup qual &amp; Asian Challenge Cup,in Sri Lanka,8,-8,1219,968,4,0,152,188,1211,976,T1
85,February 18,2010,Sri Lanka,Tajikistan,1,3,Asian Cup qual &amp; Asian Challenge Cup,in Sri Lanka,-13,13,899,1255,0,4,197,140,912,1242,T2
86,February 19,2010,Kuwait,Syria,1,1,Friendly,in the United Arab Emirates,2,-2,1489,1562,0,-2,88,70,1487,1564,draw
87,February 19,2010,North Korea,Kyrgyzstan,4,0,Asian Cup qual &amp; Asian Challenge Cup,in Sri Lanka,9,-9,1540,1178,1,-2,81,161,1531,1187,T1
88,February 19,2010,Turkmenistan,India,1,0,Asian Cup qual &amp; Asian Challenge Cup,in Sri Lanka,15,-15,1325,1205,6,-6,124,157,1310,1220,T1
89,February 20,2010,Sri Lanka,Bangladesh,3,0,Asian Cup qual &amp; Asian Challenge Cup,in Sri Lanka,32,-32,931,936,5,-3,192,191,899,968,T1
90,February 20,2010,Tajikistan,Myanmar,3,0,Asian Cup qual &amp; Asian Challenge Cup,in Sri Lanka,31,-31,1286,1188,4,-7,136,158,1255,1219,T1
91,February 21,2010,North Korea,India,3,0,Asian Cup qual &amp; Asian Challenge Cup,in Sri Lanka,9,-9,1549,1196,4,0,77,156,1540,1205,T1
92,February 21,2010,Turkmenistan,Kyrgyzstan,1,0,Asian Cup qual &amp; Asian Challenge Cup,in Sri Lanka,12,-12,1337,1166,2,-4,122,165,1325,1178,T1
93,February 24,2010,Mexico,Bolivia,5,0,Friendly,in the United States,6,-6,1898,1595,0,-2,8,59,1892,1601,T1
94,February 24,2010,North Korea,Myanmar,5,0,Asian Cup qual &amp; Asian Challenge Cup,in Sri Lanka,9,-9,1558,1179,2,-1,75,159,1549,1188,T1
95,February 24,2010,Turkmenistan,Tajikistan,2,0,Asian Cup qual &amp; Asian Challenge Cup,in Sri Lanka,26,-26,1363,1260,4,-2,118,138,1337,1286,T1
96,February 24,2010,United States,El Salvador,2,1,Friendly,in the United States,2,-2,1785,1514,1,0,19,86,1783,1516,T1
97,February 25,2010,Jordan,Azerbaijan,0,2,Friendly,in Jordan,-21,21,1445,1440,-7,4,100,103,1466,1419,T2
98,February 25,2010,Kuwait,Bahrain,4,1,Friendly,in the United Arab Emirates,21,-21,1510,1540,1,-9,87,81,1489,1561,T1
99,February 27,2010,Malaysia,Yemen,1,0,Friendly,in Malaysia,11,-11,1179,1283,5,-2,159,135,1168,1294,T1
100,February 27,2010,North Korea,Turkmenistan,1,1,Asian Cup qual &amp; Asian Challenge Cup,in Sri Lanka,-10,10,1548,1373,-3,1,77,117,1558,1363,draw
101,February 27,2010,Tajikistan,Myanmar,1,0,Asian Cup qual &amp; Asian Challenge Cup,in Sri Lanka,15,-15,1275,1164,2,-6,136,165,1260,1179,T1
102,February 28,2010,Curaçao,Bonaire,4,0,Friendly,in Curaçao,8,-8,1138,992,0,0,171,185,1130,1000,T1
103,March 2,2010,Brazil,Ireland,2,0,Friendly,in England,4,-4,2108,1763,0,0,1,27,2104,1767,T1
104,March 2,2010,Guadeloupe,Saint Kitts and Nevis,2,1,Friendly,in Guadeloupe,2,-2,1471,1137,0,-1,92,171,1469,1139,T1
105,March 3,2010,Albania,Northern Ireland,1,0,Friendly,in Albania,9,-9,1506,1568,1,-2,87,67,1497,1577,T1
106,March 3,2010,Algeria,Serbia,0,3,Friendly,in Algeria,-9,9,1540,1843,-3,1,79,14,1549,1834,T2
107,March 3,2010,Angola,Latvia,1,1,Friendly,in Angola,0,0,1452,1564,-1,-3,97,71,1452,1564,draw
108,March 3,2010,Australia,Indonesia,1,0,Asian Cup qualifier,in Australia,1,-1,1780,1258,1,0,22,139,1779,1259,T1
109,March 3,2010,Austria,Denmark,2,1,Friendly,in Austria,13,-13,1602,1799,4,0,56,17,1589,1812,T1
110,March 3,2010,Belarus,Armenia,3,1,Friendly,in Turkey,7,-7,1589,1373,4,-1,60,115,1582,1380,T1
111,March 3,2010,Belgium,Croatia,0,1,Friendly,in Belgium,-5,5,1582,1893,-4,1,65,9,1587,1888,T2
112,March 3,2010,Bosnia and Herzegovina,Ghana,2,1,Friendly,in Bosnia and Herzegovina,9,-9,1650,1683,0,-1,51,43,1641,1692,T1
113,March 3,2010,Cameroon,Italy,0,0,Friendly,in Monaco,6,-6,1713,1951,1,1,38,5,1707,1957,draw
114,March 3,2010,Cyprus,Iceland,0,0,Friendly,in Cyprus,-6,6,1557,1453,-6,3,75,96,1563,1447,draw
115,March 3,2010,England,Egypt,3,1,Friendly,in England,6,-6,1991,1833,0,-1,4,15,1985,1839,T1
116,March 3,2010,France,Spain,0,2,Friendly,in France,-11,11,1879,2106,-2,0,11,2,1890,2095,T2
117,March 3,2010,Georgia,Estonia,2,1,Friendly,in Georgia,8,-8,1444,1444,3,-5,101,101,1436,1452,T1
118,March 3,2010,Germany,Argentina,0,1,Friendly,in Germany,-14,14,1948,1916,-1,0,6,7,1962,1902,T2
119,March 3,2010,Greece,Senegal,0,2,Friendly,in Greece,-26,26,1757,1571,-8,14,29,66,1783,1545,T2
120,March 3,2010,Guatemala,El Salvador,2,1,Friendly,in the United States,12,-12,1438,1502,2,-2,105,88,1426,1514,T1
121,March 3,2010,Hong Kong,Yemen,0,0,Asian Cup qualifier,in Hong Kong,-1,1,1206,1284,0,0,155,135,1207,1283,draw
122,March 3,2010,Hungary,Russia,1,1,Friendly,in Hungary,4,-4,1615,1848,1,0,54,13,1611,1852,draw
123,March 3,2010,Iran,Thailand,1,0,Asian Cup qualifier,in Iran,6,-6,1670,1452,2,-3,47,97,1664,1458,T1
124,March 3,2010,Japan,Bahrain,2,0,Asian Cup qualifier,in Japan,10,-10,1740,1530,2,0,33,81,1730,1540,T1
125,March 3,2010,Jordan,Singapore,2,1,Asian Cup qualifier,in Jordan,10,-10,1455,1352,6,0,94,119,1445,1362,T1
126,March 3,2010,Libya,Mali,2,1,Friendly,in Libya,9,-9,1493,1552,0,-5,89,77,1484,1561,T1
127,March 3,2010,Luxembourg,Azerbaijan,1,2,Friendly,in Luxembourg,-4,4,1098,1444,0,2,176,101,1102,1440,T2
128,March 3,2010,Macedonia,Montenegro,2,1,Friendly,in Macedonia,10,-10,1586,1656,3,-3,63,49,1576,1666,T1
129,March 3,2010,Malta,Finland,1,2,Friendly,in Malta,-2,2,1217,1668,0,-2,151,48,1219,1666,T2
130,March 3,2010,Mexico,New Zealand,2,0,Friendly,in the United States,3,-3,1901,1526,0,1,8,82,1898,1529,T1
131,March 3,2010,Moldova,Kazakhstan,1,0,Friendly,in Turkey,7,-7,1450,1334,2,-1,99,123,1443,1341,T1
132,March 3,2010,Mozambique,Botswana,0,1,Friendly,in Mozambique,-15,15,1376,1307,-1,1,113,132,1391,1292,T2
133,March 3,2010,Netherlands,United States,2,1,Friendly,in the Netherlands,2,-2,2033,1783,0,-1,3,20,2031,1785,T1
134,March 3,2010,Nigeria,Democratic Republic of Congo,5,2,Friendly,in Nigeria,4,-4,1706,1426,0,-2,40,108,1702,1430,T1
135,March 3,2010,Oman,Kuwait,0,0,Asian Cup qualifier,in Oman,-10,10,1587,1520,-3,3,61,84,1597,1510,draw
136,March 3,2010,Poland,Bulgaria,2,0,Friendly,in Poland,15,-15,1677,1743,4,-2,46,32,1662,1758,T1
137,March 3,2010,Portugal,China,2,0,Friendly,in Portugal,4,-4,1878,1623,0,-1,12,53,1874,1627,T1
138,March 3,2010,Romania,Israel,0,2,Friendly,in Romania,-21,21,1752,1739,-6,4,31,34,1773,1718,T2
139,March 3,2010,Scotland,Czechia,1,0,Friendly,in Scotland,9,-9,1680,1739,1,-3,44,34,1671,1748,T1
140,March 3,2010,Slovakia,Norway,0,1,Friendly,in Slovakia,-10,10,1655,1758,-2,3,50,28,1665,1748,T2
141,March 3,2010,Slovenia,Qatar,4,1,Friendly,in Slovenia,7,-7,1680,1520,0,1,44,84,1673,1527,T1
142,March 3,2010,South Africa,Namibia,1,1,Friendly,in South Africa,-7,7,1522,1327,0,1,83,125,1529,1320,draw
143,March 3,2010,South Korea,Ivory Coast,2,0,Friendly,in England,15,-15,1756,1725,3,-2,30,36,1741,1740,T1
144,March 3,2010,Switzerland,Uruguay,1,3,Friendly,in Switzerland,-18,18,1774,1831,-5,0,23,16,1792,1813,T2
145,March 3,2010,Syria,Lebanon,4,0,Asian Cup qualifier,in Syria,6,-6,1568,1221,3,0,67,150,1562,1227,T1
146,March 3,2010,Tanzania,Uganda,2,3,Friendly,in Tanzania,-7,7,1335,1555,0,1,121,76,1342,1548,T2
147,March 3,2010,Turkey,Honduras,2,0,Friendly,in Turkey,10,-10,1795,1759,1,-1,18,27,1785,1769,T1
148,March 3,2010,Uzbekistan,United Arab Emirates,0,1,Asian Cup qualifier,in Uzbekistan,-32,32,1516,1435,-9,4,86,106,1548,1403,T2
149,March 3,2010,Venezuela,Panama,1,2,Friendly,in Venezuela,-17,17,1710,1568,-3,8,39,67,1727,1551,T2
150,March 3,2010,Wales,Sweden,0,1,Friendly,in Wales,-8,8,1599,1786,-2,5,58,19,1607,1778,T2
151,March 3,2010,Zimbabwe,Malawi,2,1,Friendly,in Zimbabwe,9,-9,1335,1373,3,-2,121,115,1326,1382,T1
152,March 4,2010,Venezuela,North Korea,1,1,Friendly,in Venezuela,-6,6,1704,1554,-1,1,40,77,1710,1548,draw
153,March 6,2010,Sierra Leone,Guinea,1,0,Friendly,in Sierra Leone,14,-14,1261,1464,3,-1,139,92,1247,1478,T1
154,March 6,2010,Venezuela,North Korea,2,1,Friendly,in Venezuela,4,-4,1708,1550,1,-1,39,78,1704,1554,T1
155,March 7,2010,Niger,Benin,2,0,Friendly,in Niger,19,-19,1261,1422,5,-4,140,108,1242,1441,T1
156,March 7,2010,Sierra Leone,Guinea,0,0,Friendly,in Sierra Leone,3,-3,1264,1461,1,-1,138,93,1261,1464,draw
157,March 17,2010,Mexico,North Korea,2,1,Friendly,in Mexico,1,-1,1902,1549,0,0,8,78,1901,1550,T1
158,March 21,2010,Iceland,Faroe Islands,2,0,Friendly,in Iceland,4,-4,1457,1208,2,0,94,154,1453,1212,T1
159,March 21,2010,Namibia,Botswana,0,0,Friendly,in Namibia,-3,3,1324,1310,0,1,125,131,1327,1307,draw
160,March 24,2010,Iceland,Mexico,0,0,Friendly,in the United States,9,-9,1466,1893,2,0,92,8,1457,1902,draw
161,March 24,2010,Martinique,Haiti,0,0,Friendly,in Martinique,-1,1,1374,1434,0,0,114,106,1375,1433,draw
162,March 31,2010,Chile,Venezuela,0,0,Friendly,in Chile,-7,7,1876,1715,-2,1,12,38,1883,1708,draw
163,March 31,2010,Paraguay,South Africa,1,1,Friendly,in Paraguay,-7,7,1753,1529,-5,1,30,82,1760,1522,draw
164,April 3,2010,Saint Kitts and Nevis,Guadeloupe,3,0,Friendly,in Saint Kitts and Nevis,28,-28,1165,1443,6,-12,165,103,1137,1471,T1
165,April 7,2010,Japan,Serbia,0,3,Friendly,in Japan,-17,17,1723,1860,-3,1,36,13,1740,1843,T2
166,April 21,2010,Honduras,Venezuela,0,1,Friendly,in Honduras,-14,14,1745,1729,-5,3,31,35,1759,1715,T2
167,April 22,2010,North Korea,South Africa,0,0,Friendly,in Germany,-1,1,1548,1530,0,1,78,81,1549,1529,draw
168,April 28,2010,South Africa,Jamaica,2,0,Friendly,in Germany,19,-19,1549,1607,3,-3,78,55,1530,1626,T1
169,May 5,2010,Argentina,Haiti,4,0,Friendly,in Argentina,1,-1,1917,1433,0,0,7,106,1916,1434,T1
170,May 5,2010,Chile,Trinidad and Tobago,2,0,Friendly,in Chile,2,-2,1878,1538,1,-1,11,81,1876,1540,T1
171,May 7,2010,Ecuador,Mexico,0,0,Friendly,in the United States,5,-5,1726,1888,2,-1,36,9,1721,1893,draw
172,May 10,2010,Mexico,Senegal,1,0,Friendly,in the United States,3,-3,1891,1568,0,0,9,66,1888,1571,T1
173,May 12,2010,Yemen,Malawi,1,0,Friendly,in Yemen,10,-10,1294,1363,1,-3,134,118,1284,1373,T1
174,May 13,2010,Germany,Malta,3,0,Friendly,in Germany,0,0,1948,1217,0,0,6,151,1948,1217,T1
175,May 13,2010,Mexico,Angola,1,0,Friendly,in the United States,1,-1,1892,1451,0,-1,9,97,1891,1452,T1
176,May 15,2010,Paraguay,North Korea,1,0,Friendly,in Switzerland,5,-5,1758,1543,3,0,26,79,1753,1548,T1
177,May 16,2010,Mexico,Chile,1,0,Friendly,in Mexico,7,-7,1899,1871,1,-1,8,12,1892,1878,T1
178,May 16,2010,South Africa,Thailand,4,0,Friendly,in South Africa,9,-9,1558,1443,4,-6,74,102,1549,1452,T1
179,May 16,2010,South Korea,Ecuador,2,0,Friendly,in South Korea,10,-10,1766,1716,5,-2,24,38,1756,1726,T1
180,May 18,2010,Yemen,Oman,0,1,Friendly tournament,in Yemen,-7,7,1287,1594,0,1,134,60,1294,1587,T2
181,May 19,2010,Austria,Croatia,0,1,Friendly,in Austria,-5,5,1597,1898,-2,0,58,9,1602,1893,T2
182,May 19,2010,Belgium,Bulgaria,2,1,Friendly,in Belgium,12,-12,1594,1731,5,-2,60,34,1582,1743,T1
183,May 19,2010,Gabon,Togo,3,0,Friendly tournament,in France,19,-19,1579,1444,7,-6,66,98,1560,1463,T1
184,May 20,2010,Aruba,Venezuela,0,3,Friendly,in Aruba,-1,1,939,1730,0,0,191,35,940,1729,T2
185,May 20,2010,Yemen,Burkina Faso,2,2,Friendly tournament,in Yemen,4,-4,1291,1475,0,0,134,90,1287,1479,draw
186,May 21,2010,Estonia,Finland,2,0,Friendly,in Estonia,20,-20,1464,1648,6,-3,92,51,1444,1668,T1
187,May 21,2010,Saudi Arabia,Democratic Republic of Congo,2,0,Friendly,in Austria,6,-6,1690,1420,0,-1,42,108,1684,1426,T1
188,May 22,2010,Oman,Burkina Faso,2,0,Friendly tournament,in Yemen,15,-15,1609,1460,5,-3,55,93,1594,1475,T1
189,May 22,2010,Turkey,Czechia,2,1,Friendly,in the United States,8,-8,1803,1731,1,-1,17,33,1795,1739,T1
190,May 23,2010,Croatia,Wales,2,0,Friendly,in Croatia,3,-3,1901,1596,1,-1,8,59,1898,1599,T1
191,May 24,2010,Argentina,Canada,5,0,Friendly,in Argentina,3,-3,1920,1597,0,0,7,57,1917,1600,T1
192,May 24,2010,Australia,New Zealand,2,1,Friendly,in Australia,2,-2,1782,1524,-1,0,23,83,1780,1526,T1
193,May 24,2010,England,Mexico,3,1,Friendly,in England,7,-7,1998,1892,0,0,4,9,1991,1899,T1
194,May 24,2010,Japan,South Korea,0,2,Friendly,in Japan,-17,17,1706,1783,-2,4,39,20,1723,1766,T2
195,May 24,2010,Portugal,Cape Verde,0,0,Friendly,in Portugal,-9,9,1869,1376,-1,4,12,113,1878,1367,draw
196,May 24,2010,South Africa,Bulgaria,1,1,Friendly,in South Africa,2,-2,1560,1729,0,-2,74,35,1558,1731,draw
197,May 25,2010,Armenia,Uzbekistan,3,1,Friendly,in Armenia,17,-17,1390,1499,4,-2,112,88,1373,1516,T1
198,May 25,2010,Cameroon,Georgia,0,0,Friendly,in Austria,-6,6,1707,1450,0,2,38,97,1713,1444,draw
199,May 25,2010,Greece,North Korea,2,2,Friendly,in Austria,-5,5,1752,1548,1,0,28,79,1757,1543,draw
200,May 25,2010,Ireland,Paraguay,2,1,Friendly,in Ireland,7,-7,1770,1751,1,-4,24,31,1763,1758,T1
201,May 25,2010,Montenegro,Albania,0,1,Friendly,in Montenegro,-16,16,1640,1522,-3,3,51,84,1656,1506,T2
202,May 25,2010,Nigeria,Saudi Arabia,0,0,Friendly,in Austria,0,0,1706,1690,0,0,39,42,1706,1690,draw
203,May 25,2010,Ukraine,Lithuania,4,0,Friendly,in Ukraine,6,-6,1789,1580,1,-1,19,65,1783,1586,T1
204,May 25,2010,United States,Czechia,2,4,Friendly,in the United States,-21,21,1762,1752,-5,5,25,28,1783,1731,T2
205,May 26,2010,Azerbaijan,Moldova,1,1,Friendly,in Austria,0,0,1444,1450,0,0,100,97,1444,1450,draw
206,May 26,2010,Chile,Zambia,3,0,Friendly,in Chile,3,-3,1874,1559,0,-1,11,74,1871,1562,T1
207,May 26,2010,Estonia,Croatia,0,0,Friendly,in Estonia,7,-7,1471,1894,1,0,90,8,1464,1901,draw
208,May 26,2010,France,Costa Rica,2,1,Friendly,in France,3,-3,1882,1698,0,0,10,41,1879,1701,T1
209,May 26,2010,Netherlands,Mexico,2,1,Friendly,in Germany,6,-6,2039,1886,0,0,3,9,2033,1892,T1
210,May 26,2010,Turkey,Northern Ireland,2,0,Friendly,in the United States,6,-6,1809,1562,0,-5,17,72,1803,1568,T1
211,May 26,2010,Uruguay,Israel,4,1,Friendly tournament,in Uruguay,13,-13,1844,1726,1,-2,15,35,1831,1739,T1
212,May 27,2010,Belarus,Honduras,2,2,Friendly,in Austria,4,-4,1593,1741,0,0,62,32,1589,1745,draw
213,May 27,2010,Denmark,Senegal,2,0,Friendly,in Denmark,4,-4,1803,1564,0,-4,18,71,1799,1568,T1
214,May 27,2010,South Africa,Colombia,2,1,Friendly,in South Africa,13,-13,1573,1747,6,-5,67,31,1560,1760,T1
215,May 28,2010,Ireland,Algeria,3,0,Friendly,in Ireland,5,-5,1775,1535,1,-1,23,81,1770,1540,T1
216,May 29,2010,Cameroon,Slovakia,1,1,Friendly,in Austria,-1,1,1706,1656,0,0,38,48,1707,1655,draw
217,May 29,2010,Hungary,Germany,0,3,Friendly,in Hungary,-7,7,1608,1955,-2,1,55,5,1615,1948,T2
218,May 29,2010,Iceland,Andorra,4,0,Friendly,in Iceland,2,-2,1468,1024,0,-1,91,184,1466,1026,T1
219,May 29,2010,Macedonia,Azerbaijan,3,1,Friendly,in Austria,9,-9,1595,1435,4,-5,60,105,1586,1444,T1
220,May 29,2010,New Zealand,Serbia,1,0,Friendly,in Austria,17,-17,1541,1843,3,-2,80,15,1524,1860,T1
221,May 29,2010,Norway,Montenegro,2,1,Friendly,in Norway,4,-4,1762,1636,0,0,26,51,1758,1640,T1
222,May 29,2010,Poland,Finland,0,0,Friendly,in Poland,-4,4,1673,1652,0,1,46,49,1677,1648,draw
223,May 29,2010,Spain,Saudi Arabia,3,2,Friendly,in Austria,2,-2,2108,1688,1,0,1,42,2106,1690,T1
224,May 29,2010,Sweden,Bosnia and Herzegovina,4,2,Friendly,in Sweden,6,-6,1792,1644,0,-1,20,50,1786,1650,T1
225,May 29,2010,United Arab Emirates,Moldova,3,2,Friendly,in Austria,10,-10,1445,1440,6,-6,99,103,1435,1450,T1
226,May 29,2010,Ukraine,Romania,3,2,Friendly,in Ukraine,6,-6,1795,1746,0,-4,19,31,1789,1752,T1
227,May 29,2010,United States,Turkey,2,1,Friendly,in the United States,8,-8,1770,1801,0,-1,25,18,1762,1809,T1
228,May 29,2010,Venezuela,Canada,1,1,Friendly,in Venezuela,-6,6,1724,1603,-3,0,36,57,1730,1597,draw
229,May 30,2010,Belarus,South Korea,1,0,Friendly,in Austria,15,-15,1608,1768,8,-4,55,25,1593,1783,T1
230,May 30,2010,Chile,Northern Ireland,1,0,Friendly,in Chile,2,-2,1876,1560,1,0,10,73,1874,1562,T1
231,May 30,2010,Chile,Israel,3,0,Friendly,in Chile,7,-7,1883,1719,1,-2,10,36,1876,1726,T1
232,May 30,2010,Colombia,Nigeria,1,1,Friendly,in England,-1,1,1746,1707,0,0,30,38,1747,1706,draw
233,May 30,2010,England,Japan,2,1,Friendly,in Austria,3,-3,2001,1703,0,-2,4,40,1998,1706,T1
234,May 30,2010,Ivory Coast,Paraguay,2,2,Friendly,in France,1,-1,1726,1750,1,0,34,29,1725,1751,draw
235,May 30,2010,Mexico,Gambia,5,1,Friendly,in Germany,2,-2,1888,1410,0,0,9,110,1886,1412,T1
236,May 30,2010,Tunisia,France,1,1,Friendly,in Tunisia,5,-5,1618,1877,0,-1,53,11,1613,1882,draw
237,May 31,2010,Grenada,Martinique,2,2,Friendly,in Grenada,1,-1,1256,1373,1,0,142,116,1255,1374,draw
238,May 31,2010,South Africa,Guatemala,5,0,Friendly,in South Africa,8,-8,1581,1430,2,-2,65,106,1573,1438,T1
239,June 1,2010,Australia,Denmark,1,0,Friendly,in South Africa,11,-11,1793,1792,2,-3,19,20,1782,1803,T1
240,June 1,2010,Netherlands,Ghana,4,1,Friendly,in the Netherlands,2,-2,2041,1681,0,0,3,43,2039,1683,T1
241,June 1,2010,Portugal,Cameroon,3,1,Friendly,in Portugal,5,-5,1874,1701,0,-2,12,41,1869,1706,T1
242,June 1,2010,Switzerland,Costa Rica,0,1,Friendly,in Switzerland,-15,15,1759,1713,-3,3,26,38,1774,1698,T2
243,June 2,2010,Albania,Andorra,1,0,Friendly,in Albania,1,-1,1523,1023,0,0,84,184,1522,1024,T1
244,June 2,2010,Azerbaijan,Honduras,0,0,Friendly,in Austria,7,-7,1442,1734,1,1,103,31,1435,1741,draw
245,June 2,2010,Belarus,Sweden,0,1,Friendly,in Belarus,-8,8,1600,1800,-4,1,59,19,1608,1792,T2
246,June 2,2010,Macedonia,Romania,1,0,Friendly,in Austria,14,-14,1609,1732,7,-2,54,32,1595,1746,T1
247,June 2,2010,Norway,Ukraine,0,1,Friendly,in Norway,-12,12,1750,1807,-3,1,28,17,1762,1795,T2
248,June 2,2010,Paraguay,Greece,2,0,Friendly,in Switzerland,15,-15,1765,1737,4,-3,25,30,1750,1752,T1
249,June 2,2010,Poland,Serbia,0,0,Friendly,in Austria,5,-5,1678,1838,0,0,46,15,1673,1843,draw
250,June 2,2010,Zimbabwe,Brazil,0,3,Friendly,in Zimbabwe,-1,1,1334,2109,-1,0,122,1,1335,2108,T2
251,June 3,2010,Germany,Bosnia and Herzegovina,3,1,Friendly,in Germany,3,-3,1958,1641,0,0,5,50,1955,1644,T1
252,June 3,2010,Mexico,Italy,2,1,Friendly,in Belgium,12,-12,1900,1939,1,0,8,6,1888,1951,T1
253,June 3,2010,Spain,South Korea,1,0,Friendly,in Austria,2,-2,2110,1766,1,0,1,24,2108,1768,T1
254,June 4,2010,China,France,1,0,Friendly,in Réunion,16,-16,1639,1861,1,-1,51,12,1623,1877,T1
255,June 4,2010,Ivory Coast,Japan,2,0,Friendly,in Switzerland,14,-14,1740,1689,4,-1,30,41,1726,1703,T1
256,June 4,2010,Luxembourg,Faroe Islands,0,0,Friendly,in Luxembourg,0,0,1098,1208,0,0,176,154,1098,1208,draw
257,June 4,2010,Slovenia,New Zealand,3,1,Friendly,in Slovenia,6,-6,1686,1535,1,-1,43,81,1680,1541,T1
258,June 4,2010,Sudan,Palestine,1,1,Friendly,in Sudan,-6,6,1328,1185,-2,1,124,158,1334,1179,draw
259,June 5,2010,Algeria,United Arab Emirates,1,0,Friendly,in Germany,7,-7,1542,1438,1,-5,80,104,1535,1445,T1
260,June 5,2010,Ghana,Latvia,1,0,Friendly,in England,7,-7,1688,1557,2,-4,42,75,1681,1564,T1
261,June 5,2010,Netherlands,Hungary,6,1,Friendly,in the Netherlands,2,-2,2043,1606,0,-1,3,57,2041,1608,T1
262,June 5,2010,Romania,Honduras,3,0,Friendly,in Austria,18,-18,1750,1716,5,-4,28,36,1732,1734,T1
263,June 5,2010,Serbia,Cameroon,4,3,Friendly,in Serbia,4,-4,1842,1697,0,0,15,40,1838,1701,T1
264,June 5,2010,Slovakia,Costa Rica,3,0,Friendly,in Slovakia,15,-15,1671,1698,1,-1,47,39,1656,1713,T1
265,June 5,2010,South Africa,Denmark,1,0,Friendly,in South Africa,13,-13,1594,1779,2,0,63,21,1581,1792,T1
266,June 5,2010,Switzerland,Italy,1,1,Friendly,in Switzerland,2,-2,1761,1937,0,0,26,6,1759,1939,draw
267,June 5,2010,United States,Australia,3,1,Friendly,in South Africa,16,-16,1786,1777,3,-2,20,22,1770,1793,T1
268,June 6,2010,Nigeria,North Korea,3,1,Friendly,in South Africa,9,-9,1716,1539,2,-1,36,80,1707,1548,T1
269,June 7,2010,Tanzania,Brazil,1,5,Friendly,in Tanzania,-1,1,1334,2110,0,1,121,1,1335,2109,T2
270,June 8,2010,Portugal,Mozambique,3,0,Friendly,in South Africa,2,-2,1876,1374,0,-1,11,115,1874,1376,T1
271,June 8,2010,Spain,Poland,6,0,Friendly,in Spain,2,-2,2112,1676,0,0,1,46,2110,1678,T1
272,June 9,2010,Chile,New Zealand,2,0,Friendly,in South Africa,4,-4,1887,1531,0,0,10,82,1883,1535,T1
273,June 10,2010,Japan,Zimbabwe,0,0,Friendly,in South Africa,-8,8,1681,1342,-3,0,44,121,1689,1334,draw
274,June 11,2010,France,Uruguay,0,0,World Cup,in South Africa,-1,1,1860,1845,0,0,12,14,1861,1844,draw
275,June 11,2010,South Africa,Mexico,1,1,World Cup,in South Africa,16,-16,1610,1884,9,-2,54,10,1594,1900,draw
276,June 12,2010,Argentina,Nigeria,1,0,World Cup,in South Africa,14,-14,1934,1702,0,-1,7,37,1920,1716,T1
277,June 12,2010,England,United States,1,1,World Cup,in South Africa,-17,17,1984,1803,0,1,4,19,2001,1786,draw
278,June 12,2010,South Korea,Greece,2,0,World Cup,in South Africa,41,-41,1807,1696,7,-8,17,40,1766,1737,T1
279,June 13,2010,Germany,Australia,4,0,World Cup,in South Africa,29,-29,1987,1748,1,-6,4,29,1958,1777,T1
280,June 13,2010,Ghana,Serbia,1,0,World Cup,in South Africa,42,-42,1730,1800,9,-5,32,20,1688,1842,T1
281,June 13,2010,Slovenia,Algeria,1,0,World Cup,in South Africa,18,-18,1704,1524,5,-4,38,83,1686,1542,T1
282,June 14,2010,Italy,Paraguay,1,1,World Cup,in South Africa,-14,14,1923,1779,-1,2,7,22,1937,1765,draw
283,June 14,2010,Japan,Cameroon,1,0,World Cup,in South Africa,31,-31,1712,1666,6,-7,38,48,1681,1697,T1
284,June 14,2010,Netherlands,Denmark,2,0,World Cup,in South Africa,16,-16,2059,1763,0,-2,3,24,2043,1779,T1
285,June 15,2010,Brazil,North Korea,2,1,World Cup,in South Africa,2,-2,2112,1537,1,-2,1,81,2110,1539,T1
286,June 15,2010,Ivory Coast,Portugal,0,0,World Cup,in South Africa,11,-11,1751,1865,4,0,27,11,1740,1876,draw
287,June 15,2010,New Zealand,Slovakia,1,1,World Cup,in South Africa,11,-11,1542,1660,2,-2,79,48,1531,1671,draw
288,June 16,2010,Chile,Honduras,1,0,World Cup,in South Africa,16,-16,1903,1700,1,-4,8,40,1887,1716,T1
289,June 16,2010,South Africa,Uruguay,0,3,World Cup,in South Africa,-33,33,1577,1878,-13,3,67,11,1610,1845,T2
290,June 16,2010,Switzerland,Spain,1,0,World Cup,in South Africa,53,-53,1814,2059,9,-1,16,2,1761,2112,T1
291,June 17,2010,Argentina,South Korea,4,1,World Cup,in South Africa,34,-34,1968,1773,0,-7,6,24,1934,1807,T1
292,June 17,2010,Greece,Nigeria,2,1,World Cup,in South Africa,31,-31,1727,1671,8,-6,34,45,1696,1702,T1
293,June 17,2010,Mexico,France,2,0,World Cup,in South Africa,42,-42,1926,1818,3,-2,7,15,1884,1860,T1
294,June 18,2010,Algeria,England,0,0,World Cup,in South Africa,26,-26,1550,1958,4,0,79,5,1524,1984,draw
295,June 18,2010,Lithuania,Latvia,0,0,Baltic Cup,in Lithuania,-5,5,1575,1562,-2,3,67,72,1580,1557,draw
296,June 18,2010,Serbia,Germany,1,0,World Cup,in South Africa,45,-45,1845,1942,6,-2,14,6,1800,1987,T1
297,June 18,2010,Slovenia,United States,2,2,World Cup,in South Africa,8,-8,1712,1795,1,-3,38,21,1704,1803,draw
298,June 19,2010,Australia,Ghana,1,1,World Cup,in South Africa,-2,2,1746,1732,0,0,30,32,1748,1730,draw
299,June 19,2010,Denmark,Cameroon,2,1,World Cup,in South Africa,22,-22,1785,1644,3,-2,22,49,1763,1666,T1
300,June 19,2010,Estonia,Latvia,0,0,Baltic Cup,in Lithuania,4,-4,1475,1558,0,-2,90,74,1471,1562,draw
301,June 19,2010,Netherlands,Japan,1,0,World Cup,in South Africa,7,-7,2066,1705,0,-1,2,39,2059,1712,T1
302,June 19,2010,Niger,Chad,1,1,Friendly,in Niger,-3,3,1258,1259,-1,2,141,140,1261,1256,draw
303,June 19,2010,Northern Mariana Islands,Guam,1,1,Marianas Cup,in the Northern Mariana Islands,0,0,499,600,0,0,229,221,499,600,draw
304,June 20,2010,Brazil,Ivory Coast,3,1,World Cup,in South Africa,10,-10,2122,1741,0,-4,1,31,2112,1751,T1
305,June 20,2010,Italy,New Zealand,1,1,World Cup,in South Africa,-24,24,1899,1566,-1,9,9,71,1923,1542,draw
306,June 20,2010,Lithuania,Estonia,2,0,Baltic Cup,in Lithuania,11,-11,1586,1464,2,-1,65,91,1575,1475,T1
307,June 20,2010,Paraguay,Slovakia,2,0,World Cup,in South Africa,30,-30,1809,1630,5,-5,18,52,1779,1660,T1
308,June 20,2010,Sudan,Tunisia,2,6,Friendly,in Sudan,-9,9,1319,1627,-2,0,126,53,1328,1618,T2
309,June 21,2010,Chile,Switzerland,1,0,World Cup,in South Africa,22,-22,1925,1792,0,-5,8,22,1903,1814,T1
310,June 21,2010,Portugal,North Korea,7,0,World Cup,in South Africa,18,-18,1883,1519,1,-4,11,86,1865,1537,T1
311,June 21,2010,Spain,Honduras,2,0,World Cup,in South Africa,10,-10,2069,1690,1,-1,2,41,2059,1700,T1
312,June 22,2010,Argentina,Greece,2,0,World Cup,in South Africa,18,-18,1986,1709,0,-4,4,38,1968,1727,T1
313,June 22,2010,Nigeria,South Korea,2,2,World Cup,in South Africa,9,-9,1680,1764,2,0,43,25,1671,1773,draw
314,June 22,2010,South Africa,France,2,1,World Cup,in South Africa,42,-42,1619,1776,13,-7,54,23,1577,1818,T1
315,June 22,2010,Uruguay,Mexico,1,0,World Cup,in South Africa,34,-34,1912,1892,4,-4,8,11,1878,1926,T1
316,June 23,2010,Australia,Serbia,2,1,World Cup,in South Africa,38,-38,1784,1807,6,-2,23,16,1746,1845,T1
317,June 23,2010,England,Slovenia,1,0,World Cup,in South Africa,12,-12,1970,1700,0,-2,5,39,1958,1712,T1
318,June 23,2010,Germany,Ghana,1,0,World Cup,in South Africa,14,-14,1956,1718,0,-3,6,35,1942,1732,T1
319,June 23,2010,United States,Algeria,1,0,World Cup,in South Africa,12,-12,1807,1538,4,0,16,80,1795,1550,T1
320,June 24,2010,Japan,Denmark,3,1,World Cup,in South Africa,55,-55,1760,1730,12,-10,26,32,1705,1785,T1
321,June 24,2010,Netherlands,Cameroon,2,1,World Cup,in South Africa,5,-5,2071,1639,1,-2,2,50,2066,1644,T1
322,June 24,2010,New Zealand,Paraguay,0,0,World Cup,in South Africa,18,-18,1584,1791,4,-6,67,21,1566,1809,draw
323,June 24,2010,Slovakia,Italy,3,2,World Cup,in South Africa,49,-49,1679,1850,7,-3,45,12,1630,1899,T1
324,June 25,2010,Brazil,Portugal,0,0,World Cup,in South Africa,-18,18,2104,1901,0,2,1,9,2122,1883,draw
325,June 25,2010,Honduras,Switzerland,0,0,World Cup,in South Africa,9,-9,1699,1783,1,-2,40,22,1690,1792,draw
326,June 25,2010,Ivory Coast,North Korea,3,0,World Cup,in South Africa,23,-23,1764,1496,6,-2,25,88,1741,1519,T1
327,June 25,2010,Spain,Chile,2,1,World Cup,in South Africa,18,-18,2087,1907,1,-1,2,8,2069,1925,T1
328,June 26,2010,China,Tajikistan,4,0,Friendly,in China,2,-2,1641,1273,1,0,49,136,1639,1275,T1
329,June 26,2010,Ghana,United States,2,1,World Cup,in South Africa,38,-38,1756,1769,9,-9,27,24,1718,1807,T1
330,June 26,2010,Uruguay,South Korea,2,1,World Cup,in South Africa,18,-18,1930,1746,0,-6,7,31,1912,1764,T1
331,June 27,2010,Argentina,Mexico,3,1,World Cup,in South Africa,33,-33,2019,1859,0,0,4,11,1986,1892,T1
332,June 27,2010,Germany,England,4,1,World Cup,in South Africa,55,-55,2011,1915,1,-2,5,7,1956,1970,T1
333,June 28,2010,Brazil,Chile,3,0,World Cup,in South Africa,26,-26,2130,1881,0,-2,1,10,2104,1907,T1
334,June 28,2010,Netherlands,Slovakia,2,1,World Cup,in South Africa,6,-6,2077,1673,0,-1,3,46,2071,1679,T1
335,June 29,2010,Japan,Paraguay,0,0,World Cup,in South Africa,3,-3,1763,1788,0,0,26,19,1760,1791,draw
336,June 29,2010,Spain,Portugal,1,0,World Cup,in South Africa,15,-15,2102,1886,0,-1,2,9,2087,1901,T1
337,July 1,2010,Chad,Togo,2,2,African Nations Cup qualifier,in Chad,5,-5,1264,1439,2,-4,138,103,1259,1444,draw
338,July 1,2010,Tunisia,Botswana,0,1,African Nations Cup qualifier,in Tunisia,-37,37,1590,1347,-11,11,64,120,1627,1310,T2
339,July 2,2010,Ghana,Uruguay,1,1,World Cup,in South Africa,14,-14,1770,1916,3,0,24,6,1756,1930,draw
340,July 2,2010,Netherlands,Brazil,2,1,World Cup,in South Africa,35,-35,2112,2095,2,-2,1,3,2077,2130,T1
341,July 3,2010,Germany,Argentina,4,0,World Cup,in South Africa,58,-58,2069,1961,1,-1,4,5,2011,2019,T1
342,July 3,2010,Spain,Paraguay,1,0,World Cup,in South Africa,8,-8,2110,1780,0,-2,2,21,2102,1788,T1
343,July 3,2010,Saint Martin,Saint Barthélemy,3,0,Friendly,in Saint Martin,5,-5,925,695,2,0,195,217,920,700,T1
344,July 6,2010,Netherlands,Uruguay,3,2,World Cup,in South Africa,15,-15,2127,1901,0,-1,1,7,2112,1916,T1
345,July 7,2010,Spain,Germany,1,0,World Cup,in South Africa,26,-26,2136,2043,1,0,1,4,2110,2069,T1
346,July 9,2010,Botswana,Chad,1,0,African Nations Cup qualifier,in Botswana,10,-10,1357,1254,1,-5,119,143,1347,1264,T1
347,July 9,2010,Togo,Malawi,1,1,African Nations Cup qualifier,in Togo,-9,9,1430,1372,-2,0,105,118,1439,1363,draw
348,July 10,2010,Germany,Uruguay,3,2,World Cup,in South Africa,18,-18,2061,1883,0,-2,4,9,2043,1901,T1
349,July 11,2010,Spain,Netherlands,1,0,World Cup,in South Africa,29,-29,2165,2098,0,0,1,2,2136,2127,T1
350,July 21,2010,Trinidad and Tobago,Antigua and Barbuda,4,1,Friendly,in Trinidad and Tobago,3,-3,1541,1242,0,-1,80,145,1538,1245,T1
351,August 4,2010,Botswana,Zimbabwe,2,0,Friendly,in Botswana,10,-10,1367,1332,0,-2,119,124,1357,1342,T1
352,August 8,2010,Anguilla,Saint Martin,1,3,Friendly,in Anguilla,-5,5,549,930,0,1,228,194,554,925,T2
353,August 10,2010,Bosnia and Herzegovina,Qatar,1,1,Friendly,in Bosnia and Herzegovina,-6,6,1635,1526,-3,1,52,83,1641,1520,draw
354,August 10,2010,Ivory Coast,Italy,1,0,Friendly,in England,12,-12,1776,1838,4,-1,22,13,1764,1850,T1
355,August 10,2010,United States,Brazil,0,2,Friendly,in the United States,-6,6,1763,2101,-1,1,26,2,1769,2095,T2
356,August 11,2010,Albania,Uzbekistan,1,0,Friendly,in Albania,7,-7,1530,1492,3,-2,81,89,1523,1499,T1
357,August 11,2010,Algeria,Gabon,1,2,Friendly,in Algeria,-12,12,1526,1591,-1,6,82,62,1538,1579,T2
358,August 11,2010,Armenia,Iran,1,3,Friendly,in Armenia,-8,8,1382,1678,0,4,112,43,1390,1670,T2
359,August 11,2010,Austria,Switzerland,0,1,Friendly,in Austria,-8,8,1589,1791,-3,1,63,19,1597,1783,T2
360,August 11,2010,Azerbaijan,Kuwait,1,1,Friendly,in Azerbaijan,-1,1,1441,1521,0,0,101,85,1442,1520,draw
361,August 11,2010,Benin,Niger,0,0,Friendly,in Benin,-6,6,1416,1264,-1,2,108,138,1422,1258,draw
362,August 11,2010,Bolivia,Colombia,1,1,Friendly,in Bolivia,1,-1,1596,1745,1,0,61,31,1595,1746,draw
363,August 11,2010,Burkina Faso,Congo,3,0,Friendly,in France,15,-15,1475,1403,2,-1,91,110,1460,1418,T1
364,August 11,2010,Chad,Tunisia,1,3,African Nations Cup qualifier,in Chad,-12,12,1242,1602,-1,6,144,58,1254,1590,T2
365,August 11,2010,China,Bahrain,1,1,Friendly,in China,-5,5,1636,1535,-2,3,51,79,1641,1530,draw
366,August 11,2010,Cyprus,Andorra,1,0,Friendly,in Cyprus,1,-1,1558,1022,3,0,74,184,1557,1023,T1
367,August 11,2010,Czechia,Latvia,4,1,Friendly,in Czechia,5,-5,1757,1553,-1,-1,29,76,1752,1558,T1
368,August 11,2010,Denmark,Germany,2,2,Friendly,in Denmark,6,-6,1736,2055,0,0,33,4,1730,2061,draw
369,August 11,2010,Egypt,Democratic Republic of Congo,6,3,Friendly,in Egypt,2,-2,1835,1418,0,1,14,107,1833,1420,T1
370,August 11,2010,England,Hungary,2,1,Friendly,in England,2,-2,1917,1604,0,1,6,56,1915,1606,T1
371,August 11,2010,Estonia,Faroe Islands,2,1,European Championship qualifier,in Estonia,5,-5,1469,1203,-1,-1,92,155,1464,1208,T1
372,August 11,2010,Finland,Belgium,1,0,Friendly,in Finland,6,-6,1658,1588,0,-1,48,64,1652,1594,T1
373,August 11,2010,Guinea,Mali,2,0,Friendly,in France,19,-19,1480,1533,2,-1,90,80,1461,1552,T1
374,August 11,2010,Iceland,Liechtenstein,1,1,Friendly,in Iceland,-8,8,1460,1166,-3,4,93,164,1468,1158,draw
375,August 11,2010,Ireland,Argentina,0,1,Friendly,in Ireland,-8,8,1767,1969,0,0,24,5,1775,1961,T2
376,August 11,2010,Kazakhstan,Oman,3,1,Friendly,in Kazakhstan,22,-22,1356,1587,2,-11,120,65,1334,1609,T1
377,August 11,2010,Lithuania,Belarus,0,2,Friendly,in Lithuania,-19,19,1567,1619,-5,4,71,55,1586,1600,T2
378,August 11,2010,Malawi,Botswana,1,1,African Nations Cup qualifier,in Malawi,-6,6,1366,1373,-1,4,119,115,1372,1367,draw
379,August 11,2010,Malta,Macedonia,1,1,Friendly,in Malta,7,-7,1224,1602,1,-4,150,58,1217,1609,draw
380,August 11,2010,Mauritania,Palestine,0,0,Friendly,in Mauritania,-2,2,1143,1187,0,0,170,158,1145,1185,draw
381,August 11,2010,Mexico,Spain,1,1,Friendly,in Mexico,5,-5,1864,2160,0,0,11,1,1859,2165,draw
382,August 11,2010,Moldova,Georgia,0,0,Friendly,in Moldova,-3,3,1437,1453,-1,1,103,96,1440,1450,draw
383,August 11,2010,Montenegro,Northern Ireland,2,0,Friendly,in Montenegro,8,-8,1644,1552,1,-4,50,77,1636,1560,T1
384,August 11,2010,Morocco,Equatorial Guinea,2,1,Friendly,in Morocco,1,-1,1569,1213,0,-1,69,153,1568,1214,T1
385,August 11,2010,Mozambique,Swaziland,2,1,Friendly,in Mozambique,3,-3,1377,1168,1,0,114,163,1374,1171,T1
386,August 11,2010,Norway,France,2,1,Friendly,in Norway,8,-8,1758,1768,1,-1,28,23,1750,1776,T1
387,August 11,2010,Panama,Venezuela,3,1,Friendly,in Panama,17,-17,1585,1707,2,-4,67,39,1568,1724,T1
388,August 11,2010,Paraguay,Costa Rica,2,0,Friendly,in Paraguay,8,-8,1788,1690,1,0,20,41,1780,1698,T1
389,August 11,2010,Poland,Cameroon,0,3,Friendly,in Poland,-24,24,1652,1663,-4,3,49,47,1676,1639,T2
390,August 11,2010,Russia,Bulgaria,1,0,Friendly,in Russia,4,-4,1852,1725,0,0,12,34,1848,1729,T1
391,August 11,2010,Saudi Arabia,Togo,1,0,Friendly,in Saudi Arabia,2,-2,1690,1428,1,-1,41,106,1688,1430,T1
392,August 11,2010,Senegal,Cape Verde,1,0,Friendly,in Senegal,3,-3,1567,1373,1,-1,71,115,1564,1376,T1
393,August 11,2010,Serbia,Greece,0,1,Friendly,in Serbia,-15,15,1792,1724,-3,3,18,35,1807,1709,T2
394,August 11,2010,Slovakia,Croatia,1,1,Friendly,in Slovakia,3,-3,1676,1891,2,0,44,7,1673,1894,draw
395,August 11,2010,Slovenia,Australia,2,0,Friendly,in Slovenia,14,-14,1714,1770,1,-3,38,22,1700,1784,T1
396,August 11,2010,South Africa,Ghana,1,0,Friendly,in South Africa,11,-11,1630,1759,0,-2,53,27,1619,1770,T1
397,August 11,2010,South Korea,Nigeria,2,1,Friendly,in South Korea,6,-6,1752,1674,1,-2,30,45,1746,1680,T1
398,August 11,2010,Sweden,Scotland,3,0,Friendly,in Sweden,8,-8,1808,1672,1,-3,17,46,1800,1680,T1
399,August 11,2010,Tanzania,Kenya,1,1,Friendly,in Tanzania,-3,3,1331,1322,-2,0,124,127,1334,1319,draw
400,August 11,2010,Thailand,Singapore,1,0,Friendly,in Thailand,5,-5,1448,1347,0,-1,99,121,1443,1352,T1
401,August 11,2010,Trinidad and Tobago,Jamaica,1,3,Friendly,in Trinidad and Tobago,-16,16,1525,1623,-4,2,84,54,1541,1607,T2
402,August 11,2010,Turkey,Romania,2,0,Friendly,in Turkey,9,-9,1810,1741,1,-3,16,32,1801,1750,T1
403,August 11,2010,Uganda,Zambia,1,1,Friendly,in Uganda,-3,3,1552,1562,1,1,77,73,1555,1559,draw
404,August 11,2010,Ukraine,Netherlands,1,1,Friendly,in Ukraine,5,-5,1812,2093,0,0,15,3,1807,2098,draw
405,August 11,2010,Uruguay,Angola,2,0,Friendly,in Portugal,2,-2,1885,1449,0,-2,9,98,1883,1451,T1
406,August 11,2010,Wales,Luxembourg,5,1,Friendly,in Wales,1,-1,1597,1097,1,0,60,176,1596,1098,T1
407,August 18,2010,Ethiopia,Kenya,0,3,Friendly,in Ethiopia,-21,21,1277,1343,-2,4,135,123,1298,1322,T2
408,August 20,2010,Madagascar,Mayotte,0,0,Friendly,in Madagascar,-6,6,1264,1133,0,1,137,172,1270,1127,draw
409,August 26,2010,Saint Lucia,Martinique,1,3,Friendly,in Saint Lucia,-9,9,1119,1382,-2,3,175,112,1128,1373,T2
410,August 28,2010,Saint Kitts and Nevis,Antigua and Barbuda,1,1,Friendly,in Saint Kitts and Nevis,-1,1,1164,1243,0,1,166,143,1165,1242,draw
411,August 28,2010,Saint Lucia,Martinique,1,1,Friendly,in Saint Lucia,4,-4,1123,1378,1,-2,174,114,1119,1382,draw
412,August 29,2010,Ethiopia,Chad,1,0,Friendly,in Ethiopia,6,-6,1283,1236,0,-1,135,146,1277,1242,T1
413,August 29,2010,Madagascar,Comoros,1,0,Friendly,in Madagascar,1,-1,1265,866,0,0,137,204,1264,867,T1
414,September 2,2010,Israel,Malta,3,1,European Championship qualifier,in Israel,2,-2,1721,1222,0,0,36,150,1719,1224,T1
415,September 3,2010,Algeria,Tanzania,1,1,African Nations Cup qualifier,in Algeria,-14,14,1512,1345,-3,3,85,122,1526,1331,draw
416,September 3,2010,Andorra,Russia,0,2,European Championship qualifier,in Andorra,-1,1,1021,1853,0,0,184,12,1022,1852,T2
417,September 3,2010,Armenia,Ireland,0,1,European Championship qualifier,in Armenia,-6,6,1376,1773,-3,2,115,22,1382,1767,T2
418,September 3,2010,Belgium,Germany,0,1,European Championship qualifier,in Belgium,-4,4,1584,2059,-4,0,68,4,1588,2055,T2
419,September 3,2010,China,Iran,0,2,Friendly,in China,-17,17,1619,1695,-3,4,54,39,1636,1678,T2
420,September 3,2010,England,Bulgaria,4,0,European Championship qualifier,in England,12,-12,1929,1713,0,-2,6,36,1917,1725,T1
421,September 3,2010,Estonia,Italy,1,2,European Championship qualifier,in Estonia,-7,7,1462,1845,-2,0,94,13,1469,1838,T2
422,September 3,2010,Faroe Islands,Serbia,0,3,European Championship qualifier,in the Faroe Islands,-4,4,1199,1796,0,0,155,18,1203,1792,T2
423,September 3,2010,France,Belarus,0,1,European Championship qualifier,in France,-32,32,1736,1651,-8,5,31,50,1768,1619,T2
424,September 3,2010,Greece,Georgia,1,1,European Championship qualifier,in Greece,-16,16,1708,1469,-2,3,37,93,1724,1453,draw
425,September 3,2010,Iceland,Norway,1,2,European Championship qualifier,in Iceland,-10,10,1450,1768,-4,4,97,24,1460,1758,T2
426,September 3,2010,Kazakhstan,Turkey,0,3,European Championship qualifier,in Kazakhstan,-8,8,1348,1818,0,1,120,15,1356,1810,T2
427,September 3,2010,Kuwait,Syria,3,0,Friendly,in Kuwait,15,-15,1536,1553,4,-6,81,76,1521,1568,T1
428,September 3,2010,Latvia,Croatia,0,3,European Championship qualifier,in Latvia,-14,14,1539,1905,-3,0,79,7,1553,1891,T2
429,September 3,2010,Liechtenstein,Spain,0,4,European Championship qualifier,in Liechtenstein,0,0,1166,2160,0,0,164,1,1166,2160,T2
430,September 3,2010,Lithuania,Scotland,0,0,European Championship qualifier,in Lithuania,0,0,1567,1672,-1,0,72,46,1567,1672,draw
431,September 3,2010,Luxembourg,Bosnia and Herzegovina,0,3,European Championship qualifier,in Luxembourg,-5,5,1092,1640,0,1,176,51,1097,1635,T2
432,September 3,2010,Moldova,Finland,2,0,European Championship qualifier,in Moldova,40,-40,1477,1618,12,-7,91,55,1437,1658,T1
433,September 3,2010,Montenegro,Wales,1,0,European Championship qualifier,in Montenegro,12,-12,1656,1585,2,-5,48,65,1644,1597,T1
434,September 3,2010,Oman,Malaysia,3,0,Friendly,in Qatar,3,-3,1590,1176,3,-1,62,161,1587,1179,T1
435,September 3,2010,Panama,Costa Rica,2,2,Friendly,in Panama,0,0,1585,1690,2,1,65,40,1585,1690,draw
436,September 3,2010,Portugal,Cyprus,4,4,European Championship qualifier,in Portugal,-17,17,1869,1575,-2,4,10,70,1886,1558,draw
437,September 3,2010,Qatar,Bahrain,1,1,Friendly,in Qatar,-3,3,1523,1538,-2,-1,84,80,1526,1535,draw
438,September 3,2010,Romania,Albania,1,1,European Championship qualifier,in Romania,-14,14,1727,1544,-1,3,33,78,1741,1530,draw
439,September 3,2010,San Marino,Netherlands,0,5,European Championship qualifier,in San Marino,0,0,913,2093,0,0,198,3,913,2093,T2
440,September 3,2010,Slovakia,Macedonia,1,0,European Championship qualifier,in Slovakia,11,-11,1687,1591,1,-2,43,60,1676,1602,T1
441,September 3,2010,Slovenia,Northern Ireland,0,1,European Championship qualifier,in Slovenia,-33,33,1681,1585,-6,12,44,65,1714,1552,T2
442,September 3,2010,Sweden,Hungary,2,0,European Championship qualifier,in Sweden,9,-9,1817,1595,1,-3,16,59,1808,1604,T1
443,September 3,2010,Switzerland,Australia,0,0,Friendly,in Switzerland,-3,3,1788,1773,0,0,19,22,1791,1770,draw
444,September 3,2010,Venezuela,Colombia,0,2,Friendly,in Venezuela,-18,18,1689,1763,-3,6,42,25,1707,1745,T2
445,September 4,2010,Botswana,Togo,2,1,African Nations Cup qualifier,in Botswana,17,-17,1390,1411,4,-3,112,109,1373,1428,T1
446,September 4,2010,Canada,Peru,0,2,Friendly,in Canada,-20,20,1583,1607,-13,8,69,56,1603,1587,T2
447,September 4,2010,Cape Verde,Mali,1,0,African Nations Cup qualifier,in Cape Verde,23,-23,1396,1510,5,-3,111,85,1373,1533,T1
448,September 4,2010,El Salvador,Honduras,2,2,Friendly tournament,in the United States,8,-8,1510,1691,1,-1,85,39,1502,1699,draw
449,September 4,2010,Gambia,Namibia,3,1,African Nations Cup qualifier,in The Gambia,15,-15,1425,1309,3,-5,106,131,1410,1324,T1
450,September 4,2010,Guatemala,Nicaragua,5,0,Friendly,in the United States,5,-5,1435,1075,2,-1,103,178,1430,1080,T1
451,September 4,2010,Guinea-Bissau,Kenya,1,0,African Nations Cup qualifier,in Guinea-Bissau,20,-20,1262,1323,5,-2,140,126,1242,1343,T1
452,September 4,2010,Ivory Coast,Rwanda,3,0,African Nations Cup qualifier,in Ivory Coast,4,-4,1780,1398,1,1,20,110,1776,1402,T1
453,September 4,2010,Japan,Paraguay,1,0,Friendly,in Japan,8,-8,1771,1780,1,-1,24,20,1763,1788,T1
454,September 4,2010,Mauritius,Cameroon,1,3,African Nations Cup qualifier,in Mauritius,-3,3,1031,1666,0,0,182,47,1034,1663,T2
455,September 4,2010,Mexico,Ecuador,1,2,Friendly,in Mexico,-16,16,1848,1732,-1,2,12,33,1864,1716,T2
456,September 4,2010,Morocco,Central African Republic,0,0,African Nations Cup qualifier,in Morocco,-18,18,1551,1202,-6,4,77,155,1569,1184,draw
457,September 4,2010,Poland,Ukraine,1,1,Friendly,in Poland,2,-2,1654,1810,0,0,49,17,1652,1812,draw
458,September 4,2010,South Africa,Niger,2,0,African Nations Cup qualifier,in South Africa,4,-4,1634,1260,0,-3,52,141,1630,1264,T1
459,September 4,2010,Sudan,Congo,2,0,African Nations Cup qualifier,in Sudan,29,-29,1348,1374,8,-8,120,118,1319,1403,T1
460,September 4,2010,Thailand,India,1,0,Friendly,in Thailand,2,-2,1450,1194,3,-1,97,157,1448,1196,T1
461,September 4,2010,Tunisia,Malawi,2,2,African Nations Cup qualifier,in Tunisia,-15,15,1587,1381,-6,6,63,113,1602,1366,draw
462,September 4,2010,Uganda,Angola,3,0,African Nations Cup qualifier,in Uganda,17,-17,1569,1432,6,-6,71,105,1552,1449,T1
463,September 5,2010,Benin,Burundi,1,1,African Nations Cup qualifier,in Benin,-15,15,1401,1205,0,3,108,155,1416,1190,draw
464,September 5,2010,Democratic Republic of Congo,Senegal,2,4,African Nations Cup qualifier,in the Democratic Republic of the Congo,-26,26,1392,1593,-4,13,111,59,1418,1567,T2
465,September 5,2010,Egypt,Sierra Leone,1,1,African Nations Cup qualifier,in Egypt,-19,19,1816,1283,-2,3,16,135,1835,1264,draw
466,September 5,2010,Ethiopia,Guinea,1,4,African Nations Cup qualifier,in Ethiopia,-25,25,1258,1505,-6,3,141,87,1283,1480,T2
467,September 5,2010,Jamaica,Costa Rica,1,0,Friendly,in Jamaica,9,-9,1632,1681,0,-3,53,43,1623,1690,T1
468,September 5,2010,Liberia,Zimbabwe,1,1,African Nations Cup qualifier,in Liberia,0,0,1235,1332,0,0,148,125,1235,1332,draw
469,September 5,2010,Mozambique,Libya,0,0,African Nations Cup qualifier,in Mozambique,1,-1,1378,1492,1,-1,115,89,1377,1493,draw
470,September 5,2010,Nigeria,Madagascar,2,0,African Nations Cup qualifier,in Nigeria,3,-3,1677,1262,0,-1,45,138,1674,1265,T1
471,September 5,2010,Swaziland,Ghana,0,3,African Nations Cup qualifier,in Swaziland,-4,4,1164,1763,-2,2,165,26,1168,1759,T2
472,September 5,2010,Zambia,Comoros,4,0,African Nations Cup qualifier,in Zambia,1,-1,1563,865,0,0,74,204,1562,866,T1
473,September 6,2010,Burkina Faso,Gabon,1,1,Friendly,in France,3,-3,1478,1588,1,-3,91,63,1475,1591,draw
474,September 7,2010,Albania,Luxembourg,1,0,European Championship qualifier,in Albania,2,-2,1546,1090,0,0,78,176,1544,1092,T1
475,September 7,2010,Argentina,Spain,4,1,Friendly,in Argentina,22,-22,1991,2138,0,0,5,1,1969,2160,T1
476,September 7,2010,Austria,Kazakhstan,2,0,European Championship qualifier,in Austria,7,-7,1596,1341,3,-4,59,124,1589,1348,T1
477,September 7,2010,Belarus,Romania,0,0,European Championship qualifier,in Belarus,-1,1,1650,1728,1,2,49,32,1651,1727,draw
478,September 7,2010,Bosnia and Herzegovina,France,0,2,European Championship qualifier,in Bosnia and Herzegovina,-30,30,1610,1766,-5,6,56,25,1640,1736,T2
479,September 7,2010,Bulgaria,Montenegro,0,1,European Championship qualifier,in Bulgaria,-28,28,1685,1684,-6,5,42,43,1713,1656,T2
480,September 7,2010,Canada,Honduras,2,1,Friendly,in Canada,10,-10,1593,1681,8,-5,62,44,1583,1691,T1
481,September 7,2010,China,Paraguay,1,1,Friendly,in China,2,-2,1621,1778,2,-2,52,22,1619,1780,draw
482,September 7,2010,Croatia,Greece,0,0,European Championship qualifier,in Croatia,-14,14,1891,1722,0,2,7,35,1905,1708,draw
483,September 7,2010,Czechia,Lithuania,0,1,European Championship qualifier,in Czechia,-34,34,1723,1601,-5,15,34,58,1757,1567,T2
484,September 7,2010,Denmark,Iceland,1,0,European Championship qualifier,in Denmark,4,-4,1740,1446,1,-4,30,101,1736,1450,T1
485,September 7,2010,Estonia,Uzbekistan,3,3,Friendly,in Estonia,-2,2,1460,1494,0,1,94,88,1462,1492,draw
486,September 7,2010,Georgia,Israel,0,0,European Championship qualifier,in Georgia,8,-8,1477,1713,1,-2,92,37,1469,1721,draw
487,September 7,2010,Germany,Azerbaijan,6,1,European Championship qualifier,in Germany,1,-1,2060,1440,0,-2,4,103,2059,1441,T1
488,September 7,2010,Guatemala,El Salvador,2,0,Friendly,in the United States,18,-18,1453,1492,5,-4,98,89,1435,1510,T1
489,September 7,2010,Hungary,Moldova,2,1,European Championship qualifier,in Hungary,9,-9,1604,1468,1,-1,57,93,1595,1477,T1
490,September 7,2010,Ireland,Andorra,3,1,European Championship qualifier,in Ireland,0,0,1773,1021,-1,0,23,184,1773,1021,T1
491,September 7,2010,Italy,Faroe Islands,5,0,European Championship qualifier,in Italy,1,-1,1846,1198,1,0,12,157,1845,1199,T1
492,September 7,2010,Japan,Guatemala,2,1,Friendly,in Japan,2,-2,1773,1451,1,5,23,98,1771,1453,T1
493,September 7,2010,Macedonia,Armenia,2,2,European Championship qualifier,in Macedonia,-14,14,1577,1390,-11,5,71,112,1591,1376,draw
494,September 7,2010,Malta,Latvia,0,2,European Championship qualifier,in Malta,-13,13,1209,1552,-3,3,153,76,1222,1539,T2
495,September 7,2010,Mexico,Colombia,1,0,Friendly,in Mexico,5,-5,1853,1758,2,-3,10,29,1848,1763,T1
496,September 7,2010,Netherlands,Finland,2,1,European Championship qualifier,in the Netherlands,1,-1,2094,1617,0,0,3,55,2093,1618,T1
497,September 7,2010,Norway,Portugal,1,0,European Championship qualifier,in Norway,20,-20,1788,1849,7,-1,18,11,1768,1869,T1
498,September 7,2010,Panama,Trinidad and Tobago,3,0,Friendly,in Panama,10,-10,1595,1515,4,-1,61,83,1585,1525,T1
499,September 7,2010,Peru,Jamaica,2,1,Friendly,in the United States,11,-11,1618,1621,2,1,54,52,1607,1632,T1
500,September 7,2010,Poland,Australia,1,2,Friendly,in Poland,-9,9,1645,1782,-1,2,50,20,1654,1773,T2
501,September 7,2010,Qatar,Oman,1,1,Friendly,in Qatar,-1,1,1522,1591,2,-3,81,64,1523,1590,draw
502,September 7,2010,Russia,Slovakia,0,1,European Championship qualifier,in Russia,-33,33,1820,1720,-3,6,14,36,1853,1687,T2
503,September 7,2010,Scotland,Liechtenstein,2,1,European Championship qualifier,in Scotland,1,-1,1673,1165,-1,-1,47,164,1672,1166,T1
504,September 7,2010,Serbia,Slovenia,1,1,European Championship qualifier,in Serbia,-11,11,1785,1692,-1,3,19,40,1796,1681,draw
505,September 7,2010,South Korea,Iran,0,1,Friendly,in South Korea,-14,14,1738,1709,-1,0,31,38,1752,1695,T2
506,September 7,2010,Sweden,San Marino,6,0,European Championship qualifier,in Sweden,0,0,1817,913,-1,0,16,198,1817,913,T1
507,September 7,2010,Switzerland,England,1,3,European Championship qualifier,in Switzerland,-26,26,1762,1955,-9,0,28,6,1788,1929,T2
508,September 7,2010,Turkey,Belgium,3,2,European Championship qualifier,in Turkey,5,-5,1823,1579,1,-2,13,70,1818,1584,T1
509,September 7,2010,United Arab Emirates,Kuwait,3,0,Friendly,in the United Arab Emirates,17,-17,1455,1519,7,-1,95,82,1438,1536,T1
510,September 7,2010,Ukraine,Chile,2,1,Friendly,in Ukraine,9,-9,1819,1872,2,0,15,9,1810,1881,T1
511,September 7,2010,Venezuela,Ecuador,1,0,Friendly,in Venezuela,8,-8,1697,1724,2,0,39,33,1689,1732,T1
512,September 7,2010,Yemen,Syria,2,1,Friendly,in Yemen,14,-14,1305,1539,0,-3,133,79,1291,1553,T1
513,September 8,2010,India,Thailand,1,2,Friendly,in India,-6,6,1188,1456,0,4,158,95,1194,1450,T2
514,September 10,2010,Belize,Trinidad and Tobago,0,0,Friendly,in Belize,7,-7,1086,1508,0,-2,177,85,1079,1515,draw
515,September 10,2010,Saint Lucia,Saint Vincent and the Grenadines,1,5,Friendly,in Saint Lucia,-18,18,1105,1254,-1,2,175,144,1123,1236,T2
516,September 11,2010,French Guiana,Suriname,1,2,Friendly,in French Guiana,-12,12,1202,1255,-4,1,155,144,1214,1243,T2
517,September 15,2010,India,Namibia,2,0,Friendly,in India,16,-16,1204,1293,3,-2,155,133,1188,1309,T1
518,September 16,2010,Jordan,Iraq,4,1,Friendly,in Jordan,18,-18,1473,1540,3,-3,93,78,1455,1558,T1
519,September 17,2010,Saint Vincent and the Grenadines,Grenada,0,1,Friendly,in Saint Vincent and the Grenadines,-13,13,1241,1269,-1,6,146,137,1254,1256,T2
520,September 18,2010,British Virgin Islands,Anguilla,2,1,Friendly,in Saint Martin,3,-3,889,546,0,0,201,228,886,549,T1
521,September 18,2010,Yemen,Zambia,0,1,Friendly,in Yemen,-6,6,1299,1569,0,1,132,73,1305,1563,T2
522,September 19,2010,Antigua and Barbuda,Trinidad and Tobago,0,1,Friendly tournament,in Antigua and Barbuda,-8,8,1235,1516,-2,2,147,83,1243,1508,T2
523,September 19,2010,Jordan,Bahrain,2,0,Friendly,in Jordan,13,-13,1486,1525,2,0,91,80,1473,1538,T1
524,September 19,2010,Saint Martin,British Virgin Islands,3,1,Friendly,in Saint Martin,9,-9,939,880,3,0,191,201,930,889,T1
525,September 19,2010,Saint Vincent and the Grenadines,Grenada,0,0,Friendly,in Saint Vincent and the Grenadines,-2,2,1239,1271,1,0,145,137,1241,1269,draw
526,September 21,2010,Iraq,Oman,3,2,Friendly,in Jordan,11,-11,1551,1580,2,-5,76,69,1540,1591,T1
527,September 21,2010,Trinidad and Tobago,Saint Lucia,3,0,Friendly tournament,in Antigua and Barbuda,5,-5,1521,1100,1,0,82,175,1516,1105,T1
528,September 22,2010,French Guiana,Mayotte,2,2,French Territory Cup,in France,-3,3,1199,1136,-1,0,157,172,1202,1133,draw
529,September 22,2010,Réunion,Saint Pierre and Miquelon,11,0,French Territory Cup,in France,2,-2,1318,698,0,0,128,217,1316,700,T1
530,September 23,2010,Antigua and Barbuda,Saint Lucia,5,0,Friendly tournament,in Antigua and Barbuda,12,-12,1247,1088,2,-1,145,176,1235,1100,T1
531,September 23,2010,Guadeloupe,New Caledonia,1,1,French Territory Cup,in France,-5,5,1438,1316,-1,1,103,129,1443,1311,draw
532,September 23,2010,Martinique,Tahiti,4,1,French Territory Cup,in France,12,-12,1390,1163,4,-5,112,167,1378,1175,T1
533,September 24,2010,Iran,Bahrain,3,0,West Asian Championship,in Jordan,18,-18,1727,1507,5,-5,33,85,1709,1525,T1
534,September 24,2010,Jordan,Syria,1,1,West Asian Championship,in Jordan,-3,3,1483,1542,0,0,91,79,1486,1539,draw
535,September 24,2010,Vietnam,North Korea,0,0,Friendly tournament,in Vietnam,2,-2,1347,1494,1,0,121,87,1345,1496,draw
536,September 25,2010,Barbados,Dominica,0,2,Friendly,in Barbados,-28,28,1284,1019,-4,1,134,185,1312,991,T2
537,September 25,2010,French Guiana,Saint Pierre and Miquelon,7,0,French Territory Cup,in France,4,-4,1203,694,1,-1,156,218,1199,698,T1
538,September 25,2010,Iraq,Yemen,2,1,West Asian Championship,in Jordan,8,-8,1559,1291,1,0,75,132,1551,1299,T1
539,September 25,2010,Réunion,Mayotte,2,1,French Territory Cup,in France,8,-8,1326,1128,2,0,126,172,1318,1136,T1
540,September 26,2010,Bahrain,Oman,2,0,West Asian Championship,in Jordan,36,-36,1543,1544,6,-9,79,78,1507,1580,T1
541,September 26,2010,Barbados,Dominica,1,3,Friendly,in Barbados,-27,27,1257,1046,-9,4,143,181,1284,1019,T2
542,September 26,2010,Guadeloupe,Tahiti,1,1,French Territory Cup,in France,-10,10,1428,1173,-2,5,105,162,1438,1163,draw
543,September 26,2010,Guyana,Trinidad and Tobago,1,1,Friendly,in Guyana,4,-4,1268,1517,1,-2,137,83,1264,1521,draw
544,September 26,2010,Kuwait,Syria,2,1,West Asian Championship,in Jordan,21,-21,1540,1521,2,-3,80,82,1519,1542,T1
545,September 26,2010,Martinique,New Caledonia,4,0,French Territory Cup,in France,22,-22,1412,1294,5,-1,107,130,1390,1316,T1
546,September 27,2010,Yemen,Palestine,3,1,West Asian Championship,in Jordan,21,-21,1312,1166,3,-3,129,162,1291,1187,T1
547,September 28,2010,Iran,Oman,2,2,West Asian Championship,in Jordan,-10,10,1717,1554,-4,3,37,75,1727,1544,draw
548,September 28,2010,Jordan,Kuwait,2,2,West Asian Championship,in Jordan,-2,2,1481,1542,0,0,91,80,1483,1540,draw
549,September 28,2010,Mayotte,Saint Pierre and Miquelon,10,0,French Territory Cup,in France,6,-6,1134,688,0,-1,172,219,1128,694,T1
550,September 28,2010,Réunion,French Guiana,1,0,French Territory Cup,in France,10,-10,1336,1193,1,-2,125,158,1326,1203,T1
551,September 29,2010,Guadeloupe,Martinique,2,0,French Territory Cup,in France,21,-21,1449,1391,4,-5,101,112,1428,1412,T1
552,September 29,2010,Iraq,Palestine,3,0,West Asian Championship,in Jordan,7,-7,1566,1159,0,-6,74,168,1559,1166,T1
553,September 29,2010,New Caledonia,Tahiti,1,1,French Territory Cup,in France,-5,5,1289,1178,-1,2,132,159,1294,1173,draw
554,October 1,2010,Guadeloupe,Mayotte,4,0,French Territory Cup,in France,8,-8,1457,1126,5,0,96,172,1449,1134,T1
555,October 1,2010,Iran,Iraq,2,1,West Asian Championship,in Jordan,12,-12,1729,1554,5,0,32,74,1717,1566,T1
556,October 1,2010,Kuwait,Yemen,1,1,West Asian Championship,in Jordan,-12,12,1530,1324,0,2,80,127,1542,1312,draw
557,October 2,2010,Cayman Islands,Saint Martin,1,1,CONCACAF Champ &amp; Carib Champ qual,in Puerto Rico,-2,2,976,941,0,0,188,191,978,939,draw
558,October 2,2010,Martinique,Réunion,0,0,French Territory Cup,in France,-2,2,1389,1338,-2,0,114,125,1391,1336,draw
559,October 2,2010,Puerto Rico,Anguilla,3,1,CONCACAF Champ &amp; Carib Champ qual,in Puerto Rico,3,-3,983,543,0,0,187,229,980,546,T1
560,October 3,2010,Kuwait,Iran,2,1,West Asian Championship,in Jordan,30,-30,1560,1699,6,-6,74,38,1530,1729,T1
561,October 4,2010,Cayman Islands,Anguilla,4,1,CONCACAF Champ &amp; Carib Champ qual,in Puerto Rico,5,-5,981,538,0,0,188,229,976,543,T1
562,October 4,2010,India,Hong Kong,0,1,Friendly,in India,-13,13,1191,1219,-3,2,158,151,1204,1206,T2
563,October 4,2010,Puerto Rico,Saint Martin,2,0,CONCACAF Champ &amp; Carib Champ qual,in Puerto Rico,18,-18,1001,923,1,-5,186,196,983,941,T1
564,October 6,2010,Anguilla,Saint Martin,2,1,CONCACAF Champ &amp; Carib Champ qual,in Puerto Rico,36,-36,574,887,2,-4,227,200,538,923,T1
565,October 6,2010,Barbados,Saint Kitts and Nevis,1,1,CONCACAF Champ &amp; Carib Champ qual,in Saint Vincent and the Grenadines,-5,5,1252,1169,-1,2,144,162,1257,1164,draw
566,October 6,2010,Puerto Rico,Cayman Islands,2,0,CONCACAF Champ &amp; Carib Champ qual,in Puerto Rico,20,-20,1021,961,1,-1,185,189,1001,981,T1
567,October 6,2010,Saint Vincent and the Grenadines,Montserrat,7,0,CONCACAF Champ &amp; Carib Champ qual,in Saint Vincent and the Grenadines,1,-1,1240,521,0,0,146,230,1239,522,T1
568,October 7,2010,Bolivia,Venezuela,1,3,Friendly,in Bolivia,-15,15,1581,1712,-9,1,68,38,1596,1697,T2
569,October 7,2010,Brazil,Iran,3,0,Friendly,in the United Arab Emirates,3,-3,2104,1696,0,-1,2,39,2101,1699,T1
570,October 8,2010,Albania,Bosnia and Herzegovina,1,1,European Championship qualifier,in Albania,-2,2,1544,1612,0,0,79,56,1546,1610,draw
571,October 8,2010,Andorra,Macedonia,0,2,European Championship qualifier,in Andorra,-4,4,1017,1581,-1,3,186,67,1021,1577,T2
572,October 8,2010,Armenia,Slovakia,3,1,European Championship qualifier,in Armenia,47,-47,1437,1673,9,-9,103,45,1390,1720,T1
573,October 8,2010,Austria,Azerbaijan,3,0,European Championship qualifier,in Austria,13,-13,1609,1427,2,-3,57,106,1596,1440,T1
574,October 8,2010,Barbados,Montserrat,5,0,CONCACAF Champ &amp; Carib Champ qual,in Saint Vincent and the Grenadines,1,-1,1253,520,0,0,144,230,1252,521,T1
575,October 8,2010,China,Syria,2,1,Friendly,in China,5,-5,1626,1516,-1,-1,53,83,1621,1521,T1
576,October 8,2010,Colombia,Ecuador,1,0,Friendly,in the United States,9,-9,1767,1715,6,-2,23,35,1758,1724,T1
577,October 8,2010,Cyprus,Norway,1,2,European Championship qualifier,in Cyprus,-14,14,1561,1802,-4,0,75,18,1575,1788,T2
578,October 8,2010,Czechia,Scotland,1,0,European Championship qualifier,in Czechia,12,-12,1735,1661,4,-1,30,48,1723,1673,T1
579,October 8,2010,Georgia,Malta,1,0,European Championship qualifier,in Georgia,4,-4,1481,1205,1,-1,92,154,1477,1209,T1
580,October 8,2010,Germany,Turkey,3,0,European Championship qualifier,in Germany,9,-9,2069,1814,0,-3,4,16,2060,1823,T1
581,October 8,2010,Greece,Latvia,1,0,European Championship qualifier,in Greece,7,-7,1729,1545,3,-1,32,78,1722,1552,T1
582,October 8,2010,Hungary,San Marino,8,0,European Championship qualifier,in Hungary,1,-1,1605,912,-1,0,58,197,1604,913,T1
583,October 8,2010,India,Vietnam,3,1,Friendly,in India,17,-17,1208,1330,5,-4,153,125,1191,1347,T1
584,October 8,2010,Indonesia,Uruguay,1,7,Friendly,in Indonesia,-2,2,1256,1887,-1,0,142,8,1258,1885,T2
585,October 8,2010,Ireland,Russia,2,3,European Championship qualifier,in Ireland,-23,23,1750,1843,-4,2,27,12,1773,1820,T2
586,October 8,2010,Japan,Argentina,1,0,Friendly,in Japan,13,-13,1786,1978,4,0,19,5,1773,1991,T1
587,October 8,2010,Kazakhstan,Belgium,0,2,European Championship qualifier,in Kazakhstan,-19,19,1322,1598,-5,7,129,62,1341,1579,T2
588,October 8,2010,Kuwait,Bahrain,1,3,Friendly,in Kuwait,-20,20,1540,1563,-6,7,80,73,1560,1543,T2
589,October 8,2010,Luxembourg,Belarus,0,0,European Championship qualifier,in Luxembourg,17,-17,1107,1633,0,-2,175,51,1090,1650,draw
590,October 8,2010,Moldova,Netherlands,0,1,European Championship qualifier,in Moldova,-2,2,1466,2096,-1,0,95,3,1468,2094,T2
591,October 8,2010,Montenegro,Switzerland,1,0,European Championship qualifier,in Montenegro,19,-19,1703,1743,4,0,39,28,1684,1762,T1
592,October 8,2010,Northern Ireland,Italy,0,0,European Championship qualifier,in Northern Ireland,9,-9,1594,1837,2,-1,63,13,1585,1846,draw
593,October 8,2010,Oman,Gabon,1,0,Friendly,in Oman,8,-8,1562,1580,1,-6,74,69,1554,1588,T1
594,October 8,2010,Panama,El Salvador,1,0,Friendly,in Panama,5,-5,1600,1487,1,-2,59,91,1595,1492,T1
595,October 8,2010,Peru,Costa Rica,2,0,Friendly,in Peru,13,-13,1631,1668,2,-2,52,46,1618,1681,T1
596,October 8,2010,Portugal,Denmark,3,1,European Championship qualifier,in Portugal,14,-14,1863,1726,1,-4,10,34,1849,1740,T1
597,October 8,2010,Serbia,Estonia,1,3,European Championship qualifier,in Serbia,-55,55,1730,1515,-12,11,31,84,1785,1460,T2
598,October 8,2010,Slovenia,Faroe Islands,5,1,European Championship qualifier,in Slovenia,2,-2,1694,1196,-1,-1,41,157,1692,1198,T1
599,October 8,2010,Spain,Lithuania,3,1,European Championship qualifier,in Spain,1,-1,2139,1600,0,-1,1,59,2138,1601,T1
600,October 8,2010,Saint Vincent and the Grenadines,Saint Kitts and Nevis,1,1,CONCACAF Champ &amp; Carib Champ qual,in Saint Vincent and the Grenadines,-9,9,1231,1178,-2,3,148,159,1240,1169,draw
601,October 8,2010,Ukraine,Canada,2,2,Friendly,in Ukraine,-7,7,1812,1600,-2,2,17,59,1819,1593,draw
602,October 8,2010,Wales,Bulgaria,0,1,European Championship qualifier,in Wales,-20,20,1565,1705,-7,4,72,38,1585,1685,T2
603,October 9,2010,Angola,Guinea-Bissau,1,0,African Nations Cup qualifier,in Angola,7,-7,1439,1255,1,-4,104,142,1432,1262,T1
604,October 9,2010,Australia,Paraguay,1,0,Friendly,in Australia,7,-7,1789,1771,1,-1,19,23,1782,1778,T1
605,October 9,2010,Burkina Faso,Gambia,3,1,African Nations Cup qualifier,in Burkina Faso,18,-18,1496,1407,6,-3,88,110,1478,1425,T1
606,October 9,2010,Burundi,Ivory Coast,0,1,African Nations Cup qualifier,in Burundi,-2,2,1203,1782,-1,-1,155,22,1205,1780,T2
607,October 9,2010,Cameroon,Democratic Republic of Congo,1,1,African Nations Cup qualifier,in Cameroon,-16,16,1650,1408,-2,3,49,109,1666,1392,draw
608,October 9,2010,Comoros,Mozambique,0,1,African Nations Cup qualifier,in the Comoros,-3,3,862,1381,0,2,204,115,865,1378,T2
609,October 9,2010,France,Romania,2,0,European Championship qualifier,in France,19,-19,1785,1709,3,-3,21,36,1766,1728,T1
610,October 9,2010,Guatemala,Belize,4,2,Friendly,in Guatemala,2,-2,1453,1084,1,0,99,177,1451,1086,T1
611,October 9,2010,Israel,Croatia,1,2,European Championship qualifier,in Israel,-16,16,1697,1907,-3,0,39,7,1713,1891,T2
612,October 9,2010,Kenya,Uganda,0,0,African Nations Cup qualifier,in Kenya,8,-8,1331,1561,3,-5,124,75,1323,1569,draw
613,October 9,2010,Malawi,Chad,6,2,African Nations Cup qualifier,in Malawi,15,-15,1396,1221,4,-3,111,149,1381,1236,T1
614,October 9,2010,Mali,Liberia,2,1,African Nations Cup qualifier,in Mali,4,-4,1514,1231,1,1,85,146,1510,1235,T1
615,October 9,2010,New Zealand,Honduras,1,1,Friendly,in New Zealand,0,0,1584,1681,0,0,66,43,1584,1681,draw
616,October 9,2010,Rwanda,Benin,0,3,African Nations Cup qualifier,in Rwanda,-45,45,1353,1446,-9,7,119,102,1398,1401,T2
617,October 9,2010,Saudi Arabia,Uzbekistan,4,0,Friendly,in Saudi Arabia,6,-6,1696,1488,2,-3,40,91,1690,1494,T1
618,October 9,2010,Senegal,Mauritius,7,0,African Nations Cup qualifier,in Senegal,2,-2,1595,1029,1,0,63,183,1593,1031,T1
619,October 9,2010,Taiwan,Macao,7,1,Friendly tournament,in Taiwan,9,-9,932,690,3,-1,193,217,923,699,T1
620,October 9,2010,Tanzania,Morocco,0,1,African Nations Cup qualifier,in Tanzania,-14,14,1331,1565,-2,6,124,71,1345,1551,T2
621,October 9,2010,United Arab Emirates,Chile,0,2,Friendly,in the United Arab Emirates,-4,4,1451,1876,-2,0,100,9,1455,1872,T2
622,October 9,2010,United States,Poland,2,2,Friendly,in the United States,-6,6,1757,1651,-1,1,26,48,1763,1645,draw
623,October 10,2010,Central African Republic,Algeria,2,0,African Nations Cup qualifier,in Central African Republic,46,-46,1248,1466,12,-8,144,94,1202,1512,T1
624,October 10,2010,Congo,Swaziland,3,1,African Nations Cup qualifier,in Congo,9,-9,1383,1155,2,-3,115,168,1374,1164,T1
625,October 10,2010,Ghana,Sudan,0,0,African Nations Cup qualifier,in Ghana,-18,18,1745,1366,-2,1,27,119,1763,1348,draw
626,October 10,2010,Guinea,Nigeria,1,0,African Nations Cup qualifier,in Guinea,24,-24,1529,1653,6,-3,81,47,1505,1677,T1
627,October 10,2010,Jamaica,Trinidad and Tobago,1,0,Friendly,in Jamaica,5,-5,1626,1512,2,-4,52,86,1621,1517,T1
628,October 10,2010,Libya,Zambia,1,0,African Nations Cup qualifier,in Libya,19,-19,1511,1550,3,-7,87,77,1492,1569,T1
629,October 10,2010,Madagascar,Ethiopia,0,1,African Nations Cup qualifier,in Madagascar,-26,26,1236,1284,-8,4,146,136,1262,1258,T2
630,October 10,2010,Niger,Egypt,1,0,African Nations Cup qualifier,in Niger,37,-37,1297,1779,8,-7,131,22,1260,1816,T1
631,October 10,2010,Sierra Leone,South Africa,0,0,African Nations Cup qualifier,in Sierra Leone,12,-12,1295,1622,2,-4,132,54,1283,1634,draw
632,October 10,2010,Saint Kitts and Nevis,Montserrat,4,0,CONCACAF Champ &amp; Carib Champ qual,in Saint Vincent and the Grenadines,2,-2,1180,518,0,0,159,230,1178,520,T1
633,October 10,2010,Saint Vincent and the Grenadines,Barbados,0,0,CONCACAF Champ &amp; Carib Champ qual,in Saint Vincent and the Grenadines,-4,4,1227,1257,-3,4,149,140,1231,1253,draw
634,October 10,2010,Taiwan,Philippines,1,1,Friendly tournament,in Taiwan,-8,8,924,829,-2,1,195,205,932,821,draw
635,October 10,2010,Togo,Tunisia,1,2,African Nations Cup qualifier,in Togo,-16,16,1395,1603,-4,6,112,59,1411,1587,T2
636,October 10,2010,Zimbabwe,Cape Verde,0,0,African Nations Cup qualifier,in Zimbabwe,-2,2,1330,1398,-2,1,125,110,1332,1396,draw
637,October 11,2010,Brazil,Ukraine,2,0,Friendly,in England,5,-5,2109,1807,0,0,2,16,2104,1812,T1
638,October 12,2010,Armenia,Andorra,4,0,European Championship qualifier,in Armenia,4,-4,1441,1013,1,0,104,186,1437,1017,T1
639,October 12,2010,Azerbaijan,Turkey,1,0,European Championship qualifier,in Azerbaijan,34,-34,1461,1780,11,-7,96,22,1427,1814,T1
640,October 12,2010,Bahrain,Uzbekistan,2,4,Friendly,in Bahrain,-22,22,1541,1510,-6,4,78,86,1563,1488,T2
641,October 12,2010,Belarus,Albania,2,0,European Championship qualifier,in Belarus,15,-15,1648,1529,0,-1,50,80,1633,1544,T1
642,October 12,2010,Belgium,Austria,4,4,European Championship qualifier,in Belgium,-5,5,1593,1614,0,2,63,55,1598,1609,draw
643,October 12,2010,Bulgaria,Saudi Arabia,2,0,Friendly,in Turkey,15,-15,1720,1681,3,-1,34,41,1705,1696,T1
644,October 12,2010,China,Uruguay,0,4,Friendly tournament,in China,-16,16,1610,1903,-5,0,57,8,1626,1887,T2
645,October 12,2010,Costa Rica,El Salvador,2,1,Friendly,in Costa Rica,3,-3,1671,1484,0,-1,45,92,1668,1487,T1
646,October 12,2010,Croatia,Norway,2,1,Friendly,in Croatia,5,-5,1912,1797,0,1,7,16,1907,1802,T1
647,October 12,2010,Denmark,Cyprus,2,0,European Championship qualifier,in Denmark,11,-11,1737,1550,2,-1,31,75,1726,1561,T1
648,October 12,2010,Ecuador,Poland,2,2,Friendly,in Canada,-2,2,1713,1653,-3,1,37,47,1715,1651,draw
649,October 12,2010,England,Montenegro,0,0,European Championship qualifier,in England,-15,15,1940,1718,0,3,6,35,1955,1703,draw
650,October 12,2010,Equatorial Guinea,Botswana,0,2,Friendly,in Equatorial Guinea,-12,12,1201,1402,-4,3,157,110,1213,1390,T2
651,October 12,2010,Estonia,Slovenia,0,1,European Championship qualifier,in Estonia,-16,16,1499,1710,-4,4,88,38,1515,1694,T2
652,October 12,2010,Faroe Islands,Northern Ireland,1,1,European Championship qualifier,in the Faroe Islands,14,-14,1210,1580,4,-1,153,66,1196,1594,draw
653,October 12,2010,Finland,Hungary,1,2,European Championship qualifier,in Finland,-26,26,1591,1631,-9,7,64,51,1617,1605,T2
654,October 12,2010,France,Luxembourg,2,0,European Championship qualifier,in France,1,-1,1786,1106,1,0,19,175,1785,1107,T1
655,October 12,2010,Greece,Israel,2,1,European Championship qualifier,in Greece,13,-13,1742,1684,3,-4,29,43,1729,1697,T1
656,October 12,2010,Honduras,Guatemala,2,0,Friendly,in the United States,6,-6,1687,1447,1,-3,42,102,1681,1453,T1
657,October 12,2010,Iceland,Portugal,1,3,European Championship qualifier,in Iceland,-8,8,1438,1871,-3,0,105,10,1446,1863,T2
658,October 12,2010,Indonesia,Maldives,3,0,Friendly,in Indonesia,7,-7,1263,1116,1,0,140,174,1256,1123,T1
659,October 12,2010,Kazakhstan,Germany,0,3,European Championship qualifier,in Kazakhstan,-2,2,1320,2071,0,0,129,4,1322,2069,T2
660,October 12,2010,Kuwait,Vietnam,3,1,Friendly,in Kuwait,4,-4,1544,1326,3,-1,77,126,1540,1330,T1
661,October 12,2010,Latvia,Georgia,1,1,European Championship qualifier,in Latvia,-9,9,1536,1490,-1,1,79,91,1545,1481,draw
662,October 12,2010,Liechtenstein,Czechia,0,2,European Championship qualifier,in Liechtenstein,-4,4,1161,1739,-2,0,166,30,1165,1735,T2
663,October 12,2010,Macedonia,Russia,0,1,European Championship qualifier,in Macedonia,-11,11,1570,1854,-2,1,69,11,1581,1843,T2
664,October 12,2010,Mexico,Venezuela,2,2,Friendly,in Mexico,-6,6,1847,1718,-1,0,12,35,1853,1712,draw
665,October 12,2010,Netherlands,Sweden,4,1,European Championship qualifier,in the Netherlands,7,-7,2103,1810,0,0,3,14,2096,1817,T1
666,October 12,2010,New Zealand,Paraguay,0,2,Friendly,in New Zealand,-11,11,1573,1782,-1,3,67,20,1584,1771,T2
667,October 12,2010,Oman,Chile,0,1,Friendly,in Oman,-5,5,1557,1881,0,0,73,9,1562,1876,T2
668,October 12,2010,Panama,Peru,1,0,Friendly,in Panama,8,-8,1608,1623,2,-2,58,53,1600,1631,T1
669,October 12,2010,Philippines,Macao,5,0,Friendly tournament,in Taiwan,19,-19,848,671,0,-3,205,220,829,690,T1
670,October 12,2010,Qatar,Iraq,1,2,Friendly,in Qatar,-12,12,1510,1566,-4,6,86,70,1522,1554,T2
671,October 12,2010,San Marino,Moldova,0,2,European Championship qualifier,in San Marino,-4,4,908,1470,0,0,197,94,912,1466,T2
672,October 12,2010,Saudi Arabia,Gabon,1,0,Friendly,in Turkey,7,-7,1688,1573,-1,2,41,67,1681,1580,T1
673,October 12,2010,Scotland,Spain,2,3,European Championship qualifier,in Scotland,-4,4,1657,2143,0,0,46,1,1661,2139,T2
674,October 12,2010,Slovakia,Ireland,1,1,European Championship qualifier,in Slovakia,-1,1,1672,1751,0,-1,44,27,1673,1750,draw
675,October 12,2010,South Korea,Japan,0,0,Friendly,in South Korea,-1,1,1737,1787,-2,1,31,18,1738,1786,draw
676,October 12,2010,Switzerland,Wales,4,1,European Championship qualifier,in Switzerland,12,-12,1755,1553,3,-4,25,74,1743,1565,T1
677,October 12,2010,United Arab Emirates,Angola,0,2,Friendly,in the United Arab Emirates,-20,20,1431,1459,-7,7,107,97,1451,1439,T2
678,October 12,2010,United States,Colombia,0,0,Friendly,in the United States,-3,3,1754,1770,-1,0,26,24,1757,1767,draw
679,October 13,2010,Guyana,Saint Lucia,1,0,CONCACAF Champ &amp; Carib Champ qual,in Suriname,10,-10,1278,1078,2,-1,137,177,1268,1088,T1
680,October 13,2010,India,Yemen,3,6,Friendly,in India,-17,17,1191,1341,-4,5,158,122,1208,1324,T2
681,October 13,2010,Suriname,Netherlands Antilles,2,1,CONCACAF Champ &amp; Carib Champ qual,in Suriname,9,-9,1264,1129,2,0,140,171,1255,1138,T1
682,October 14,2010,Dominican Republic,British Virgin Islands,17,0,CONCACAF Champ &amp; Carib Champ qual,in the Dominican Republic,25,-25,1074,855,1,-3,179,204,1049,880,T1
683,October 15,2010,Dominica,British Virgin Islands,10,0,CONCACAF Champ &amp; Carib Champ qual,in the Dominican Republic,26,-26,1072,829,2,-1,179,205,1046,855,T1
684,October 15,2010,Guyana,Netherlands Antilles,3,2,CONCACAF Champ &amp; Carib Champ qual,in Suriname,12,-12,1290,1117,3,-2,134,173,1278,1129,T1
685,October 15,2010,Suriname,Saint Lucia,2,1,CONCACAF Champ &amp; Carib Champ qual,in Suriname,6,-6,1270,1072,0,-2,140,179,1264,1078,T1
686,October 17,2010,Dominican Republic,Dominica,0,1,CONCACAF Champ &amp; Carib Champ qual,in the Dominican Republic,-26,26,1048,1098,-3,3,181,176,1074,1072,T2
687,October 17,2010,Netherlands Antilles,Saint Lucia,2,2,CONCACAF Champ &amp; Carib Champ qual,in Suriname,-3,3,1114,1075,-1,1,174,178,1117,1072,draw
688,October 17,2010,Suriname,Guyana,0,2,CONCACAF Champ &amp; Carib Champ qual,in Suriname,-37,37,1233,1327,-6,7,146,127,1270,1290,T2
689,October 22,2010,Grenada,Puerto Rico,3,1,CONCACAF Champ &amp; Carib Champ qual,in Grenada,7,-7,1278,1014,1,0,138,185,1271,1021,T1
690,October 22,2010,Guadeloupe,Saint Kitts and Nevis,2,1,CONCACAF Champ &amp; Carib Champ qual,in Grenada,7,-7,1464,1173,2,-3,96,162,1457,1180,T1
691,October 22,2010,Laos,Cambodia,0,0,Southeast Asian Championship qualifier,in Laos,-10,10,861,785,-2,1,203,209,871,775,draw
692,October 22,2010,Philippines,East Timor,5,0,Southeast Asian Championship qualifier,in Laos,13,-13,861,550,1,0,203,229,848,563,T1
693,October 24,2010,Cambodia,East Timor,4,2,Southeast Asian Championship qualifier,in Laos,12,-12,797,538,2,0,207,229,785,550,T1
694,October 24,2010,Grenada,Saint Kitts and Nevis,2,0,CONCACAF Champ &amp; Carib Champ qual,in Grenada,14,-14,1292,1159,3,-4,135,166,1278,1173,T1
695,October 24,2010,Guadeloupe,Puerto Rico,3,2,CONCACAF Champ &amp; Carib Champ qual,in Grenada,3,-3,1467,1011,1,-1,95,186,1464,1014,T1
696,October 24,2010,Laos,Philippines,2,2,Southeast Asian Championship qualifier,in Laos,-6,6,855,867,-1,1,204,202,861,861,draw
697,October 26,2010,Cambodia,Philippines,0,0,Southeast Asian Championship qualifier,in Laos,4,-4,801,863,0,0,207,202,797,867,draw
698,October 26,2010,Grenada,Guadeloupe,0,3,CONCACAF Champ &amp; Carib Champ qual,in Grenada,-28,28,1264,1495,-4,5,139,90,1292,1467,T2
699,October 26,2010,Laos,East Timor,6,1,Southeast Asian Championship qualifier,in Laos,7,-7,862,531,1,0,203,229,855,538,T1
700,October 26,2010,Panama,Cuba,0,3,Friendly,in Panama,-29,29,1579,1479,-8,6,66,95,1608,1450,T2
701,October 26,2010,Saint Kitts and Nevis,Puerto Rico,1,0,CONCACAF Champ &amp; Carib Champ qual,in Grenada,12,-12,1171,999,4,0,162,186,1159,1011,T1
702,October 27,2010,Botswana,Swaziland,2,0,Friendly,in Botswana,4,-4,1406,1151,0,-1,110,169,1402,1155,T1
703,October 28,2010,Yemen,Senegal,4,1,Friendly,in Yemen,25,-25,1366,1570,3,-7,119,68,1341,1595,T1
704,October 29,2010,Curaçao,Aruba,3,0,Friendly tournament,in Curaçao,9,-9,1123,930,1,-2,173,193,1114,939,T1
705,October 29,2010,Suriname,Bonaire,4,2,Friendly tournament,in Curaçao,9,-9,1242,983,1,0,145,187,1233,992,T1
706,October 31,2010,Aruba,Bonaire,3,3,Friendly tournament,in Curaçao,2,-2,932,981,1,0,192,187,930,983,draw
707,October 31,2010,Curaçao,Suriname,2,2,Friendly tournament,in Curaçao,1,-1,1124,1241,0,0,173,145,1123,1242,draw
708,November 2,2010,Guyana,Haiti,0,0,CONCACAF Champ &amp; Carib Champ qual,in Trinidad and Tobago,6,-6,1333,1427,3,-1,124,107,1327,1433,draw
709,November 2,2010,North Korea,Singapore,2,1,Friendly tournament,in Vietnam,9,-9,1503,1338,3,0,88,122,1494,1347,T1
710,November 2,2010,Trinidad and Tobago,Saint Vincent and the Grenadines,6,2,CONCACAF Champ &amp; Carib Champ qual,in Trinidad and Tobago,7,-7,1519,1220,2,-2,82,151,1512,1227,T1
711,November 4,2010,Haiti,Saint Vincent and the Grenadines,3,1,CONCACAF Champ &amp; Carib Champ qual,in Trinidad and Tobago,14,-14,1441,1206,3,-2,104,153,1427,1220,T1
712,November 4,2010,Trinidad and Tobago,Guyana,2,1,CONCACAF Champ &amp; Carib Champ qual,in Trinidad and Tobago,6,-6,1525,1327,0,-3,82,127,1519,1333,T1
713,November 4,2010,Vietnam,Singapore,1,1,Friendly tournament,in Vietnam,-4,4,1322,1342,-1,0,129,122,1326,1338,draw
714,November 6,2010,Guyana,Saint Vincent and the Grenadines,2,0,CONCACAF Champ &amp; Carib Champ qual,in Trinidad and Tobago,20,-20,1347,1186,5,-5,122,158,1327,1206,T1
715,November 6,2010,Trinidad and Tobago,Haiti,4,0,CONCACAF Champ &amp; Carib Champ qual,in Trinidad and Tobago,19,-19,1544,1422,5,-3,77,107,1525,1441,T1
716,November 6,2010,Vietnam,North Korea,0,2,Friendly tournament,in Vietnam,-17,17,1305,1520,-2,5,131,83,1322,1503,T2
717,November 7,2010,Yemen,Uganda,2,2,Friendly,in Yemen,3,-3,1369,1558,0,0,119,72,1366,1561,draw
718,November 10,2010,Antigua and Barbuda,Suriname,2,1,CONCACAF Champ &amp; Carib Champ qual,in Antigua and Barbuda,14,-14,1261,1227,3,-3,141,148,1247,1241,T1
719,November 10,2010,Bahrain,Uganda,0,0,Friendly,in Bahrain,-2,2,1539,1560,0,0,79,72,1541,1558,draw
720,November 10,2010,Cuba,Dominica,4,2,CONCACAF Champ &amp; Carib Champ qual,in Antigua and Barbuda,6,-6,1485,1092,2,0,93,176,1479,1098,T1
721,November 10,2010,Yemen,North Korea,1,1,Friendly,in Yemen,1,-1,1370,1519,0,0,119,83,1369,1520,draw
722,November 11,2010,Iraq,India,2,0,Friendly,in the United Arab Emirates,3,-3,1569,1188,0,0,70,157,1566,1191,T1
723,November 12,2010,Antigua and Barbuda,Dominica,0,0,CONCACAF Champ &amp; Carib Champ qual,in Antigua and Barbuda,-13,13,1248,1105,-2,0,143,176,1261,1092,draw
724,November 12,2010,Cuba,Suriname,3,3,CONCACAF Champ &amp; Carib Champ qual,in Antigua and Barbuda,-13,13,1472,1240,-2,3,95,145,1485,1227,draw
725,November 14,2010,Antigua and Barbuda,Cuba,0,0,CONCACAF Champ &amp; Carib Champ qual,in Antigua and Barbuda,7,-7,1255,1465,0,-2,143,97,1248,1472,draw
726,November 14,2010,Bahrain,Syria,0,2,Friendly,in Bahrain,-20,20,1519,1536,-4,5,83,79,1539,1516,T2
727,November 14,2010,Kuwait,India,9,1,Friendly,in the United Arab Emirates,5,-5,1549,1183,0,-1,77,158,1544,1188,T1
728,November 14,2010,Suriname,Dominica,5,0,CONCACAF Champ &amp; Carib Champ qual,in Antigua and Barbuda,25,-25,1265,1080,6,-1,139,177,1240,1105,T1
729,November 16,2010,Cape Verde,Guinea-Bissau,2,1,Friendly,in Portugal,6,-6,1404,1249,0,-1,111,144,1398,1255,T1
730,November 16,2010,Jordan,Cyprus,0,0,Friendly,in Jordan,-1,1,1480,1551,0,0,94,75,1481,1550,draw
731,November 16,2010,Saudi Arabia,Uganda,0,0,Friendly,in the United Arab Emirates,-4,4,1684,1564,-1,0,42,72,1688,1560,draw
732,November 16,2010,Scotland,Faroe Islands,3,0,Friendly,in Scotland,1,-1,1658,1209,0,0,46,152,1657,1210,T1
733,November 17,2010,Albania,Macedonia,0,0,Friendly,in Albania,-2,2,1527,1572,0,0,81,68,1529,1570,draw
734,November 17,2010,Argentina,Brazil,1,0,Friendly,in Qatar,14,-14,1992,2095,0,-1,5,3,1978,2109,T1
735,November 17,2010,Austria,Greece,1,2,Friendly,in Austria,-9,9,1605,1751,-3,2,58,27,1614,1742,T2
736,November 17,2010,Botswana,Tunisia,1,0,African Nations Cup qualifier,in Botswana,25,-25,1431,1578,4,-7,106,65,1406,1603,T1
737,November 17,2010,Bulgaria,Serbia,0,1,Friendly,in Bulgaria,-13,13,1707,1743,-3,5,37,28,1720,1730,T2
738,November 17,2010,Burkina Faso,Guinea,2,1,Friendly,in France,11,-11,1507,1518,2,-4,88,85,1496,1529,T1
739,November 17,2010,Chile,Uruguay,2,0,Friendly,in Chile,12,-12,1893,1891,0,-2,9,10,1881,1903,T1
740,November 17,2010,China,Latvia,1,0,Friendly,in China,5,-5,1615,1531,1,-1,56,80,1610,1536,T1
741,November 17,2010,Colombia,Peru,1,1,Friendly,in Colombia,-6,6,1764,1629,-1,1,25,52,1770,1623,draw
742,November 17,2010,Costa Rica,Jamaica,0,0,Friendly,in the United States,-1,1,1670,1627,1,-1,44,53,1671,1626,draw
743,November 17,2010,Croatia,Malta,3,0,European Championship qualifier,in Croatia,1,-1,1913,1204,0,0,7,153,1912,1205,T1
744,November 17,2010,Denmark,Czechia,0,0,Friendly,in Denmark,-3,3,1734,1742,-2,0,33,30,1737,1739,draw
745,November 17,2010,Ecuador,Venezuela,4,1,Friendly,in Ecuador,13,-13,1726,1705,3,-3,34,38,1713,1718,T1
746,November 17,2010,Egypt,Australia,3,0,Friendly,in Egypt,13,-13,1792,1776,5,-5,18,22,1779,1789,T1
747,November 17,2010,England,France,1,2,Friendly,in England,-16,16,1924,1802,0,2,6,17,1940,1786,T2
748,November 17,2010,Estonia,Liechtenstein,1,1,Friendly,in Estonia,-9,9,1490,1170,-3,3,92,163,1499,1161,draw
749,November 17,2010,Finland,San Marino,8,0,European Championship qualifier,in Finland,1,-1,1592,907,1,0,61,197,1591,908,T1
750,November 17,2010,Ghana,Saudi Arabia,0,0,Friendly,in the United Arab Emirates,-2,2,1743,1686,0,1,28,41,1745,1684,draw
751,November 17,2010,Guatemala,Guyana,3,0,Friendly,in the United States,13,-13,1460,1334,5,-2,97,124,1447,1347,T1
752,November 17,2010,Hong Kong,Paraguay,0,7,Friendly,in Hong Kong,-3,3,1216,1785,0,0,151,20,1219,1782,T2
753,November 17,2010,Hungary,Lithuania,2,0,Friendly,in Hungary,10,-10,1641,1590,0,-3,51,62,1631,1600,T1
754,November 17,2010,Iraq,Kuwait,1,1,Friendly,in the United Arab Emirates,-1,1,1568,1550,1,2,69,75,1569,1549,draw
755,November 17,2010,Ireland,Norway,1,2,Friendly,in Ireland,-12,12,1739,1809,-4,1,31,15,1751,1797,T2
756,November 17,2010,Israel,Iceland,3,2,Friendly,in Israel,2,-2,1686,1436,1,0,41,105,1684,1438,T1
757,November 17,2010,Italy,Romania,1,1,Friendly,in Austria,-4,4,1833,1713,1,3,12,36,1837,1709,draw
758,November 17,2010,Libya,Niger,1,1,Friendly tournament,in Libya,-11,11,1500,1308,-4,1,90,131,1511,1297,draw
759,November 17,2010,Luxembourg,Algeria,0,0,Friendly,in Luxembourg,6,-6,1112,1460,0,-1,175,97,1106,1466,draw
760,November 17,2010,Malawi,Rwanda,2,1,Friendly,in Malawi,6,-6,1402,1347,1,0,111,121,1396,1353,T1
761,November 17,2010,Mali,Democratic Republic of Congo,3,1,Friendly,in France,11,-11,1525,1397,3,-4,82,112,1514,1408,T1
762,November 17,2010,Montenegro,Azerbaijan,2,0,Friendly,in Montenegro,3,-3,1721,1458,0,-2,35,100,1718,1461,T1
763,November 17,2010,Netherlands,Turkey,1,0,Friendly,in the Netherlands,2,-2,2105,1778,1,1,2,21,2103,1780,T1
764,November 17,2010,Northern Ireland,Morocco,1,1,Friendly,in Northern Ireland,-3,3,1577,1568,-2,2,66,69,1580,1565,draw
765,November 17,2010,Oman,Belarus,0,4,Friendly,in Oman,-19,19,1538,1667,-5,4,78,46,1557,1648,T2
766,November 17,2010,Panama,Honduras,2,0,Friendly,in Panama,15,-15,1594,1672,5,-2,60,43,1579,1687,T1
767,November 17,2010,Poland,Ivory Coast,3,1,Friendly,in Poland,16,-16,1669,1766,2,-4,45,24,1653,1782,T1
768,November 17,2010,Portugal,Spain,4,0,Friendly,in Portugal,27,-27,1898,2116,2,0,8,1,1871,2143,T1
769,November 17,2010,Russia,Belgium,0,2,Friendly,in Russia,-27,27,1827,1620,-2,6,13,55,1854,1593,T2
770,November 17,2010,Senegal,Gabon,2,1,Friendly,in France,10,-10,1580,1563,4,-6,64,72,1570,1573,T1
771,November 17,2010,Slovakia,Bosnia and Herzegovina,2,3,Friendly,in Slovakia,-14,14,1658,1626,-3,2,47,54,1672,1612,T2
772,November 17,2010,Slovenia,Georgia,1,2,Friendly,in Slovenia,-17,17,1693,1507,-2,4,40,88,1710,1490,T2
773,November 17,2010,South Africa,United States,0,1,Friendly tournament,in South Africa,-14,14,1608,1768,-3,3,57,23,1622,1754,T2
774,November 17,2010,Sweden,Germany,0,0,Friendly,in Sweden,4,-4,1814,2067,0,0,14,4,1810,2071,draw
775,November 17,2010,Switzerland,Ukraine,2,2,Friendly,in Switzerland,-1,1,1754,1808,-1,-1,26,16,1755,1807,draw
776,November 17,2010,Tajikistan,Afghanistan,1,0,Friendly,in Tajikistan,1,-1,1274,779,0,0,138,210,1273,780,T1
777,November 17,2010,Togo,Chad,0,0,African Nations Cup qualifier,in Togo,-13,13,1382,1234,-2,2,115,147,1395,1221,draw
778,November 18,2010,Qatar,Haiti,0,1,Friendly,in Qatar,-15,15,1495,1437,-4,3,90,105,1510,1422,T2
779,November 18,2010,United Arab Emirates,India,5,0,Friendly,in the United Arab Emirates,5,-5,1436,1178,0,0,106,158,1431,1183,T1
780,November 21,2010,Indonesia,East Timor,6,0,Friendly,in Indonesia,0,0,1263,531,0,0,141,229,1263,531,T1
781,November 22,2010,Kuwait,Qatar,1,0,Gulf Cup,in Yemen,17,-17,1567,1478,4,-4,71,94,1550,1495,T1
782,November 22,2010,Yemen,Saudi Arabia,0,4,Gulf Cup,in Yemen,-17,17,1353,1703,-1,2,120,39,1370,1686,T2
783,November 23,2010,Bahrain,Oman,1,1,Gulf Cup,in Yemen,1,-1,1520,1537,0,0,83,78,1519,1538,draw
784,November 23,2010,Iraq,United Arab Emirates,0,0,Gulf Cup,in Yemen,-7,7,1561,1443,-4,2,73,104,1568,1436,draw
785,November 23,2010,Tanzania,Kenya,1,0,Friendly,in Tanzania,7,-7,1338,1324,2,-2,123,127,1331,1331,T1
786,November 24,2010,Indonesia,Taiwan,2,0,Friendly,in Indonesia,2,-2,1265,922,2,-1,139,196,1263,924,T1
787,November 25,2010,Kuwait,Saudi Arabia,0,0,Gulf Cup,in Yemen,7,-7,1574,1696,3,0,67,39,1567,1703,draw
788,November 25,2010,Yemen,Qatar,1,2,Gulf Cup,in Yemen,-19,19,1334,1497,-4,4,124,90,1353,1478,T2
789,November 26,2010,Cuba,Trinidad and Tobago,2,0,CONCACAF Champ qual &amp; Carib Champ,in Martinique,37,-37,1502,1507,8,-8,88,85,1465,1544,T1
790,November 26,2010,Iraq,Bahrain,3,2,Gulf Cup,in Yemen,18,-18,1579,1502,8,-5,65,88,1561,1520,T1
791,November 26,2010,Martinique,Grenada,1,1,CONCACAF Champ qual &amp; Carib Champ,in Martinique,-11,11,1378,1275,-4,3,117,138,1389,1264,draw
792,November 26,2010,Oman,United Arab Emirates,0,0,Gulf Cup,in Yemen,-5,5,1532,1448,0,1,78,103,1537,1443,draw
793,November 26,2010,Singapore,Laos,4,0,Friendly,in Singapore,1,-1,1343,861,0,-1,121,204,1342,862,T1
794,November 27,2010,Guadeloupe,Guyana,1,1,CONCACAF Champ qual &amp; Carib Champ,in Martinique,-9,9,1486,1343,-1,3,93,121,1495,1334,draw
795,November 27,2010,Jamaica,Antigua and Barbuda,3,1,CONCACAF Champ qual &amp; Carib Champ,in Martinique,6,-6,1633,1249,1,0,52,143,1627,1255,T1
796,November 27,2010,Tanzania,Zambia,0,1,CECAFA Cup,in Tanzania,-14,14,1324,1564,-4,4,126,72,1338,1550,T2
797,November 28,2010,Burundi,Somalia,2,0,CECAFA Cup,in Tanzania,10,-10,1213,914,2,-1,152,196,1203,924,T1
798,November 28,2010,Grenada,Trinidad and Tobago,1,0,CONCACAF Champ qual &amp; Carib Champ,in Martinique,32,-32,1307,1475,6,-10,132,95,1275,1507,T1
799,November 28,2010,Martinique,Cuba,0,1,CONCACAF Champ qual &amp; Carib Champ,in Martinique,-19,19,1359,1521,-2,6,119,82,1378,1502,T2
800,November 28,2010,Qatar,Saudi Arabia,1,1,Gulf Cup,in Yemen,10,-10,1507,1686,5,-2,86,41,1497,1696,draw
801,November 28,2010,Rwanda,Ivory Coast,2,1,CECAFA Cup,in Tanzania,37,-37,1384,1729,7,-9,113,33,1347,1766,T1
802,November 28,2010,Yemen,Kuwait,0,3,Gulf Cup,in Yemen,-22,22,1312,1596,-6,8,130,60,1334,1574,T2
803,November 28,2010,Zanzibar,Sudan,2,0,CECAFA Cup,in Tanzania,35,-35,1344,1331,10,-5,120,124,1309,1366,T1
804,November 29,2010,Antigua and Barbuda,Guyana,1,0,CONCACAF Champ qual &amp; Carib Champ,in Martinique,25,-25,1274,1318,4,-7,139,128,1249,1343,T1
805,November 29,2010,Iraq,Oman,0,0,Gulf Cup,in Yemen,-3,3,1576,1535,-2,0,68,78,1579,1532,draw
806,November 29,2010,Jamaica,Guadeloupe,2,0,CONCACAF Champ qual &amp; Carib Champ,in Martinique,18,-18,1651,1468,2,-4,50,96,1633,1486,T1
807,November 29,2010,Malawi,Kenya,3,2,CECAFA Cup,in Tanzania,16,-16,1418,1308,2,-4,109,130,1402,1324,T1
808,November 29,2010,United Arab Emirates,Bahrain,3,1,Gulf Cup,in Yemen,35,-35,1483,1467,11,-8,92,97,1448,1502,T1
809,November 29,2010,Uganda,Ethiopia,2,1,CECAFA Cup,in Tanzania,7,-7,1571,1277,1,0,71,138,1564,1284,T1
810,November 30,2010,Burundi,Zambia,0,0,CECAFA Cup,in Tanzania,15,-15,1228,1549,2,-3,150,76,1213,1564,draw
811,November 30,2010,Cuba,Grenada,0,0,CONCACAF Champ qual &amp; Carib Champ,in Martinique,-11,11,1510,1318,-2,4,84,128,1521,1307,draw
812,November 30,2010,Martinique,Trinidad and Tobago,0,1,CONCACAF Champ qual &amp; Carib Champ,in Martinique,-19,19,1340,1494,-2,4,121,90,1359,1475,T2
813,November 30,2010,Tanzania,Somalia,3,0,CECAFA Cup,in Tanzania,4,-4,1328,910,0,0,125,196,1324,914,T1
814,December 1,2010,Guadeloupe,Antigua and Barbuda,1,0,CONCACAF Champ qual &amp; Carib Champ,in Martinique,10,-10,1478,1264,1,-3,95,142,1468,1274,T1
815,December 1,2010,Indonesia,Malaysia,5,1,Southeast Asian Championship,in Indonesia,19,-19,1284,1157,3,-6,138,167,1265,1176,T1
816,December 1,2010,Ivory Coast,Zanzibar,1,0,CECAFA Cup,in Tanzania,4,-4,1733,1340,0,-1,33,120,1729,1344,T1
817,December 1,2010,Jamaica,Guyana,4,0,CONCACAF Champ qual &amp; Carib Champ,in Martinique,10,-10,1661,1308,3,-2,47,130,1651,1318,T1
818,December 1,2010,Laos,Thailand,2,2,Southeast Asian Championship,in Indonesia,19,-19,880,1437,3,-3,201,105,861,1456,draw
819,December 1,2010,Rwanda,Sudan,0,0,CECAFA Cup,in Tanzania,-3,3,1381,1334,-2,0,115,123,1384,1331,draw
820,December 2,2010,Ethiopia,Kenya,2,1,CECAFA Cup,in Tanzania,22,-22,1299,1286,6,-8,133,138,1277,1308,T1
821,December 2,2010,Iraq,Kuwait,2,2,Gulf Cup,in Yemen,1,-1,1577,1595,1,0,67,60,1576,1596,draw
822,December 2,2010,Malawi,Uganda,1,1,CECAFA Cup,in Tanzania,8,-8,1426,1563,0,-1,109,72,1418,1571,draw
823,December 2,2010,Philippines,Singapore,1,1,Southeast Asian Championship,in Vietnam,18,-18,881,1325,2,-6,201,125,863,1343,draw
824,December 2,2010,Saudi Arabia,United Arab Emirates,1,0,Gulf Cup,in Yemen,9,-9,1695,1474,1,-2,40,95,1686,1483,T1
825,December 2,2010,Vietnam,Myanmar,7,1,Southeast Asian Championship,in Vietnam,17,-17,1322,1147,6,-5,127,169,1305,1164,T1
826,December 3,2010,Guadeloupe,Cuba,2,1,Caribbean Championship,in Martinique,22,-22,1500,1488,6,-8,88,92,1478,1510,T1
827,December 3,2010,Jamaica,Grenada,2,1,Caribbean Championship,in Martinique,5,-5,1666,1313,0,0,47,129,1661,1318,T1
828,December 3,2010,Rwanda,Zanzibar,0,0,CECAFA Cup,in Tanzania,-2,2,1379,1342,-1,0,116,119,1381,1340,draw
829,December 3,2010,Zambia,Somalia,6,0,CECAFA Cup,in Tanzania,2,-2,1551,908,1,0,75,196,1549,910,T1
830,December 4,2010,Ethiopia,Malawi,1,1,CECAFA Cup,in Tanzania,7,-7,1306,1419,0,0,133,109,1299,1426,draw
831,December 4,2010,Indonesia,Laos,6,0,Southeast Asian Championship,in Indonesia,4,-4,1288,876,2,0,137,202,1284,880,T1
832,December 4,2010,Malaysia,Thailand,0,0,Southeast Asian Championship,in Indonesia,13,-13,1170,1424,4,-3,162,108,1157,1437,draw
833,December 4,2010,Tanzania,Burundi,2,0,CECAFA Cup,in Tanzania,14,-14,1342,1214,5,-2,119,152,1328,1228,T1
834,December 5,2010,Cuba,Grenada,1,0,Caribbean Championship,in Martinique,11,-11,1499,1302,2,-3,90,132,1488,1313,T1
835,December 5,2010,Guadeloupe,Jamaica,1,1,Caribbean Championship,in Martinique,9,-9,1509,1657,3,-2,85,49,1500,1666,draw
836,December 5,2010,Ivory Coast,Sudan,3,0,CECAFA Cup,in Tanzania,6,-6,1739,1328,3,-2,30,125,1733,1334,T1
837,December 5,2010,Kuwait,Saudi Arabia,1,0,Gulf Cup,in Yemen,26,-26,1621,1669,5,-4,55,44,1595,1695,T1
838,December 5,2010,Singapore,Myanmar,2,1,Southeast Asian Championship,in Vietnam,11,-11,1336,1136,2,-1,123,170,1325,1147,T1
839,December 5,2010,Uganda,Kenya,2,0,CECAFA Cup,in Tanzania,10,-10,1573,1276,3,1,69,138,1563,1286,T1
840,December 5,2010,Vietnam,Philippines,0,2,Southeast Asian Championship,in Vietnam,-57,57,1265,938,-13,10,140,191,1322,881,T2
841,December 7,2010,Ethiopia,Zambia,2,1,CECAFA Cup,in Tanzania,32,-32,1338,1519,9,-6,122,81,1306,1551,T1
842,December 7,2010,Indonesia,Thailand,2,1,Southeast Asian Championship,in Indonesia,22,-22,1310,1402,6,-3,130,111,1288,1424,T1
843,December 7,2010,Ivory Coast,Malawi,1,0,CECAFA Cup,in Tanzania,5,-5,1744,1414,3,1,27,108,1739,1419,T1
844,December 7,2010,Malaysia,Laos,5,1,Southeast Asian Championship,in Indonesia,12,-12,1182,864,4,-1,158,203,1170,876,T1
845,December 8,2010,Myanmar,Philippines,0,0,Southeast Asian Championship,in Vietnam,-10,10,1126,948,0,0,170,191,1136,938,draw
846,December 8,2010,Tanzania,Rwanda,1,0,CECAFA Cup,in Tanzania,16,-16,1358,1363,0,-2,119,118,1342,1379,T1
847,December 8,2010,Uganda,Zanzibar,2,2,CECAFA Cup,in Tanzania,-12,12,1561,1354,-4,-1,73,120,1573,1342,draw
848,December 8,2010,Vietnam,Singapore,1,0,Southeast Asian Championship,in Vietnam,18,-18,1283,1318,2,-4,138,128,1265,1336,T1
849,December 10,2010,Bosnia and Herzegovina,Poland,2,2,Friendly,in Turkey,1,-1,1627,1668,0,-1,54,45,1626,1669,draw
850,December 10,2010,Ivory Coast,Ethiopia,1,0,CECAFA Cup,in Tanzania,4,-4,1748,1334,0,-1,27,123,1744,1338,T1
851,December 10,2010,Tanzania,Uganda,0,0,CECAFA Cup,in Tanzania,6,-6,1364,1555,1,0,118,73,1358,1561,draw
852,December 12,2010,Tanzania,Ivory Coast,1,0,CECAFA Cup,in Tanzania,33,-33,1397,1715,6,-8,112,35,1364,1748,T1
853,December 12,2010,Uganda,Ethiopia,4,3,CECAFA Cup,in Tanzania,9,-9,1564,1325,1,-2,72,125,1555,1334,T1
854,December 15,2010,Malaysia,Vietnam,2,0,Southeast Asian Championship,in Malaysia,30,-30,1212,1253,5,-5,153,143,1182,1283,T1
855,December 16,2010,Indonesia,Philippines,1,0,Southeast Asian Championship,in Indonesia,3,-3,1313,945,1,0,129,191,1310,948,T1
856,December 16,2010,Qatar,Egypt,2,1,Friendly,in Qatar,15,-15,1522,1777,5,-3,81,21,1507,1792,T1
857,December 18,2010,China,Estonia,3,0,Friendly,in China,8,-8,1623,1482,2,-1,55,93,1615,1490,T1
858,December 18,2010,Honduras,Panama,2,1,Friendly,in Honduras,5,-5,1677,1589,0,-2,42,63,1672,1594,T1
859,December 18,2010,Iraq,Syria,0,1,Friendly,in Iraq,-14,14,1563,1550,-5,0,72,76,1577,1536,T2
860,December 18,2010,Vietnam,Malaysia,0,0,Southeast Asian Championship,in Vietnam,-8,8,1245,1220,-2,2,145,151,1253,1212,draw
861,December 19,2010,Indonesia,Philippines,1,0,Southeast Asian Championship,in Indonesia,3,-3,1316,942,0,0,129,191,1313,945,T1
862,December 22,2010,China,Macedonia,1,0,Friendly,in China,6,-6,1629,1566,2,-2,53,71,1623,1572,T1
863,December 22,2010,Qatar,Estonia,2,0,Friendly,in Qatar,9,-9,1531,1473,3,-2,78,95,1522,1482,T1
864,December 22,2010,Syria,Iraq,0,1,Friendly,in Syria,-12,12,1538,1575,0,4,76,68,1550,1563,T2
865,December 24,2010,Kuwait,North Korea,2,1,Friendly,in Egypt,7,-7,1628,1512,1,-2,55,84,1621,1519,T1
866,December 25,2010,Bahrain,Uzbekistan,1,1,Friendly,in the United Arab Emirates,1,-1,1468,1509,0,0,97,85,1467,1510,draw
867,December 26,2010,Malaysia,Indonesia,3,0,Southeast Asian Championship,in Malaysia,35,-35,1255,1281,8,-8,143,137,1220,1316,T1
868,December 27,2010,Kuwait,North Korea,2,2,Friendly,in Egypt,-3,3,1625,1515,-1,0,56,84,1628,1512,draw
869,December 28,2010,Algeria,Chad,3,1,Friendly,in Algeria,4,-4,1464,1230,0,-1,98,149,1460,1234,T1
870,December 28,2010,Bahrain,Jordan,2,1,Friendly,in the United Arab Emirates,10,-10,1478,1470,4,-3,93,96,1468,1480,T1
871,December 28,2010,Qatar,Iran,0,0,Friendly,in Qatar,2,-2,1533,1694,0,0,78,39,1531,1696,draw
872,December 28,2010,Saudi Arabia,Iraq,0,1,Friendly,in Saudi Arabia,-15,15,1654,1590,-5,6,49,62,1669,1575,T2
873,December 29,2010,Indonesia,Malaysia,2,1,Southeast Asian Championship,in Indonesia,13,-13,1294,1242,3,-3,134,146,1281,1255,T1
874,December 30,2010,South Korea,Syria,1,0,Friendly,in the United Arab Emirates,5,-5,1742,1533,2,-1,29,77,1737,1538,T1
875,December 31,2010,Bahrain,Saudi Arabia,0,1,Friendly,in Bahrain,-8,8,1470,1662,-2,3,95,46,1478,1654,T2
876,December 31,2010,Kuwait,Zambia,4,0,Friendly,in Egypt,13,-13,1638,1506,3,-6,53,88,1625,1519,T1
877,January 2,2011,China,Iraq,3,2,Friendly,in Qatar,9,-9,1638,1581,1,-2,53,64,1629,1590,T1
878,January 2,2011,Iran,Angola,1,0,Friendly,in Qatar,4,-4,1698,1455,0,-1,39,101,1694,1459,T1
879,January 2,2011,Jordan,Uzbekistan,2,2,Friendly,in the United Arab Emirates,1,-1,1471,1508,0,-1,95,85,1470,1509,draw
880,January 2,2011,United Arab Emirates,Syria,2,0,Friendly,in the United Arab Emirates,13,-13,1487,1520,1,-4,92,81,1474,1533,T1
881,January 4,2011,Bahrain,North Korea,0,1,Friendly,in Bahrain,-11,11,1459,1539,-4,2,100,76,1470,1528,T2
882,January 4,2011,Saudi Arabia,Angola,0,0,Friendly,in Saudi Arabia,-7,7,1655,1462,-3,3,49,98,1662,1455,draw
883,January 5,2011,Egypt,Tanzania,5,1,Friendly tournament,in Egypt,3,-3,1780,1394,1,-1,20,113,1777,1397,T1
884,January 5,2011,Kenya,Sudan,1,0,Friendly tournament,in Egypt,17,-17,1293,1311,3,-5,135,129,1276,1328,T1
885,January 5,2011,United Arab Emirates,Australia,0,0,Friendly,in the United Arab Emirates,5,-5,1492,1771,0,0,92,22,1487,1776,draw
886,January 5,2011,Uganda,Burundi,3,1,Friendly tournament,in Egypt,5,-5,1569,1209,2,0,70,153,1564,1214,T1
887,January 7,2011,Qatar,Uzbekistan,0,2,Asian Cup,in Qatar,-49,49,1471,1557,-13,11,94,74,1520,1508,T2
888,January 8,2011,Burundi,Tanzania,1,1,Friendly tournament,in Egypt,7,-7,1216,1387,1,0,152,113,1209,1394,draw
889,January 8,2011,China,Kuwait,2,0,Asian Cup,in Qatar,38,-38,1676,1600,10,-6,43,59,1638,1638,T1
890,January 8,2011,Democratic Republic of Congo,Kenya,1,0,Friendly tournament,in Egypt,11,-11,1408,1282,3,-3,109,138,1397,1293,T1
891,January 8,2011,Egypt,Uganda,1,0,Friendly tournament,in Egypt,4,-4,1784,1565,0,-2,20,72,1780,1569,T1
892,January 9,2011,Japan,Jordan,1,1,Asian Cup,in Qatar,-18,18,1769,1489,-4,2,22,92,1787,1471,draw
893,January 9,2011,Syria,Saudi Arabia,2,1,Asian Cup,in Qatar,34,-34,1554,1621,7,-5,75,55,1520,1655,T1
894,January 10,2011,Australia,India,4,0,Asian Cup,in Qatar,3,-3,1774,1175,0,-2,21,161,1771,1178,T1
895,January 10,2011,South Korea,Bahrain,2,1,Asian Cup,in Qatar,8,-8,1750,1451,2,-2,27,102,1742,1459,T1
896,January 11,2011,Democratic Republic of Congo,Sudan,2,1,Friendly tournament,in Egypt,11,-11,1419,1300,1,-3,108,132,1408,1311,T1
897,January 11,2011,Egypt,Burundi,3,0,Friendly tournament,in Egypt,1,-1,1785,1215,1,-1,18,153,1784,1216,T1
898,January 11,2011,Iran,Iraq,2,1,Asian Cup,in Qatar,17,-17,1715,1564,4,-7,35,71,1698,1581,T1
899,January 11,2011,North Korea,United Arab Emirates,0,0,Asian Cup,in Qatar,-3,3,1536,1495,0,1,78,90,1539,1492,draw
900,January 11,2011,Tanzania,Uganda,1,1,Friendly tournament,in Egypt,7,-7,1394,1558,0,-1,113,73,1387,1565,draw
901,January 12,2011,Qatar,China,2,0,Asian Cup,in Qatar,49,-49,1520,1627,12,-10,83,53,1471,1676,T1
902,January 12,2011,Uzbekistan,Kuwait,2,1,Asian Cup,in Qatar,28,-28,1585,1572,11,-10,63,69,1557,1600,T1
903,January 13,2011,Japan,Syria,2,1,Asian Cup,in Qatar,11,-11,1780,1543,2,-2,20,77,1769,1554,T1
904,January 13,2011,Jordan,Saudi Arabia,1,0,Asian Cup,in Qatar,34,-34,1523,1587,10,-7,83,62,1489,1621,T1
905,January 14,2011,Australia,South Korea,1,1,Asian Cup,in Qatar,-2,2,1772,1752,0,1,22,26,1774,1750,draw
906,January 14,2011,Bahrain,India,5,2,Asian Cup,in Qatar,15,-15,1466,1160,5,-4,97,165,1451,1175,T1
907,January 14,2011,Costa Rica,Honduras,1,1,CONCACAF Champ q &amp; Central Am Cup,in Panama,0,0,1670,1677,0,0,43,42,1670,1677,draw
908,January 14,2011,Egypt,Kenya,5,1,Friendly tournament,in Egypt,2,-2,1787,1280,0,0,18,138,1785,1282,T1
909,January 14,2011,El Salvador,Nicaragua,2,0,CONCACAF Champ q &amp; Central Am Cup,in Panama,5,-5,1489,1070,0,-1,94,179,1484,1075,T1
910,January 14,2011,Panama,Belize,2,0,CONCACAF Champ q &amp; Central Am Cup,in Panama,2,-2,1591,1082,1,0,60,176,1589,1084,T1
911,January 14,2011,Uganda,Democratic Republic of Congo,1,0,Friendly tournament,in Egypt,9,-9,1567,1410,3,-1,71,109,1558,1419,T1
912,January 15,2011,Iran,North Korea,1,0,Asian Cup,in Qatar,13,-13,1728,1523,2,-4,33,82,1715,1536,T1
913,January 15,2011,Iraq,United Arab Emirates,1,0,Asian Cup,in Qatar,20,-20,1584,1475,9,-2,64,94,1564,1495,T1
914,January 16,2011,China,Uzbekistan,2,2,Asian Cup,in Qatar,-3,3,1624,1588,-1,1,54,62,1627,1585,draw
915,January 16,2011,Costa Rica,Guatemala,2,0,CONCACAF Champ q &amp; Central Am Cup,in Panama,14,-14,1684,1446,1,-2,42,102,1670,1460,T1
916,January 16,2011,El Salvador,Belize,5,2,CONCACAF Champ q &amp; Central Am Cup,in Panama,6,-6,1495,1076,1,-1,92,177,1489,1082,T1
917,January 16,2011,Panama,Nicaragua,2,0,CONCACAF Champ q &amp; Central Am Cup,in Panama,2,-2,1593,1068,1,0,59,179,1591,1070,T1
918,January 16,2011,Qatar,Kuwait,3,0,Asian Cup,in Qatar,38,-38,1558,1534,10,-9,74,79,1520,1572,T1
919,January 16,2011,Sudan,Tanzania,2,0,Friendly tournament,in Egypt,28,-28,1328,1366,8,-5,124,118,1300,1394,T1
920,January 17,2011,Democratic Republic of Congo,Kenya,1,0,Friendly tournament,in Egypt,10,-10,1420,1270,1,-1,108,139,1410,1280,T1
921,January 17,2011,Egypt,Uganda,3,1,Friendly tournament,in Egypt,6,-6,1793,1561,-1,-2,19,73,1787,1567,T1
922,January 17,2011,Japan,Saudi Arabia,5,0,Asian Cup,in Qatar,25,-25,1805,1562,3,-9,17,72,1780,1587,T1
923,January 17,2011,Jordan,Syria,2,1,Asian Cup,in Qatar,26,-26,1549,1517,6,-8,77,85,1523,1543,T1
924,January 18,2011,Australia,Bahrain,1,0,Asian Cup,in Qatar,7,-7,1779,1459,1,-2,21,99,1772,1466,T1
925,January 18,2011,Belize,Nicaragua,1,1,CONCACAF Champ q &amp; Central Am Cup,in Panama,0,0,1076,1068,0,0,177,179,1076,1068,draw
926,January 18,2011,Honduras,Guatemala,3,1,CONCACAF Champ q &amp; Central Am Cup,in Panama,13,-13,1690,1433,2,-4,41,106,1677,1446,T1
927,January 18,2011,Panama,El Salvador,2,0,CONCACAF Champ q &amp; Central Am Cup,in Panama,15,-15,1608,1480,3,-1,56,93,1593,1495,T1
928,January 18,2011,South Korea,India,4,1,Asian Cup,in Qatar,3,-3,1755,1157,1,-1,25,166,1752,1160,T1
929,January 19,2011,Iran,United Arab Emirates,3,0,Asian Cup,in Qatar,17,-17,1745,1458,5,-5,28,99,1728,1475,T1
930,January 19,2011,Iraq,North Korea,1,0,Asian Cup,in Qatar,21,-21,1605,1502,5,-6,58,89,1584,1523,T1
931,January 19,2011,Sweden,Botswana,2,1,Friendly,in South Africa,2,-2,1816,1429,0,0,14,107,1814,1431,T1
932,January 21,2011,Guatemala,Nicaragua,2,1,CONCACAF Champ q &amp; Central Am Cup,in Panama,4,-4,1437,1064,2,0,104,179,1433,1068,T1
933,January 21,2011,Honduras,El Salvador,2,0,Central American Cup,in Panama,14,-14,1704,1466,1,-2,40,95,1690,1480,T1
934,January 21,2011,Panama,Costa Rica,1,1,Central American Cup,in Panama,-1,1,1607,1685,-2,0,58,43,1608,1684,draw
935,January 21,2011,Qatar,Japan,2,3,Asian Cup,in Qatar,-15,15,1543,1820,-2,3,76,14,1558,1805,T2
936,January 21,2011,Uzbekistan,Jordan,2,1,Asian Cup,in Qatar,22,-22,1610,1527,7,-3,56,80,1588,1549,T1
937,January 22,2011,Australia,Iraq,1,0,Asian Cup,in Qatar,13,-13,1792,1592,1,-2,20,61,1779,1605,T1
938,January 22,2011,South Korea,Iran,1,0,Asian Cup,in Qatar,24,-24,1779,1721,3,-6,22,34,1755,1745,T1
939,January 22,2011,United States,Chile,1,1,Friendly,in the United States,1,-1,1769,1892,-1,0,24,9,1768,1893,draw
940,January 23,2011,Honduras,Costa Rica,2,1,Central American Cup,in Panama,19,-19,1723,1666,6,-2,34,45,1704,1685,T1
941,January 23,2011,Panama,El Salvador,0,0,Central American Cup,in Panama,-12,12,1595,1478,-2,2,60,93,1607,1466,draw
942,January 24,2011,Vanuatu,New Caledonia,0,0,Friendly,in Vanuatu,-1,1,1229,1290,-1,0,150,136,1230,1289,draw
943,January 25,2011,Australia,Uzbekistan,6,0,Asian Cup,in Qatar,28,-28,1820,1582,6,-7,14,63,1792,1610,T1
944,January 25,2011,Japan,South Korea,2,2,Asian Cup,in Qatar,-3,3,1817,1782,-1,0,15,22,1820,1779,draw
945,January 28,2011,South Korea,Uzbekistan,3,2,Asian Cup,in Qatar,12,-12,1794,1570,2,-5,20,68,1782,1582,T1
946,January 29,2011,Japan,Australia,1,0,Asian Cup,in Qatar,25,-25,1842,1795,3,-5,12,19,1817,1820,T1
947,February 6,2011,Poland,Moldova,1,0,Friendly,in Portugal,5,-5,1673,1465,0,0,43,95,1668,1470,T1
948,February 8,2011,Cyprus,Sweden,0,2,Friendly tournament,in Cyprus,-13,13,1538,1829,-1,1,76,14,1551,1816,T2
949,February 8,2011,Equatorial Guinea,Chad,2,0,Friendly,in Equatorial Guinea,12,-12,1213,1218,2,-2,154,151,1201,1230,T1
950,February 8,2011,Ghana,Togo,4,1,Friendly,in Belgium,4,-4,1747,1378,0,-2,28,116,1743,1382,T1
951,February 8,2011,Ireland,Wales,3,0,Friendly tournament,in Ireland,8,-8,1747,1545,3,0,28,74,1739,1553,T1
952,February 8,2011,Ivory Coast,Mali,1,0,Friendly,in France,5,-5,1720,1520,0,0,37,82,1715,1525,T1
953,February 8,2011,Peru,Panama,1,0,Friendly,in Peru,6,-6,1635,1589,0,-3,52,62,1629,1595,T1
954,February 8,2011,Romania,Ukraine,2,2,Friendly tournament,in Cyprus,4,-4,1717,1804,0,0,38,17,1713,1808,draw
955,February 9,2011,Albania,Slovenia,1,2,Friendly,in Albania,-8,8,1519,1701,-2,1,82,40,1527,1693,T2
956,February 9,2011,Argentina,Portugal,2,1,Friendly,in Switzerland,7,-7,1999,1891,0,-1,5,9,1992,1898,T1
957,February 9,2011,Belarus,Kazakhstan,1,1,Friendly,in Turkey,-8,8,1659,1328,-3,3,47,124,1667,1320,draw
958,February 9,2011,Belgium,Finland,1,1,Friendly,in Belgium,-4,4,1616,1596,0,1,55,58,1620,1592,draw
959,February 9,2011,Cambodia,Macao,3,1,Asian Cup &amp; Asian Challenge Cup qual,in Cambodia,13,-13,814,658,0,0,207,220,801,671,T1
960,February 9,2011,Cape Verde,Burkina Faso,1,0,Friendly,in Portugal,13,-13,1417,1494,2,-5,109,91,1404,1507,T1
961,February 9,2011,Croatia,Czechia,4,2,Friendly,in Croatia,5,-5,1918,1737,0,0,7,31,1913,1742,T1
962,February 9,2011,Cyprus,Romania,1,1,Friendly tournament,in Cyprus,3,-3,1541,1714,0,0,76,38,1538,1717,draw
963,February 9,2011,Denmark,England,1,2,Friendly,in Denmark,-7,7,1727,1931,-2,0,34,6,1734,1924,T2
964,February 9,2011,El Salvador,Haiti,1,0,Friendly,in El Salvador,6,-6,1484,1431,0,-2,93,106,1478,1437,T1
965,February 9,2011,France,Brazil,1,0,Friendly,in France,15,-15,1817,2080,3,0,15,3,1802,2095,T1
966,February 9,2011,Gabon,Democratic Republic of Congo,2,0,Friendly,in France,9,-9,1572,1411,4,-2,67,110,1563,1420,T1
967,February 9,2011,Georgia,Armenia,2,1,Friendly,in Cyprus,8,-8,1515,1433,2,-2,84,105,1507,1441,T1
968,February 9,2011,Germany,Italy,1,1,Friendly,in Germany,-7,7,2060,1840,0,0,4,13,2067,1833,draw
969,February 9,2011,Greece,Canada,1,0,Friendly,in Greece,4,-4,1755,1596,0,0,27,58,1751,1600,T1
970,February 9,2011,Guinea-Bissau,Gambia,3,1,Friendly,in Portugal,21,-21,1270,1386,4,-2,139,112,1249,1407,T1
971,February 9,2011,Honduras,Ecuador,1,1,Friendly,in Honduras,-3,3,1720,1729,-2,0,36,33,1723,1726,draw
972,February 9,2011,Hungary,Azerbaijan,2,0,Friendly,in the United Arab Emirates,8,-8,1649,1450,1,-2,50,101,1641,1458,T1
973,February 9,2011,Iran,Russia,1,0,Friendly,in the United Arab Emirates,13,-13,1734,1814,3,-1,32,16,1721,1827,T1
974,February 9,2011,Israel,Serbia,0,2,Friendly,in Israel,-17,17,1669,1760,-3,4,45,26,1686,1743,T2
975,February 9,2011,Libya,Benin,3,2,Friendly,in Libya,6,-6,1506,1440,2,0,88,102,1500,1446,T1
976,February 9,2011,Luxembourg,Slovakia,2,1,Friendly,in Luxembourg,19,-19,1131,1639,5,-5,170,51,1112,1658,T1
977,February 9,2011,Macedonia,Cameroon,0,1,Friendly,in Macedonia,-10,10,1556,1660,-3,4,73,46,1566,1650,T2
978,February 9,2011,Malaysia,Hong Kong,2,0,Friendly,in Malaysia,10,-10,1252,1206,2,-4,144,156,1242,1216,T1
979,February 9,2011,Malta,Switzerland,0,0,Friendly,in Malta,9,-9,1213,1745,3,-4,153,30,1204,1754,draw
980,February 9,2011,Mexico,Bosnia and Herzegovina,2,0,Friendly,in the United States,7,-7,1854,1620,0,-1,11,54,1847,1627,T1
981,February 9,2011,Moldova,Andorra,2,1,Friendly,in Portugal,1,-1,1466,1012,0,0,95,185,1465,1013,T1
982,February 9,2011,Morocco,Niger,3,0,Friendly,in Morocco,4,-4,1572,1304,2,-1,67,131,1568,1308,T1
983,February 9,2011,Mozambique,Botswana,1,1,Friendly,in Mozambique,-1,1,1380,1430,0,0,114,107,1381,1429,draw
984,February 9,2011,Namibia,Malawi,1,2,Friendly,in Namibia,-9,9,1284,1423,-2,1,137,108,1293,1414,T2
985,February 9,2011,Netherlands,Austria,3,1,Friendly,in the Netherlands,1,-1,2106,1604,0,0,2,57,2105,1605,T1
986,February 9,2011,Nigeria,Sierra Leone,2,1,Friendly,in Nigeria,1,-1,1654,1294,0,0,49,133,1653,1295,T1
987,February 9,2011,Philippines,Mongolia,2,0,Asian Cup &amp; Asian Challenge Cup qual,in the Philippines,12,-12,954,782,0,-1,191,209,942,794,T1
988,February 9,2011,Poland,Norway,1,0,Friendly,in Portugal,14,-14,1687,1795,1,-3,42,19,1673,1809,T1
989,February 9,2011,San Marino,Liechtenstein,0,1,Friendly,in San Marino,-6,6,901,1176,0,1,198,161,907,1170,T2
990,February 9,2011,Scotland,Northern Ireland,3,0,Friendly tournament,in Ireland,20,-20,1678,1557,3,-6,43,72,1658,1577,T1
991,February 9,2011,Senegal,Guinea,3,0,Friendly,in Senegal,10,-10,1590,1508,3,-4,61,87,1580,1518,T1
992,February 9,2011,South Africa,Kenya,2,0,Friendly,in South Africa,2,-2,1610,1268,0,-1,56,140,1608,1270,T1
993,February 9,2011,Spain,Colombia,1,0,Friendly,in Spain,1,-1,2117,1763,0,0,1,25,2116,1764,T1
994,February 9,2011,Swaziland,Zambia,0,4,Friendly,in Swaziland,-7,7,1144,1513,0,3,168,85,1151,1506,T2
995,February 9,2011,Sweden,Ukraine,1,1,Friendly tournament,in Cyprus,-1,1,1828,1805,0,0,14,17,1829,1804,draw
996,February 9,2011,Tanzania,Palestine,1,0,Friendly,in Tanzania,3,-3,1369,1156,0,-1,118,166,1366,1159,T1
997,February 9,2011,Turkey,South Korea,0,0,Friendly,in Turkey,-2,2,1776,1796,0,2,23,18,1778,1794,draw
998,February 9,2011,Venezuela,Costa Rica,2,2,Friendly,in Venezuela,-4,4,1701,1670,0,1,40,44,1705,1666,draw
999,February 10,2011,Taiwan,Laos,5,2,Asian Cup &amp; Asian Challenge Cup qual,in Taiwan,20,-20,942,844,4,-1,192,204,922,864,T1
1000,February 14,2011,Bahrain,Kuwait,0,0,Friendly,in Bahrain,-1,1,1458,1535,0,1,98,77,1459,1534,draw
1001,February 16,2011,Laos,Taiwan,1,1,Asian Cup &amp; Asian Challenge Cup qual,in Laos,0,0,844,942,0,0,204,192,844,942,draw
1002,February 16,2011,Macao,Cambodia,3,2,Asian Cup &amp; Asian Challenge Cup qual,in Macao,23,-23,681,791,1,-1,219,208,658,814,T1
1003,March 11,2011,Gibraltar,Faroe Islands,3,0,Friendly,in Gibraltar,17,-17,1143,1192,2,-2,169,157,1126,1209,T1
1004,March 15,2011,Mongolia,Philippines,2,1,Asian Cup &amp; Asian Challenge Cup qual,in Mongolia,24,-24,806,930,2,-4,207,195,782,954,T1
1005,March 16,2011,Argentina,Venezuela,4,1,Friendly,in Argentina,3,-3,2002,1698,0,-1,5,41,1999,1701,T1
1006,March 16,2011,Botswana,Namibia,1,1,Friendly,in Botswana,-6,6,1424,1290,0,2,107,135,1430,1284,draw
1007,March 17,2011,Nepal,Bhutan,1,0,Friendly,in Nepal,1,-1,963,597,0,0,188,224,962,598,T1
1008,March 19,2011,Nepal,Bhutan,2,1,Friendly,in Nepal,1,-1,964,596,0,0,188,224,963,597,T1
1009,March 21,2011,India,Taiwan,3,0,Asian Cup &amp; Asian Challenge Cup qual,in Malaysia,16,-16,1173,926,3,-4,162,195,1157,942,T1
1010,March 21,2011,Maldives,Cambodia,4,0,Asian Cup &amp; Asian Challenge Cup qual,in the Maldives,6,-6,1122,785,1,0,174,209,1116,791,T1
1011,March 21,2011,Myanmar,Philippines,1,1,Asian Cup &amp; Asian Challenge Cup qual,in Myanmar,-14,14,1112,944,-3,4,175,191,1126,930,draw
1012,March 21,2011,Palestine,Bangladesh,2,0,Asian Cup &amp; Asian Challenge Cup qual,in Myanmar,13,-13,1169,923,2,-4,164,196,1156,936,T1
1013,March 21,2011,Tajikistan,Kyrgyzstan,1,0,Asian Cup &amp; Asian Challenge Cup qual,in the Maldives,14,-14,1288,1152,1,-4,137,167,1274,1166,T1
1014,March 21,2011,Turkmenistan,Pakistan,3,0,Asian Cup &amp; Asian Challenge Cup qual,in Malaysia,4,-4,1377,887,0,-1,117,200,1373,891,T1
1015,March 23,2011,Afghanistan,Bhutan,3,0,Asian Cup &amp; Asian Challenge Cup qual,in India,18,-18,797,578,2,-2,208,226,779,596,T1
1016,March 23,2011,India,Pakistan,3,1,Asian Cup &amp; Asian Challenge Cup qual,in Malaysia,10,-10,1183,877,3,-1,159,201,1173,887,T1
1017,March 23,2011,Maldives,Kyrgyzstan,2,1,Asian Cup &amp; Asian Challenge Cup qual,in the Maldives,16,-16,1138,1136,4,-4,170,171,1122,1152,T1
1018,March 23,2011,Myanmar,Bangladesh,0,2,Asian Cup &amp; Asian Challenge Cup qual,in Myanmar,-50,50,1062,973,-4,8,179,188,1112,923,T2
1019,March 23,2011,Palestine,Philippines,0,0,Asian Cup &amp; Asian Challenge Cup qual,in Myanmar,-11,11,1158,955,-1,-1,165,192,1169,944,draw
1020,March 23,2011,Tajikistan,Cambodia,3,0,Asian Cup &amp; Asian Challenge Cup qual,in the Maldives,4,-4,1292,781,2,-1,135,210,1288,785,T1
1021,March 23,2011,Turkmenistan,Taiwan,2,0,Asian Cup &amp; Asian Challenge Cup qual,in Malaysia,4,-4,1381,922,3,-1,114,196,1377,926,T1
1022,March 24,2011,Cuba,El Salvador,0,1,Friendly,in Cuba,-13,13,1486,1497,-3,3,93,90,1499,1484,T2
1023,March 25,2011,Afghanistan,Bhutan,2,0,Asian Cup &amp; Asian Challenge Cup qual,in India,13,-13,810,565,1,-1,207,227,797,578,T1
1024,March 25,2011,Austria,Belgium,0,2,European Championship qualifier,in Austria,-37,37,1567,1653,-11,6,68,49,1604,1616,T2
1025,March 25,2011,China,New Zealand,1,1,Friendly,in China,-4,4,1620,1577,-1,2,54,64,1624,1573,draw
1026,March 25,2011,Estonia,Uruguay,2,0,Friendly,in Estonia,26,-26,1499,1865,4,-1,90,10,1473,1891,T1
1027,March 25,2011,Hungary,Netherlands,0,4,European Championship qualifier,in Hungary,-9,9,1640,2115,0,0,50,2,1649,2106,T2
1028,March 25,2011,India,Turkmenistan,1,1,Asian Cup &amp; Asian Challenge Cup qual,in Malaysia,10,-10,1193,1371,3,-3,156,117,1183,1381,draw
1029,March 25,2011,Jamaica,Venezuela,0,2,Friendly,in Jamaica,-18,18,1639,1716,-3,4,51,37,1657,1698,T2
1030,March 25,2011,Kyrgyzstan,Cambodia,4,3,Asian Cup &amp; Asian Challenge Cup qual,in the Maldives,5,-5,1141,776,1,0,170,210,1136,781,T1
1031,March 25,2011,Lithuania,Poland,2,0,Friendly,in Lithuania,15,-15,1605,1672,4,-1,57,43,1590,1687,T1
1032,March 25,2011,Luxembourg,France,0,2,European Championship qualifier,in Luxembourg,-2,2,1129,1819,0,0,172,15,1131,1817,T2
1033,March 25,2011,Maldives,Tajikistan,0,0,Asian Cup &amp; Asian Challenge Cup qual,in the Maldives,3,-3,1141,1289,0,-2,170,137,1138,1292,draw
1034,March 25,2011,Montenegro,Uzbekistan,1,0,Friendly,in Montenegro,4,-4,1725,1566,0,0,35,69,1721,1570,T1
1035,March 25,2011,Myanmar,Palestine,1,3,Asian Cup &amp; Asian Challenge Cup qual,in Myanmar,-30,30,1032,1188,-3,6,182,159,1062,1158,T2
1036,March 25,2011,Pakistan,Taiwan,2,0,Asian Cup &amp; Asian Challenge Cup qual,in Malaysia,34,-34,911,888,5,-4,196,200,877,922,T1
1037,March 25,2011,Panama,Bolivia,2,0,Friendly,in Panama,10,-10,1599,1571,5,-3,58,67,1589,1581,T1
1038,March 25,2011,Philippines,Bangladesh,3,0,Asian Cup &amp; Asian Challenge Cup qual,in Myanmar,37,-37,992,936,5,-4,187,192,955,973,T1
1039,March 25,2011,Serbia,Northern Ireland,2,1,European Championship qualifier,in Serbia,6,-6,1766,1551,1,-1,25,73,1760,1557,T1
1040,March 25,2011,Slovenia,Italy,0,1,European Championship qualifier,in Slovenia,-18,18,1683,1858,-1,2,41,11,1701,1840,T2
1041,March 25,2011,South Korea,Honduras,4,0,Friendly,in South Korea,10,-10,1806,1710,1,-3,17,39,1796,1720,T1
1042,March 25,2011,Spain,Czechia,2,1,European Championship qualifier,in Spain,2,-2,2119,1735,0,0,1,31,2117,1737,T1
1043,March 26,2011,Albania,Belarus,1,0,European Championship qualifier,in Albania,22,-22,1541,1637,6,-6,76,53,1519,1659,T1
1044,March 26,2011,Andorra,Slovakia,0,1,European Championship qualifier,in Andorra,-2,2,1010,1641,0,2,185,49,1012,1639,T2
1045,March 26,2011,Armenia,Russia,0,0,European Championship qualifier,in Armenia,13,-13,1446,1801,3,-2,102,18,1433,1814,draw
1046,March 26,2011,Bosnia and Herzegovina,Romania,2,1,European Championship qualifier,in Bosnia and Herzegovina,20,-20,1640,1694,4,-2,50,40,1620,1714,T1
1047,March 26,2011,Bulgaria,Switzerland,0,0,European Championship qualifier,in Bulgaria,-4,4,1703,1749,1,1,39,29,1707,1745,draw
1048,March 26,2011,Burkina Faso,Namibia,4,0,African Nations Cup qualifier,in Burkina Faso,11,-11,1505,1279,3,-4,89,139,1494,1290,T1
1049,March 26,2011,Cape Verde,Liberia,4,2,African Nations Cup qualifier,in Cape Verde,10,-10,1427,1221,0,-1,109,149,1417,1231,T1
1050,March 26,2011,Chad,Botswana,0,1,African Nations Cup qualifier,in Chad,-14,14,1204,1438,-3,3,154,104,1218,1424,T2
1051,March 26,2011,Colombia,Ecuador,2,0,Friendly,in Spain,14,-14,1777,1715,5,-4,21,37,1763,1729,T1
1052,March 26,2011,Costa Rica,China,2,2,Friendly,in Costa Rica,-4,4,1666,1624,-1,-2,45,56,1670,1620,draw
1053,March 26,2011,Cyprus,Iceland,0,0,European Championship qualifier,in Cyprus,-11,11,1530,1447,-4,3,80,101,1541,1436,draw
1054,March 26,2011,Georgia,Croatia,1,0,European Championship qualifier,in Georgia,34,-34,1549,1884,10,-2,74,9,1515,1918,T1
1055,March 26,2011,Germany,Kazakhstan,4,0,European Championship qualifier,in Germany,1,-1,2061,1327,0,0,4,124,2060,1328,T1
1056,March 26,2011,Guinea-Bissau,Uganda,0,1,African Nations Cup qualifier,in Guinea-Bissau,-10,10,1260,1571,-3,4,142,67,1270,1561,T2
1057,March 26,2011,Iraq,North Korea,2,0,Friendly,in the United Arab Emirates,11,-11,1603,1491,2,-4,59,93,1592,1502,T1
1058,March 26,2011,Ireland,Macedonia,2,1,European Championship qualifier,in Ireland,6,-6,1753,1550,0,-1,28,73,1747,1556,T1
1059,March 26,2011,Israel,Latvia,2,1,European Championship qualifier,in Israel,8,-8,1677,1523,2,-4,43,83,1669,1531,T1
1060,March 26,2011,Jordan,Kuwait,1,1,Friendly,in the United Arab Emirates,0,0,1527,1535,-1,0,81,77,1527,1535,draw
1061,March 26,2011,Kenya,Angola,2,1,African Nations Cup qualifier,in Kenya,25,-25,1293,1437,5,-8,135,105,1268,1462,T1
1062,March 26,2011,Malawi,Togo,1,0,African Nations Cup qualifier,in Malawi,12,-12,1435,1366,1,-3,107,119,1423,1378,T1
1063,March 26,2011,Mali,Zimbabwe,1,0,African Nations Cup qualifier,in Mali,6,-6,1526,1324,-1,-3,82,126,1520,1330,T1
1064,March 26,2011,Malta,Greece,0,1,European Championship qualifier,in Malta,-3,3,1210,1758,1,0,152,27,1213,1755,T2
1065,March 26,2011,Mexico,Paraguay,3,1,Friendly,in the United States,12,-12,1866,1773,2,-1,10,23,1854,1785,T1
1066,March 26,2011,Norway,Denmark,1,1,European Championship qualifier,in Norway,-9,9,1786,1736,-1,3,20,31,1795,1727,draw
1067,March 26,2011,Portugal,Chile,1,1,Friendly,in Portugal,-3,3,1888,1895,1,1,8,7,1891,1892,draw
1068,March 26,2011,Rwanda,Burundi,3,1,African Nations Cup qualifier,in Rwanda,12,-12,1375,1203,2,-3,117,155,1363,1215,T1
1069,March 26,2011,Senegal,Cameroon,1,0,African Nations Cup qualifier,in Senegal,18,-18,1608,1642,5,-2,57,48,1590,1660,T1
1070,March 26,2011,South Africa,Egypt,1,0,African Nations Cup qualifier,in South Africa,25,-25,1635,1768,2,-4,54,25,1610,1793,T1
1071,March 26,2011,Tanzania,Central African Republic,2,1,African Nations Cup qualifier,in Tanzania,9,-9,1378,1239,2,-1,116,146,1369,1248,T1
1072,March 26,2011,United States,Argentina,1,1,Friendly,in the United States,4,-4,1773,1998,1,0,23,5,1769,2002,draw
1073,March 26,2011,Wales,England,0,2,European Championship qualifier,in Wales,-10,10,1535,1941,-3,0,77,6,1545,1931,T2
1074,March 27,2011,Algeria,Morocco,1,0,African Nations Cup qualifier,in Algeria,20,-20,1484,1552,1,-6,95,71,1464,1572,T1
1075,March 27,2011,Brazil,Scotland,2,0,Friendly,in England,3,-3,2083,1675,0,-1,3,43,2080,1678,T1
1076,March 27,2011,Congo,Ghana,0,3,African Nations Cup qualifier,in Congo,-13,13,1370,1760,-4,3,117,27,1383,1747,T2
1077,March 27,2011,Democratic Republic of Congo,Mauritius,3,0,African Nations Cup qualifier,in the Democratic Republic of the Congo,4,-4,1415,1025,0,0,110,183,1411,1029,T1
1078,March 27,2011,Ivory Coast,Benin,2,1,African Nations Cup qualifier,in Ghana,7,-7,1727,1433,1,-4,34,107,1720,1440,T1
1079,March 27,2011,Madagascar,Guinea,1,1,African Nations Cup qualifier,in Madagascar,9,-9,1245,1499,2,-2,145,89,1236,1508,draw
1080,March 27,2011,Mozambique,Zambia,0,2,African Nations Cup qualifier,in Mozambique,-27,27,1353,1540,-6,8,120,77,1380,1513,T2
1081,March 27,2011,Niger,Sierra Leone,3,1,African Nations Cup qualifier,in Niger,21,-21,1325,1273,6,-6,125,139,1304,1294,T1
1082,March 27,2011,Nigeria,Ethiopia,4,0,African Nations Cup qualifier,in Nigeria,6,-6,1660,1319,0,-3,46,128,1654,1325,T1
1083,March 27,2011,Sri Lanka,Tajikistan,2,2,Friendly,in Sri Lanka,6,-6,937,1283,2,0,192,137,931,1289,draw
1084,March 27,2011,Saint Kitts and Nevis,Grenada,0,0,Friendly,in Saint Kitts and Nevis,1,-1,1172,1301,0,0,164,132,1171,1302,draw
1085,March 27,2011,Sudan,Swaziland,3,0,African Nations Cup qualifier,in Sudan,11,-11,1339,1133,1,-4,122,171,1328,1144,T1
1086,March 28,2011,Guatemala,Bolivia,1,1,Friendly,in Guatemala,1,-1,1438,1570,1,-1,103,67,1437,1571,draw
1087,March 28,2011,Libya,Comoros,3,0,African Nations Cup qualifier,in Mali,2,-2,1508,860,0,0,87,203,1506,862,T1
1088,March 29,2011,Belgium,Azerbaijan,4,1,European Championship qualifier,in Belgium,10,-10,1663,1440,1,-2,46,102,1653,1450,T1
1089,March 29,2011,Canada,Belarus,1,0,Friendly,in Turkey,11,-11,1607,1626,2,-3,59,56,1596,1637,T1
1090,March 29,2011,Chile,Colombia,2,0,Friendly,in the Netherlands,10,-10,1905,1767,0,-3,7,24,1895,1777,T1
1091,March 29,2011,China,Honduras,3,0,Friendly,in China,17,-17,1641,1693,6,-2,50,40,1624,1710,T1
1092,March 29,2011,Costa Rica,Argentina,0,0,Friendly,in Costa Rica,6,-6,1672,1992,0,0,45,5,1666,1998,draw
1093,March 29,2011,Cuba,Panama,0,2,Friendly,in Cuba,-14,14,1472,1613,-1,3,95,57,1486,1599,T2
1094,March 29,2011,Cyprus,Bulgaria,0,1,Friendly,in Cyprus,-8,8,1522,1711,-3,1,84,38,1530,1703,T2
1095,March 29,2011,Czechia,Liechtenstein,2,0,European Championship qualifier,in Czechia,1,-1,1736,1175,0,0,32,163,1735,1176,T1
1096,March 29,2011,Ecuador,Peru,0,0,Friendly,in the Netherlands,-2,2,1713,1637,0,1,37,53,1715,1635,draw
1097,March 29,2011,El Salvador,Jamaica,2,3,Friendly,in El Salvador,-9,9,1488,1648,-2,4,93,48,1497,1639,T2
1098,March 29,2011,England,Ghana,1,1,Friendly,in England,-7,7,1934,1767,0,3,6,24,1941,1760,draw
1099,March 29,2011,Equatorial Guinea,Gambia,1,0,Friendly,in Equatorial Guinea,12,-12,1225,1374,2,-3,149,115,1213,1386,T1
1100,March 29,2011,Estonia,Serbia,1,1,European Championship qualifier,in Estonia,9,-9,1508,1757,2,-1,87,27,1499,1766,draw
1101,March 29,2011,France,Croatia,0,0,Friendly,in France,-1,1,1818,1885,0,0,15,9,1819,1884,draw
1102,March 29,2011,Germany,Australia,1,2,Friendly,in Germany,-18,18,2043,1813,0,3,4,16,2061,1795,T2
1103,March 29,2011,Greece,Poland,0,0,Friendly,in Greece,-5,5,1753,1677,0,1,28,43,1758,1672,draw
1104,March 29,2011,Ireland,Uruguay,2,3,Friendly,in Ireland,-10,10,1743,1875,-2,1,31,10,1753,1865,T2
1105,March 29,2011,Israel,Georgia,1,0,European Championship qualifier,in Israel,8,-8,1685,1541,1,-3,41,77,1677,1549,T1
1106,March 29,2011,Jordan,North Korea,1,1,Friendly,in the United Arab Emirates,-1,1,1526,1492,1,1,81,92,1527,1491,draw
1107,March 29,2011,Kuwait,Iraq,1,0,Friendly,in the United Arab Emirates,12,-12,1547,1591,4,-3,74,62,1535,1603,T1
1108,March 29,2011,Lithuania,Spain,1,3,European Championship qualifier,in Lithuania,-5,5,1600,2124,-2,0,60,1,1605,2119,T2
1109,March 29,2011,Mexico,Venezuela,1,1,Friendly,in the United States,-4,4,1862,1720,-2,0,12,36,1866,1716,draw
1110,March 29,2011,Netherlands,Hungary,5,3,European Championship qualifier,in the Netherlands,2,-2,2117,1638,0,-2,2,52,2115,1640,T1
1111,March 29,2011,Nigeria,Kenya,3,0,Friendly,in Nigeria,2,-2,1662,1291,-1,0,47,134,1660,1293,T1
1112,March 29,2011,Northern Ireland,Slovenia,0,0,European Championship qualifier,in Northern Ireland,2,-2,1553,1681,1,-1,71,42,1551,1683,draw
1113,March 29,2011,Oman,Tunisia,2,1,Friendly,in Oman,8,-8,1543,1570,2,-3,76,66,1535,1578,T1
1114,March 29,2011,Portugal,Finland,2,0,Friendly,in Portugal,3,-3,1891,1593,0,0,8,61,1888,1596,T1
1115,March 29,2011,Qatar,Russia,1,1,Friendly,in Qatar,4,-4,1547,1797,1,0,74,18,1543,1801,draw
1116,March 29,2011,Romania,Luxembourg,3,1,European Championship qualifier,in Romania,1,-1,1695,1128,1,0,39,172,1694,1129,T1
1117,March 29,2011,Slovakia,Denmark,1,2,Friendly,in Slovakia,-10,10,1631,1746,-6,1,55,30,1641,1736,T2
1118,March 29,2011,Sri Lanka,Tajikistan,0,2,Friendly,in Sri Lanka,-6,6,931,1289,-2,1,194,136,937,1283,T2
1119,March 29,2011,Sweden,Moldova,2,1,European Championship qualifier,in Sweden,3,-3,1831,1463,0,0,14,96,1828,1466,T1
1120,March 29,2011,Turkey,Austria,2,0,European Championship qualifier,in Turkey,9,-9,1785,1558,0,-2,22,70,1776,1567,T1
1121,March 29,2011,Ukraine,Italy,0,2,Friendly,in Ukraine,-17,17,1788,1875,-2,2,19,10,1805,1858,T2
1122,March 29,2011,United States,Paraguay,0,1,Friendly,in the United States,-13,13,1760,1786,-3,3,26,20,1773,1773,T2
1123,April 2,2011,Grenada,Saint Kitts and Nevis,0,1,Friendly,in Grenada,-16,16,1285,1188,-5,5,137,159,1301,1172,T2
1124,April 3,2011,Tahiti,New Caledonia,1,3,Friendly,in Tahiti,-14,14,1164,1304,-2,2,164,132,1178,1290,T2
1125,April 6,2011,Tahiti,New Caledonia,1,0,Friendly,in Tahiti,11,-11,1175,1293,1,-1,163,133,1164,1304,T1
1126,April 7,2011,Nepal,Afghanistan,1,0,Asian Cup &amp; Asian Challenge Cup qual,in Nepal,8,-8,972,802,0,-1,189,208,964,810,T1
1127,April 7,2011,North Korea,Sri Lanka,4,0,Asian Cup &amp; Asian Challenge Cup qual,in Nepal,3,-3,1495,928,1,-1,91,195,1492,931,T1
1128,April 9,2011,Afghanistan,Sri Lanka,1,0,Asian Cup &amp; Asian Challenge Cup qual,in Nepal,27,-27,829,901,3,-2,205,197,802,928,T1
1129,April 9,2011,Nepal,North Korea,0,1,Asian Cup &amp; Asian Challenge Cup qual,in Nepal,-3,3,969,1498,0,0,189,91,972,1495,T2
1130,April 11,2011,Nepal,Sri Lanka,0,0,Asian Cup &amp; Asian Challenge Cup qual,in Nepal,-9,9,960,910,-1,1,190,196,969,901,draw
1131,April 11,2011,North Korea,Afghanistan,2,0,Asian Cup &amp; Asian Challenge Cup qual,in Nepal,1,-1,1499,828,1,-1,90,206,1498,829,T1
1132,April 20,2011,Argentina,Ecuador,2,2,Friendly,in Argentina,-8,8,1984,1721,0,1,5,36,1992,1713,draw
1133,April 23,2011,Mozambique,Tanzania,2,0,Friendly,in Mozambique,12,-12,1365,1366,1,-4,119,117,1353,1378,T1
1134,May 4,2011,New Caledonia,Réunion,2,4,Friendly,in New Caledonia,-17,17,1276,1355,-5,3,138,120,1293,1338,T2
1135,May 7,2011,Monaco,Vatican,2,1,Friendly,in Italy,5,-5,895,700,0,-2,199,215,890,705,T1
1136,May 7,2011,New Caledonia,Réunion,1,3,Friendly,in New Caledonia,-16,16,1260,1371,-3,5,141,115,1276,1355,T2
1137,May 14,2011,Tanzania,South Africa,0,1,Friendly,in Tanzania,-5,5,1361,1640,-2,3,120,51,1366,1635,T2
1138,May 20,2011,Guyana,Barbados,1,0,Friendly,in Guyana,6,-6,1314,1251,1,-1,130,144,1308,1257,T1
1139,May 22,2011,Guyana,Barbados,3,2,Friendly,in Guyana,6,-6,1320,1245,2,0,128,144,1314,1251,T1
1140,May 24,2011,Ireland,Northern Ireland,5,0,Friendly tournament,in Ireland,10,-10,1753,1543,3,-4,28,75,1743,1553,T1
1141,May 25,2011,Argentina,Paraguay,4,2,Friendly tournament,in Argentina,7,-7,1991,1779,0,-2,5,22,1984,1786,T1
1142,May 25,2011,Scotland,Wales,3,1,Friendly tournament,in Ireland,14,-14,1689,1521,3,-4,41,84,1675,1535,T1
1143,May 25,2011,Swaziland,Botswana,0,0,Friendly,in Swaziland,5,-5,1138,1433,0,-3,171,106,1133,1438,draw
1144,May 26,2011,Cuba,Nicaragua,1,1,Friendly,in Cuba,-9,9,1463,1073,0,0,95,178,1472,1064,draw
1145,May 27,2011,Barbados,Saint Vincent and the Grenadines,0,0,Friendly,in Barbados,-4,4,1241,1190,-2,2,146,159,1245,1186,draw
1146,May 27,2011,Grenada,Antigua and Barbuda,2,2,Friendly,in Grenada,-3,3,1282,1267,0,1,136,139,1285,1264,draw
1147,May 27,2011,Wales,Northern Ireland,2,0,Friendly tournament,in Ireland,24,-24,1545,1519,9,-9,75,84,1521,1543,T1
1148,May 28,2011,Cuba,Nicaragua,2,1,Friendly,in Cuba,1,-1,1464,1072,0,0,95,178,1463,1073,T1
1149,May 28,2011,Ecuador,Mexico,1,1,Friendly,in the United States,4,-4,1725,1858,1,0,35,12,1721,1862,draw
1150,May 28,2011,Ethiopia,Sudan,1,2,Friendly,in Ethiopia,-12,12,1307,1351,-2,1,131,122,1319,1339,T2
1151,May 29,2011,Barbados,Guyana,1,1,Friendly,in Barbados,-1,1,1240,1321,0,0,146,128,1241,1320,draw
1152,May 29,2011,El Salvador,Honduras,2,2,Friendly,in the United States,5,-5,1493,1688,0,0,93,40,1488,1693,draw
1153,May 29,2011,Germany,Uruguay,2,1,Friendly,in Germany,4,-4,2047,1871,0,-1,4,11,2043,1875,T1
1154,May 29,2011,Ireland,Scotland,1,0,Friendly tournament,in Ireland,8,-8,1761,1681,2,-1,26,42,1753,1689,T1
1155,May 29,2011,Panama,Grenada,2,0,Friendly,in Panama,2,-2,1615,1280,0,0,57,136,1613,1282,T1
1156,May 29,2011,Swaziland,Malawi,1,1,Friendly,in Swaziland,5,-5,1143,1430,4,-3,167,108,1138,1435,draw
1157,May 29,2011,Tunisia,Central African Republic,3,0,Friendly,in Tunisia,3,-3,1573,1236,2,0,64,147,1570,1239,T1
1158,June 1,2011,Canada,Ecuador,2,2,Friendly,in Canada,1,-1,1608,1724,1,-2,58,37,1607,1725,draw
1159,June 1,2011,Ethiopia,Sudan,1,1,Friendly,in Ethiopia,-2,2,1305,1353,0,0,131,122,1307,1351,draw
1160,June 1,2011,Guatemala,Venezuela,0,2,Friendly,in Guatemala,-8,8,1430,1728,-4,3,107,34,1438,1720,T2
1161,June 1,2011,Japan,Peru,0,0,Friendly tournament,in Japan,-11,11,1831,1648,0,6,13,48,1842,1637,draw
1162,June 1,2011,Mexico,New Zealand,3,0,Friendly,in the United States,6,-6,1864,1571,0,-2,12,65,1858,1577,T1
1163,June 1,2011,Nigeria,Argentina,4,1,Friendly,in Nigeria,28,-28,1690,1963,7,0,40,5,1662,1991,T1
1164,June 1,2011,Ukraine,Uzbekistan,2,0,Friendly,in Ukraine,4,-4,1792,1562,0,0,19,68,1788,1566,T1
1165,June 3,2011,Austria,Germany,1,2,European Championship qualifier,in Austria,-4,4,1554,2051,1,0,69,4,1558,2047,T2
1166,June 3,2011,Belarus,France,1,1,European Championship qualifier,in Belarus,5,-5,1631,1813,2,0,54,15,1626,1818,draw
1167,June 3,2011,Belgium,Turkey,1,1,European Championship qualifier,in Belgium,1,-1,1664,1784,0,0,47,21,1663,1785,draw
1168,June 3,2011,Croatia,Georgia,2,1,European Championship qualifier,in Croatia,3,-3,1888,1538,0,-2,9,79,1885,1541,T1
1169,June 3,2011,Faroe Islands,Slovenia,0,2,European Championship qualifier,in the Faroe Islands,-6,6,1186,1687,-4,1,162,42,1192,1681,T2
1170,June 3,2011,Ghana,Congo,3,1,African Nations Cup qualifier,in Ghana,3,-3,1770,1367,1,0,23,117,1767,1370,T1
1171,June 3,2011,Hong Kong,Malaysia,1,1,Friendly,in Hong Kong,-2,2,1204,1254,-1,0,154,143,1206,1252,draw
1172,June 3,2011,Italy,Estonia,3,0,European Championship qualifier,in Italy,4,-4,1879,1504,0,-2,10,89,1875,1508,T1
1173,June 3,2011,Kazakhstan,Azerbaijan,2,1,European Championship qualifier,in Kazakhstan,21,-21,1348,1419,1,-7,123,109,1327,1440,T1
1174,June 3,2011,Liechtenstein,Lithuania,2,0,European Championship qualifier,in Liechtenstein,52,-52,1227,1548,14,-12,149,72,1175,1600,T1
1175,June 3,2011,Luxembourg,Hungary,0,1,Friendly,in Luxembourg,-2,2,1126,1640,0,2,172,52,1128,1638,T2
1176,June 3,2011,Moldova,Sweden,1,4,European Championship qualifier,in Moldova,-12,12,1451,1843,-3,0,99,13,1463,1831,T2
1177,June 3,2011,Romania,Bosnia and Herzegovina,3,0,European Championship qualifier,in Romania,20,-20,1715,1620,1,-4,38,56,1695,1640,T1
1178,June 3,2011,San Marino,Finland,0,1,European Championship qualifier,in San Marino,-1,1,900,1594,0,1,198,60,901,1593,T2
1179,June 3,2011,South Korea,Serbia,2,1,Friendly,in South Korea,6,-6,1812,1751,0,-1,17,29,1806,1757,T1
1180,June 4,2011,Bolivia,Paraguay,0,2,Friendly,in Bolivia,-10,10,1560,1789,-3,2,69,20,1570,1779,T2
1181,June 4,2011,Brazil,Netherlands,0,0,Friendly,in Brazil,-2,2,2081,2119,0,0,3,2,2083,2117,draw
1182,June 4,2011,Cameroon,Senegal,0,0,African Nations Cup qualifier,in Cameroon,-7,7,1635,1615,-3,1,53,57,1642,1608,draw
1183,June 4,2011,Czechia,Peru,0,0,Friendly tournament,in Japan,-4,4,1732,1652,-1,0,33,48,1736,1648,draw
1184,June 4,2011,England,Switzerland,2,2,European Championship qualifier,in England,-14,14,1920,1763,0,3,6,27,1934,1749,draw
1185,June 4,2011,Greece,Malta,3,1,European Championship qualifier,in Greece,1,-1,1754,1209,-1,0,29,153,1753,1210,T1
1186,June 4,2011,Iceland,Denmark,0,2,European Championship qualifier,in Iceland,-14,14,1433,1760,-2,3,102,28,1447,1746,T2
1187,June 4,2011,Latvia,Israel,1,2,European Championship qualifier,in Latvia,-16,16,1507,1701,-6,3,88,40,1523,1685,T2
1188,June 4,2011,Macedonia,Ireland,0,2,European Championship qualifier,in Macedonia,-21,21,1529,1782,-8,4,79,22,1550,1761,T2
1189,June 4,2011,Montenegro,Bulgaria,1,1,European Championship qualifier,in Montenegro,-6,6,1719,1717,-1,1,37,38,1725,1711,draw
1190,June 4,2011,Morocco,Algeria,4,0,African Nations Cup qualifier,in Morocco,21,-21,1573,1463,7,-1,63,95,1552,1484,T1
1191,June 4,2011,Namibia,Burkina Faso,1,4,African Nations Cup qualifier,in Namibia,-23,23,1256,1528,-4,8,141,80,1279,1505,T2
1192,June 4,2011,Portugal,Norway,1,0,European Championship qualifier,in Portugal,9,-9,1900,1777,0,-3,8,23,1891,1786,T1
1193,June 4,2011,Russia,Armenia,3,1,European Championship qualifier,in Russia,4,-4,1801,1442,0,1,18,100,1797,1446,T1
1194,June 4,2011,Sierra Leone,Niger,1,0,African Nations Cup qualifier,in Sierra Leone,17,-17,1290,1308,4,-5,134,130,1273,1325,T1
1195,June 4,2011,Slovakia,Andorra,1,0,European Championship qualifier,in Slovakia,1,-1,1632,1009,0,0,54,185,1631,1010,T1
1196,June 4,2011,Uganda,Guinea-Bissau,2,0,African Nations Cup qualifier,in Uganda,5,-5,1576,1255,2,-1,62,142,1571,1260,T1
1197,June 4,2011,United States,Spain,0,4,Friendly,in the United States,-7,7,1753,2131,-3,0,30,1,1760,2124,T2
1198,June 4,2011,Zambia,Mozambique,3,0,African Nations Cup qualifier,in Zambia,12,-12,1552,1353,7,-2,71,121,1540,1365,T1
1199,June 5,2011,Angola,Kenya,1,0,African Nations Cup qualifier,in Angola,8,-8,1445,1283,2,-3,99,136,1437,1291,T1
1200,June 5,2011,Australia,New Zealand,3,0,Friendly,in Australia,4,-4,1817,1567,0,0,15,66,1813,1571,T1
1201,June 5,2011,Benin,Ivory Coast,2,6,African Nations Cup qualifier,in Benin,-18,18,1415,1745,-7,3,109,32,1433,1727,T2
1202,June 5,2011,Botswana,Malawi,0,0,African Nations Cup qualifier,in Botswana,-6,6,1427,1436,-4,4,106,102,1433,1430,draw
1203,June 5,2011,Burundi,Rwanda,3,1,African Nations Cup qualifier,in Burundi,36,-36,1239,1339,8,-12,148,125,1203,1375,T1
1204,June 5,2011,China,Uzbekistan,1,0,Friendly,in China,5,-5,1646,1557,-1,-2,51,69,1641,1562,T1
1205,June 5,2011,Central African Republic,Tanzania,2,1,African Nations Cup qualifier,in Central African Republic,21,-21,1257,1340,6,-4,141,123,1236,1361,T1
1206,June 5,2011,Comoros,Libya,1,1,African Nations Cup qualifier,in the Comoros,18,-18,878,1490,1,-5,202,92,860,1508,draw
1207,June 5,2011,Costa Rica,Cuba,5,0,CONCACAF Championship,in the United States,23,-23,1695,1441,5,-7,41,101,1672,1464,T1
1208,June 5,2011,Egypt,South Africa,0,0,African Nations Cup qualifier,in Egypt,-12,12,1756,1652,-3,3,28,48,1768,1640,draw
1209,June 5,2011,Ethiopia,Nigeria,2,2,African Nations Cup qualifier,in Ethiopia,14,-14,1319,1676,3,-5,128,46,1305,1690,draw
1210,June 5,2011,Guinea,Madagascar,4,1,African Nations Cup qualifier,in Guinea,8,-8,1507,1237,4,-5,86,149,1499,1245,T1
1211,June 5,2011,Liberia,Cape Verde,1,0,African Nations Cup qualifier,in Liberia,26,-26,1247,1401,6,-3,145,111,1221,1427,T1
1212,June 5,2011,Mauritius,Democratic Republic of Congo,1,2,African Nations Cup qualifier,in Mauritius,-6,6,1019,1421,-1,3,184,107,1025,1415,T2
1213,June 5,2011,Mexico,El Salvador,5,0,CONCACAF Championship,in the United States,11,-11,1875,1482,1,0,11,93,1864,1493,T1
1214,June 5,2011,Poland,Argentina,2,1,Friendly,in Poland,15,-15,1692,1948,3,0,42,5,1677,1963,T1
1215,June 5,2011,Swaziland,Sudan,1,2,African Nations Cup qualifier,in Swaziland,-14,14,1129,1367,-4,5,171,116,1143,1353,T2
1216,June 5,2011,Tunisia,Chad,5,0,African Nations Cup qualifier,in Tunisia,5,-5,1578,1199,1,-2,62,156,1573,1204,T1
1217,June 5,2011,Zimbabwe,Mali,2,1,African Nations Cup qualifier,in Zimbabwe,26,-26,1350,1500,4,-8,121,89,1324,1526,T1
1218,June 6,2011,Guatemala,Honduras,0,0,CONCACAF Championship,in the United States,16,-16,1446,1672,6,-3,99,46,1430,1688,draw
1219,June 6,2011,Jamaica,Grenada,4,0,CONCACAF Championship,in the United States,10,-10,1658,1270,2,0,48,137,1648,1280,T1
1220,June 6,2011,Ukraine,France,1,4,Friendly,in Ukraine,-21,21,1771,1834,-4,2,23,14,1792,1813,T2
1221,June 7,2011,Australia,Serbia,0,0,Friendly,in Australia,-4,4,1813,1755,-1,1,17,30,1817,1751,draw
1222,June 7,2011,Austria,Latvia,3,1,Friendly,in Austria,9,-9,1563,1498,3,-2,67,88,1554,1507,T1
1223,June 7,2011,Azerbaijan,Germany,1,3,European Championship qualifier,in Azerbaijan,-3,3,1416,2054,0,0,108,4,1419,2051,T2
1224,June 7,2011,Belarus,Luxembourg,2,0,European Championship qualifier,in Belarus,2,-2,1633,1124,0,-1,55,173,1631,1126,T1
1225,June 7,2011,Bosnia and Herzegovina,Albania,2,0,European Championship qualifier,in Bosnia and Herzegovina,16,-16,1636,1525,2,-4,54,81,1620,1541,T1
1226,June 7,2011,Brazil,Romania,1,0,Friendly,in Brazil,1,-1,2082,1714,0,0,3,39,2081,1715,T1
1227,June 7,2011,Cameroon,Russia,0,0,Friendly,in Austria,4,-4,1639,1797,0,-1,53,19,1635,1801,draw
1228,June 7,2011,Ecuador,Greece,1,1,Friendly,in the United States,1,-1,1725,1753,1,-2,35,31,1724,1754,draw
1229,June 7,2011,Faroe Islands,Estonia,2,0,European Championship qualifier,in the Faroe Islands,47,-47,1233,1457,12,-8,150,96,1186,1504,T1
1230,June 7,2011,Gabon,Gambia,0,1,Friendly,in Gabon,-17,17,1555,1391,-5,1,70,112,1572,1374,T2
1231,June 7,2011,Ireland,Italy,2,0,Friendly,in Belgium,19,-19,1801,1860,3,-2,18,12,1782,1879,T1
1232,June 7,2011,Japan,Czechia,0,0,Friendly tournament,in Japan,-8,8,1823,1740,0,1,15,33,1831,1732,draw
1233,June 7,2011,Norway,Lithuania,1,0,Friendly,in Norway,3,-3,1780,1545,0,-2,22,74,1777,1548,T1
1234,June 7,2011,Panama,Guadeloupe,3,2,CONCACAF Championship,in the United States,18,-18,1633,1491,2,-5,55,90,1615,1509,T1
1235,June 7,2011,Paraguay,Bolivia,0,0,Friendly,in Paraguay,-7,7,1782,1567,-2,3,21,65,1789,1560,draw
1236,June 7,2011,San Marino,Hungary,0,3,European Championship qualifier,in San Marino,-2,2,898,1642,0,0,198,52,900,1640,T2
1237,June 7,2011,Singapore,Maldives,4,0,Friendly,in Singapore,6,-6,1324,1135,3,-1,126,170,1318,1141,T1
1238,June 7,2011,South Korea,Ghana,2,1,Friendly,in South Korea,6,-6,1818,1764,1,-2,16,26,1812,1770,T1
1239,June 7,2011,Sweden,Finland,5,0,European Championship qualifier,in Sweden,9,-9,1852,1585,0,-1,13,61,1843,1594,T1
1240,June 7,2011,United States,Canada,2,0,CONCACAF Championship,in the United States,15,-15,1768,1593,6,0,24,59,1753,1608,T1
1241,June 7,2011,Venezuela,Spain,0,3,Friendly,in Venezuela,-5,5,1723,2136,-1,0,36,1,1728,2131,T2
1242,June 8,2011,China,North Korea,2,0,Friendly,in China,6,-6,1652,1493,2,-2,49,89,1646,1499,T1
1243,June 8,2011,Uruguay,Netherlands,1,1,Friendly tournament,in Uruguay,6,-6,1877,2113,1,0,10,2,1871,2119,draw
1244,June 9,2011,Costa Rica,El Salvador,1,1,CONCACAF Championship,in the United States,-14,14,1681,1496,-2,4,43,88,1695,1482,draw
1245,June 9,2011,Mexico,Cuba,5,0,CONCACAF Championship,in the United States,8,-8,1883,1433,1,-1,10,103,1875,1441,T1
1246,June 9,2011,Poland,France,0,1,Friendly,in Poland,-9,9,1683,1843,0,0,42,14,1692,1834,T2
1247,June 10,2011,Honduras,Grenada,7,1,CONCACAF Championship,in the United States,10,-10,1682,1260,3,-2,43,139,1672,1270,T1
1248,June 10,2011,Jamaica,Guatemala,2,0,CONCACAF Championship,in the United States,17,-17,1675,1429,1,-6,47,105,1658,1446,T1
1249,June 11,2011,Canada,Guadeloupe,1,0,CONCACAF Championship,in the United States,18,-18,1611,1473,0,-1,59,92,1593,1491,T1
1250,June 11,2011,Paraguay,Romania,2,0,Friendly,in Paraguay,8,-8,1790,1706,1,0,20,39,1782,1714,T1
1251,June 11,2011,United States,Panama,1,2,CONCACAF Championship,in the United States,-40,40,1728,1673,-10,7,34,48,1768,1633,T2
1252,June 12,2011,El Salvador,Cuba,6,1,CONCACAF Championship,in the United States,41,-41,1537,1392,10,-9,78,111,1496,1433,T1
1253,June 12,2011,Mexico,Costa Rica,4,1,CONCACAF Championship,in the United States,21,-21,1904,1660,2,-5,8,49,1883,1681,T1
1254,June 13,2011,Guatemala,Grenada,4,0,CONCACAF Championship,in the United States,26,-26,1455,1234,7,-10,97,149,1429,1260,T1
1255,June 13,2011,Jamaica,Honduras,1,0,CONCACAF Championship,in the United States,26,-26,1701,1656,6,-6,40,49,1675,1682,T1
1256,June 14,2011,Canada,Panama,1,1,CONCACAF Championship,in the United States,4,-4,1615,1669,1,0,58,46,1611,1673,draw
1257,June 14,2011,United States,Guadeloupe,1,0,CONCACAF Championship,in the United States,6,-6,1734,1467,1,0,33,92,1728,1473,T1
1258,June 15,2011,Belize,Montserrat,5,2,World Cup qualifier,in Trinidad and Tobago,3,-3,1079,515,0,0,176,230,1076,518,T1
1259,June 18,2011,Costa Rica,Honduras,1,1,CONCACAF Championship,in the United States,0,0,1660,1656,0,0,48,49,1660,1656,draw
1260,June 18,2011,Malaysia,Myanmar,2,0,Friendly,in Malaysia,4,-4,1258,1028,3,0,140,182,1254,1032,T1
1261,June 18,2011,Mexico,Guatemala,2,1,CONCACAF Championship,in the United States,4,-4,1908,1451,1,-1,7,98,1904,1455,T1
1262,June 19,2011,Anguilla,US Virgin Islands,0,0,Friendly,in Anguilla,0,0,574,672,0,0,226,220,574,672,draw
1263,June 19,2011,Chile,Estonia,4,0,Friendly,in Chile,2,-2,1907,1455,0,0,8,96,1905,1457,T1
1264,June 19,2011,El Salvador,Panama,1,1,CONCACAF Championship,in the United States,9,-9,1546,1660,4,-1,74,47,1537,1669,draw
1265,June 19,2011,United States,Jamaica,2,0,CONCACAF Championship,in the United States,24,-24,1758,1677,5,-4,28,44,1734,1701,T1
1266,June 20,2011,Argentina,Albania,4,0,Friendly,in Argentina,2,-2,1950,1523,0,0,5,82,1948,1525,T1
1267,June 22,2011,Mexico,Honduras,2,0,CONCACAF Championship,in the United States,14,-14,1922,1642,1,-3,6,52,1908,1656,T1
1268,June 22,2011,United States,Panama,1,0,CONCACAF Championship,in the United States,12,-12,1770,1648,4,-4,24,51,1758,1660,T1
1269,June 23,2011,Paraguay,Chile,0,0,Friendly,in Paraguay,0,0,1790,1907,0,0,20,8,1790,1907,draw
1270,June 23,2011,Uruguay,Estonia,3,0,Friendly tournament,in Uruguay,2,-2,1879,1453,0,-1,11,97,1877,1455,T1
1271,June 25,2011,Kenya,Sudan,1,2,Friendly,in Kenya,-10,10,1273,1377,0,2,136,114,1283,1367,T2
1272,June 25,2011,United States,Mexico,2,4,CONCACAF Championship,in the United States,-32,32,1738,1954,-9,1,33,5,1770,1922,T2
1273,June 29,2011,Bangladesh,Pakistan,3,0,World Cup qualifier,in Bangladesh,23,-23,959,888,0,-4,192,199,936,911,T1
1274,June 29,2011,Cambodia,Laos,4,2,World Cup qualifier,in Cambodia,27,-27,803,817,1,-4,209,208,776,844,T1
1275,June 29,2011,Iraq,Syria,1,2,Friendly,in Iraq,-15,15,1576,1532,-2,6,62,79,1591,1517,T2
1276,June 29,2011,Malaysia,Taiwan,2,1,World Cup qualifier,in Malaysia,3,-3,1261,885,1,-1,139,201,1258,888,T1
1277,June 29,2011,Mongolia,Myanmar,1,0,World Cup qualifier,in Mongolia,27,-27,833,1001,4,-3,204,185,806,1028,T1
1278,June 29,2011,Nepal,East Timor,2,1,World Cup qualifier,in Nepal,2,-2,962,529,1,0,189,229,960,531,T1
1279,June 29,2011,Palestine,Afghanistan,2,0,World Cup qualifier,in Tajikistan,7,-7,1195,821,3,-1,158,207,1188,828,T1
1280,June 29,2011,Sri Lanka,Philippines,1,1,World Cup qualifier,in Sri Lanka,-1,1,909,993,1,0,195,187,910,992,draw
1281,June 29,2011,Vietnam,Macao,6,0,World Cup qualifier,in Vietnam,2,-2,1247,679,1,0,144,219,1245,681,T1
1282,July 1,2011,Argentina,Bolivia,1,1,Copa América,in Argentina,-22,22,1928,1589,0,5,6,60,1950,1567,draw
1283,July 2,2011,Colombia,Costa Rica,1,0,Copa América,in Argentina,18,-18,1785,1642,3,-4,21,51,1767,1660,T1
1284,July 2,2011,Lebanon,Kuwait,0,6,Friendly,in Lebanon,-9,9,1212,1556,0,2,154,70,1221,1547,T2
1285,July 2,2011,Nepal,East Timor,5,0,World Cup qualifier,in Nepal,4,-4,966,525,0,0,189,229,962,529,T1
1286,July 2,2011,Turks and Caicos,Bahamas,0,4,World Cup qualifier,in Turks and Caicos,-43,43,784,914,-4,8,210,195,827,871,T2
1287,July 3,2011,Brazil,Venezuela,0,0,Copa América,in Argentina,-19,19,2063,1742,0,4,3,32,2082,1723,draw
1288,July 3,2011,Ecuador,Paraguay,0,0,Copa América,in Argentina,5,-5,1730,1785,-1,0,36,20,1725,1790,draw
1289,July 3,2011,Laos,Cambodia,6,2,World Cup qualifier,in Laos,26,-26,843,777,3,-2,204,210,817,803,T1
1290,July 3,2011,Macao,Vietnam,1,7,World Cup qualifier,in Macao,-5,5,674,1252,-1,1,220,143,679,1247,T2
1291,July 3,2011,Myanmar,Mongolia,2,0,World Cup qualifier,in Myanmar,11,-11,1012,822,1,-2,184,206,1001,833,T1
1292,July 3,2011,Pakistan,Bangladesh,0,0,World Cup qualifier,in Pakistan,-2,2,886,961,-2,2,202,190,888,959,draw
1293,July 3,2011,Palestine,Afghanistan,1,1,World Cup qualifier,in Palestine,-18,18,1177,839,-5,1,163,205,1195,821,draw
1294,July 3,2011,Philippines,Sri Lanka,4,0,World Cup qualifier,in the Philippines,19,-19,1012,890,3,-4,184,200,993,909,T1
1295,July 3,2011,Taiwan,Malaysia,3,2,World Cup qualifier,in Taiwan,33,-33,918,1228,7,-12,195,151,885,1261,T1
1296,July 3,2011,US Virgin Islands,British Virgin Islands,2,0,World Cup qualifier,in the US Virgin Islands,35,-35,707,794,7,-2,213,207,672,829,T1
1297,July 4,2011,Chile,Mexico,2,1,Copa América,in Argentina,28,-28,1935,1926,3,-2,5,7,1907,1954,T1
1298,July 4,2011,Peru,Uruguay,1,1,Copa América,in Argentina,14,-14,1666,1865,1,0,46,11,1652,1879,draw
1299,July 5,2011,Syria,Jordan,3,1,Friendly,in Turkey,15,-15,1547,1511,6,-3,73,85,1532,1526,T1
1300,July 6,2011,Argentina,Colombia,0,0,Copa América,in Argentina,-15,15,1913,1800,-2,1,8,19,1928,1785,draw
1301,July 6,2011,Kuwait,Oman,1,1,Friendly,in Lebanon,0,0,1556,1543,0,0,70,78,1556,1543,draw
1302,July 6,2011,Malawi,Namibia,0,1,Friendly,in Malawi,-17,17,1419,1273,-4,5,106,136,1436,1256,T2
1303,July 7,2011,Costa Rica,Bolivia,2,0,Copa América,in Argentina,32,-32,1674,1557,5,-8,46,68,1642,1589,T1
1304,July 7,2011,Solomon Islands,Vanuatu,2,1,Friendly,in the Solomon Islands,6,-6,1293,1223,2,-3,133,153,1287,1229,T1
1305,July 8,2011,Aruba,Saint Lucia,4,2,World Cup qualifier,in Aruba,34,-34,966,1041,4,-4,189,181,932,1075,T1
1306,July 8,2011,Chile,Uruguay,1,1,Copa América,in Argentina,-5,5,1930,1870,0,0,5,11,1935,1865,draw
1307,July 8,2011,Dominican Republic,Anguilla,2,0,World Cup qualifier,in the Dominican Republic,2,-2,1050,572,1,0,179,226,1048,574,T1
1308,July 8,2011,Jordan,Yemen,4,0,Friendly,in Turkey,9,-9,1520,1303,1,-1,84,131,1511,1312,T1
1309,July 8,2011,Peru,Mexico,1,0,Copa América,in Argentina,41,-41,1707,1885,8,-4,39,10,1666,1926,T1
1310,July 9,2011,Bahamas,Turks and Caicos,6,0,World Cup qualifier,in the Bahamas,18,-18,932,766,2,-1,194,210,914,784,T1
1311,July 9,2011,Brazil,Paraguay,2,2,Copa América,in Argentina,-17,17,2046,1802,-1,3,4,18,2063,1785,draw
1312,July 9,2011,Lebanon,Oman,0,1,Friendly,in Lebanon,-4,4,1208,1547,-1,5,155,73,1212,1543,T2
1313,July 9,2011,Solomon Islands,Vanuatu,0,0,Friendly,in the Solomon Islands,-5,5,1288,1228,-2,3,135,150,1293,1223,draw
1314,July 9,2011,Venezuela,Ecuador,1,0,Copa América,in Argentina,24,-24,1766,1706,7,-3,25,39,1742,1730,T1
1315,July 10,2011,British Virgin Islands,US Virgin Islands,1,2,World Cup qualifier,in the British Virgin Islands,-30,30,764,737,-3,2,210,211,794,707,T2
1316,July 10,2011,Colombia,Bolivia,2,0,Copa América,in Argentina,15,-15,1815,1542,3,-10,17,78,1800,1557,T1
1317,July 10,2011,Dominican Republic,Anguilla,4,0,World Cup qualifier,in the Dominican Republic,3,-3,1053,569,0,0,179,226,1050,572,T1
1318,July 10,2011,Maldives,India,1,1,Friendly,in the Maldives,-1,1,1134,1194,0,0,170,158,1135,1193,draw
1319,July 11,2011,Argentina,Costa Rica,3,0,Copa América,in Argentina,11,-11,1924,1663,1,-1,6,48,1913,1674,T1
1320,July 12,2011,Chile,Peru,1,0,Copa América,in Argentina,11,-11,1941,1696,0,-3,5,41,1930,1707,T1
1321,July 12,2011,Saint Lucia,Aruba,4,2,World Cup qualifier,in Saint Lucia,16,-16,1057,950,3,-4,178,193,1041,966,T1
1322,July 12,2011,Uruguay,Mexico,1,0,Copa América,in Argentina,26,-26,1896,1859,2,-2,9,12,1870,1885,T1
1323,July 13,2011,Brazil,Ecuador,4,2,Copa América,in Argentina,9,-9,2055,1697,1,-2,3,40,2046,1706,T1
1324,July 13,2011,Fiji,Vanuatu,2,0,Friendly,in Fiji,7,-7,1330,1221,1,-3,126,153,1323,1228,T1
1325,July 13,2011,Jordan,Saudi Arabia,1,1,Friendly tournament,in Jordan,-2,2,1518,1564,-1,1,85,66,1520,1562,draw
1326,July 13,2011,Kuwait,Iraq,2,0,Friendly tournament,in Jordan,24,-24,1580,1552,8,-8,61,70,1556,1576,T1
1327,July 13,2011,Paraguay,Venezuela,3,3,Copa América,in Argentina,-3,3,1799,1769,-1,0,20,25,1802,1766,draw
1328,July 14,2011,Thailand,Myanmar,1,0,Friendly,in Thailand,1,-1,1403,1011,0,-1,109,185,1402,1012,T1
1329,July 15,2011,Fiji,Vanuatu,1,2,Friendly,in Fiji,-15,15,1315,1236,-3,5,129,148,1330,1221,T2
1330,July 15,2011,Oman,Syria,1,1,Friendly,in Lebanon,0,0,1547,1547,0,0,72,72,1547,1547,draw
1331,July 15,2011,Thailand,Myanmar,1,1,Friendly,in Thailand,-9,9,1394,1020,-1,2,110,183,1403,1011,draw
1332,July 16,2011,Argentina,Uruguay,1,1,Copa América,in Argentina,-9,9,1915,1905,-1,1,7,8,1924,1896,draw
1333,July 16,2011,Jordan,Iraq,1,1,Friendly tournament,in Jordan,-3,3,1515,1555,0,2,85,68,1518,1552,draw
1334,July 16,2011,Kuwait,Saudi Arabia,1,0,Friendly tournament,in Jordan,14,-14,1594,1550,1,-5,60,71,1580,1564,T1
1335,July 16,2011,Peru,Colombia,2,0,Copa América,in Argentina,50,-50,1746,1765,9,-8,32,25,1696,1815,T1
1336,July 17,2011,Belize,Montserrat,3,1,World Cup qualifier,in Honduras,2,-2,1081,513,1,0,175,230,1079,515,T1
1337,July 17,2011,Brazil,Paraguay,0,0,Copa América,in Argentina,-16,16,2039,1815,-1,2,4,17,2055,1799,draw
1338,July 17,2011,Iran,Madagascar,1,0,Friendly,in Iran,1,-1,1735,1236,0,0,36,147,1734,1237,T1
1339,July 17,2011,Qatar,India,1,2,Friendly,in Qatar,-19,19,1528,1213,-8,4,80,154,1547,1194,T2
1340,July 17,2011,United Arab Emirates,Lebanon,6,2,Friendly,in the United Arab Emirates,4,-4,1462,1204,0,-1,94,156,1458,1208,T1
1341,July 17,2011,Venezuela,Chile,2,1,Copa América,in Argentina,36,-36,1805,1905,5,-2,19,7,1769,1941,T1
1342,July 18,2011,Singapore,Taiwan,3,2,Friendly,in Singapore,1,-1,1325,917,0,0,126,196,1324,918,T1
1343,July 19,2011,Uruguay,Peru,2,0,Copa América,in Argentina,21,-21,1926,1725,2,-4,5,36,1905,1746,T1
1344,July 20,2011,Paraguay,Venezuela,0,0,Copa América,in Argentina,-1,1,1814,1806,0,0,17,19,1815,1805,draw
1345,July 23,2011,China,Laos,7,2,World Cup qualifier,in China,0,0,1652,843,0,0,49,204,1652,843,T1
1346,July 23,2011,Iran,Maldives,4,0,World Cup qualifier,in Iran,1,-1,1736,1133,-1,0,36,170,1735,1134,T1
1347,July 23,2011,Iraq,Yemen,2,0,World Cup qualifier,in Iraq,7,-7,1562,1296,1,-1,67,132,1555,1303,T1
1348,July 23,2011,Jordan,Nepal,9,0,World Cup qualifier,in Jordan,2,-2,1517,964,0,0,85,189,1515,966,T1
1349,July 23,2011,Kuwait,Philippines,3,0,World Cup qualifier,in Kuwait,1,-1,1595,1011,0,0,60,185,1594,1012,T1
1350,July 23,2011,Lebanon,Bangladesh,4,0,World Cup qualifier,in Lebanon,9,-9,1213,952,3,-2,153,192,1204,961,T1
1351,July 23,2011,Oman,Myanmar,2,0,World Cup qualifier,in Oman,2,-2,1549,1018,-1,-1,73,184,1547,1020,T1
1352,July 23,2011,Peru,Venezuela,4,1,Copa América,in Argentina,54,-54,1779,1752,13,-13,23,32,1725,1806,T1
1353,July 23,2011,Qatar,Vietnam,3,0,World Cup qualifier,in Qatar,7,-7,1535,1245,1,-1,79,144,1528,1252,T1
1354,July 23,2011,Saudi Arabia,Hong Kong,3,0,World Cup qualifier,in Saudi Arabia,5,-5,1555,1199,2,-1,69,157,1550,1204,T1
1355,July 23,2011,Singapore,Malaysia,5,3,World Cup qualifier,in Singapore,15,-15,1340,1213,3,-2,123,153,1325,1228,T1
1356,July 23,2011,Syria,Tajikistan,2,1,World Cup qualifier,in Jordan,7,-7,1554,1282,1,-1,71,135,1547,1289,T1
1357,July 23,2011,Thailand,Palestine,1,0,World Cup qualifier,in Thailand,6,-6,1400,1171,0,-1,110,164,1394,1177,T1
1358,July 23,2011,Turkmenistan,Indonesia,1,1,World Cup qualifier,in Turkmenistan,-9,9,1362,1303,-3,1,118,131,1371,1294,draw
1359,July 23,2011,United Arab Emirates,India,3,0,World Cup qualifier,in the United Arab Emirates,8,-8,1470,1205,2,-2,92,156,1462,1213,T1
1360,July 23,2011,Uzbekistan,Kyrgyzstan,4,0,World Cup qualifier,in Uzbekistan,4,-4,1561,1137,-1,0,68,169,1557,1141,T1
1361,July 24,2011,Liberia,Gambia,3,2,Friendly,in Liberia,11,-11,1258,1380,2,0,141,112,1247,1391,T1
1362,July 24,2011,Uruguay,Paraguay,3,0,Copa América,in Argentina,30,-30,1956,1784,0,-3,5,20,1926,1814,T1
1363,July 27,2011,Vanuatu,Solomon Islands,0,0,Friendly,in Vanuatu,-1,1,1235,1289,-1,0,148,134,1236,1288,draw
1364,July 28,2011,Bangladesh,Lebanon,2,0,World Cup qualifier,in Bangladesh,43,-43,995,1170,4,-11,188,164,952,1213,T1
1365,July 28,2011,Hong Kong,Saudi Arabia,0,5,World Cup qualifier,in Hong Kong,-15,15,1184,1570,-3,3,160,66,1199,1555,T2
1366,July 28,2011,India,United Arab Emirates,2,2,World Cup qualifier,in India,9,-9,1214,1461,2,-2,154,94,1205,1470,draw
1367,July 28,2011,Indonesia,Turkmenistan,4,3,World Cup qualifier,in Indonesia,18,-18,1321,1344,4,-4,127,122,1303,1362,T1
1368,July 28,2011,Iraq,Yemen,0,0,World Cup qualifier,in the United Arab Emirates,-13,13,1549,1309,-6,1,73,131,1562,1296,draw
1369,July 28,2011,Kyrgyzstan,Uzbekistan,0,3,World Cup qualifier,in Kyrgyzstan,-9,9,1128,1570,-2,2,171,66,1137,1561,T2
1370,July 28,2011,Laos,China,1,6,World Cup qualifier,in Laos,-1,1,842,1653,0,0,204,49,843,1652,T2
1371,July 28,2011,Malaysia,Singapore,1,1,World Cup qualifier,in Malaysia,2,-2,1215,1338,0,-3,153,126,1213,1340,draw
1372,July 28,2011,Maldives,Iran,0,1,World Cup qualifier,in the Maldives,-2,2,1131,1738,1,1,169,35,1133,1736,T2
1373,July 28,2011,Myanmar,Oman,0,2,World Cup qualifier,in Myanmar,-5,5,1013,1554,0,2,184,71,1018,1549,T2
1374,July 28,2011,Nepal,Jordan,1,1,World Cup qualifier,in Nepal,17,-17,981,1500,0,-1,189,86,964,1517,draw
1375,July 28,2011,Palestine,Thailand,2,2,World Cup qualifier,in Palestine,7,-7,1178,1393,3,0,161,110,1171,1400,draw
1376,July 28,2011,Philippines,Kuwait,1,2,World Cup qualifier,in the Philippines,-2,2,1009,1597,0,0,185,60,1011,1595,T2
1377,July 28,2011,Tajikistan,Syria,0,4,World Cup qualifier,in Tajikistan,-20,20,1262,1574,-5,7,140,64,1282,1554,T2
1378,July 28,2011,Vietnam,Qatar,2,1,World Cup qualifier,in Vietnam,30,-30,1275,1505,9,-6,135,85,1245,1535,T1
1379,July 29,2011,Mauritius,Mayotte,0,2,Friendly,in Mauritius,-15,15,1004,1141,-3,3,186,169,1019,1126,T2
1380,July 30,2011,Vanuatu,Solomon Islands,2,0,Friendly,in Vanuatu,13,-13,1248,1276,3,0,145,134,1235,1289,T1
1381,July 31,2011,Botswana,Swaziland,2,0,Friendly,in South Africa,5,-5,1432,1124,1,-1,103,172,1427,1129,T1
1382,August 4,2011,Madagascar,Mayotte,1,1,Indian Ocean Games,in the Seychelles,-4,4,1232,1145,-2,2,150,167,1236,1141,draw
1383,August 4,2011,Maldives,Mauritius,1,1,Indian Ocean Games,in the Seychelles,-5,5,1126,1009,-1,2,171,184,1131,1004,draw
1384,August 4,2011,Seychelles,Comoros,0,0,Indian Ocean Games,in the Seychelles,-9,9,1016,887,0,2,182,201,1025,878,draw
1385,August 6,2011,Comoros,Maldives,2,2,Indian Ocean Games,in the Seychelles,9,-9,896,1117,2,-3,199,174,887,1126,draw
1386,August 6,2011,Réunion,Madagascar,2,1,Indian Ocean Games,in the Seychelles,9,-9,1380,1223,3,-2,112,152,1371,1232,T1
1387,August 6,2011,Seychelles,Mauritius,2,1,Indian Ocean Games,in the Seychelles,11,-11,1027,998,0,-3,182,187,1016,1009,T1
1388,August 7,2011,El Salvador,Venezuela,2,1,Friendly,in the United States,15,-15,1561,1737,4,-4,70,36,1546,1752,T1
1389,August 8,2011,Mayotte,Réunion,2,0,Indian Ocean Games,in the Seychelles,36,-36,1181,1344,6,-9,161,121,1145,1380,T1
1390,August 9,2011,Mauritius,Comoros,2,0,Indian Ocean Games,in the Seychelles,16,-16,1014,880,4,-4,183,203,998,896,T1
1391,August 9,2011,Seychelles,Maldives,5,1,Indian Ocean Games,in the Seychelles,27,-27,1054,1090,2,0,180,174,1027,1117,T1
1392,August 10,2011,Albania,Montenegro,3,2,Friendly,in Albania,13,-13,1536,1706,4,-2,77,39,1523,1719,T1
1393,August 10,2011,Austria,Slovakia,1,2,Friendly,in Austria,-11,11,1552,1643,-3,3,72,54,1563,1632,T2
1394,August 10,2011,Azerbaijan,Macedonia,0,1,Friendly,in Azerbaijan,-10,10,1406,1539,0,4,107,75,1416,1529,T2
1395,August 10,2011,Bahrain,Oman,1,1,Friendly,in the United Arab Emirates,3,-3,1461,1551,1,-1,94,73,1458,1554,draw
1396,August 10,2011,Belarus,Bulgaria,1,0,Friendly,in Belarus,10,-10,1643,1707,2,0,54,38,1633,1717,T1
1397,August 10,2011,Bolivia,Panama,1,3,Friendly,in Bolivia,-15,15,1527,1663,-3,3,80,48,1542,1648,T2
1398,August 10,2011,Bosnia and Herzegovina,Greece,0,0,Friendly,in Bosnia and Herzegovina,0,0,1636,1753,-2,1,57,30,1636,1753,draw
1399,August 10,2011,Botswana,Kenya,1,0,Friendly,in Botswana,4,-4,1436,1269,2,-2,101,138,1432,1273,T1
1400,August 10,2011,China,Jamaica,1,0,Friendly,in China,8,-8,1661,1669,0,-1,49,46,1653,1677,T1
1401,August 10,2011,Costa Rica,Ecuador,0,2,Friendly,in Costa Rica,-18,18,1645,1715,-5,4,53,37,1663,1697,T2
1402,August 10,2011,Cyprus,Moldova,3,2,Friendly,in Cyprus,5,-5,1527,1446,2,-1,80,99,1522,1451,T1
1403,August 10,2011,France,Chile,1,1,Friendly,in France,-1,1,1842,1906,0,0,14,8,1843,1905,draw
1404,August 10,2011,Gabon,Guinea,1,1,Friendly,in France,-1,1,1554,1508,1,0,70,84,1555,1507,draw
1405,August 10,2011,Gambia,Democratic Republic of Congo,3,0,Friendly,in The Gambia,15,-15,1395,1406,2,-2,110,107,1380,1421,T1
1406,August 10,2011,Germany,Brazil,3,2,Friendly,in Germany,7,-7,2061,2032,0,0,3,4,2054,2039,T1
1407,August 10,2011,Guinea-Bissau,Equatorial Guinea,4,1,Friendly,in Portugal,16,-16,1271,1209,7,-4,137,155,1255,1225,T1
1408,August 10,2011,Honduras,Venezuela,2,0,Friendly,in the United States,19,-19,1661,1718,3,0,49,36,1642,1737,T1
1409,August 10,2011,Hungary,Iceland,4,0,Friendly,in Hungary,5,-5,1647,1428,0,-2,52,104,1642,1433,T1
1410,August 10,2011,Ireland,Croatia,0,0,Friendly,in Ireland,0,0,1801,1888,-1,0,19,10,1801,1888,draw
1411,August 10,2011,Italy,Spain,2,1,Friendly,in Italy,15,-15,1875,2121,0,0,11,1,1860,2136,T1
1412,August 10,2011,Ivory Coast,Israel,4,3,Friendly,in Switzerland,9,-9,1754,1692,3,-1,29,41,1745,1701,T1
1413,August 10,2011,Japan,South Korea,3,0,Friendly,in Japan,12,-12,1835,1806,0,-1,15,17,1823,1818,T1
1414,August 10,2011,Kazakhstan,Syria,1,1,Friendly,in Kazakhstan,3,-3,1351,1571,0,-1,120,65,1348,1574,draw
1415,August 10,2011,Kuwait,North Korea,0,0,Friendly,in Kuwait,-5,5,1592,1498,-2,3,62,87,1597,1493,draw
1416,August 10,2011,Latvia,Finland,0,2,Friendly,in Latvia,-16,16,1482,1601,-3,2,91,59,1498,1585,T2
1417,August 10,2011,Liberia,Angola,0,0,Friendly,in Liberia,2,-2,1260,1443,0,0,142,100,1258,1445,draw
1418,August 10,2011,Liechtenstein,Switzerland,1,2,Friendly,in Liechtenstein,-2,2,1225,1765,0,3,150,24,1227,1763,T2
1419,August 10,2011,Lithuania,Armenia,3,0,Friendly,in Lithuania,8,-8,1553,1434,4,-1,71,102,1545,1442,T1
1420,August 10,2011,Malta,Central African Republic,2,1,Friendly,in Malta,9,-9,1218,1248,3,-1,152,144,1209,1257,T1
1421,August 10,2011,Niger,Togo,3,3,Friendly,in Niger,-1,1,1307,1367,0,0,132,116,1308,1366,draw
1422,August 10,2011,Norway,Czechia,3,0,Friendly,in Norway,11,-11,1791,1729,2,-2,20,35,1780,1740,T1
1423,August 10,2011,Northern Ireland,Faroe Islands,4,0,European Championship qualifier,in Northern Ireland,7,-7,1526,1226,1,0,82,149,1519,1233,T1
1424,August 10,2011,Poland,Georgia,1,0,Friendly,in Poland,4,-4,1687,1534,0,0,43,78,1683,1538,T1
1425,August 10,2011,Portugal,Luxembourg,5,0,Friendly,in Portugal,0,0,1900,1124,0,0,9,171,1900,1124,T1
1426,August 10,2011,Russia,Serbia,1,0,Friendly,in Russia,6,-6,1803,1749,1,-2,18,32,1797,1755,T1
1427,August 10,2011,San Marino,Romania,0,1,Friendly,in San Marino,0,0,898,1706,0,0,198,39,898,1706,T2
1428,August 10,2011,Scotland,Denmark,2,1,Friendly,in Scotland,9,-9,1690,1751,2,-3,42,31,1681,1760,T1
1429,August 10,2011,Senegal,Morocco,0,2,Friendly,in Senegal,-21,21,1594,1594,-2,5,60,60,1615,1573,T2
1430,August 10,2011,Slovenia,Belgium,0,0,Friendly,in Slovenia,-3,3,1684,1667,-2,0,44,47,1687,1664,draw
1431,August 10,2011,South Africa,Burkina Faso,3,0,Friendly,in South Africa,8,-8,1660,1520,-1,-3,51,83,1652,1528,T1
1432,August 10,2011,Tunisia,Mali,4,2,Friendly,in Tunisia,8,-8,1586,1492,-1,-3,63,89,1578,1500,T1
1433,August 10,2011,Turkey,Estonia,3,0,Friendly,in Turkey,3,-3,1787,1450,-1,-1,21,98,1784,1453,T1
1434,August 10,2011,Ukraine,Sweden,0,1,Friendly,in Ukraine,-11,11,1760,1863,-3,1,27,12,1771,1852,T2
1435,August 10,2011,United States,Mexico,1,1,Friendly,in the United States,1,-1,1739,1858,1,-1,33,13,1738,1859,draw
1436,August 10,2011,Wales,Australia,1,2,Friendly,in Wales,-6,6,1539,1819,0,1,75,16,1545,1813,T2
1437,August 10,2011,Zimbabwe,Zambia,2,0,Friendly,in Zimbabwe,19,-19,1369,1533,4,-6,115,79,1350,1552,T1
1438,August 11,2011,Mauritius,Mayotte,0,0,Indian Ocean Games,in the Seychelles,7,-7,1021,1174,0,-3,183,164,1014,1181,draw
1439,August 11,2011,Seychelles,Réunion,2,1,Indian Ocean Games,in the Seychelles,22,-22,1076,1322,3,-5,177,126,1054,1344,T1
1440,August 13,2011,Réunion,Mayotte,1,0,Indian Ocean Games,in the Seychelles,9,-9,1331,1165,0,-1,126,165,1322,1174,T1
1441,August 13,2011,Seychelles,Mauritius,1,1,Indian Ocean Games,in the Seychelles,-6,6,1070,1027,-1,0,178,183,1076,1021,draw
1442,August 14,2011,Liberia,Niger,0,0,Friendly,in Liberia,-2,2,1258,1309,-1,1,143,131,1260,1307,draw
1443,August 17,2011,Fiji,Samoa,3,0,Friendly,in Fiji,1,-1,1316,701,0,0,130,214,1315,702,T1
1444,August 17,2011,Lebanon,Syria,2,3,Friendly,in Lebanon,-3,3,1167,1574,0,0,164,65,1170,1571,T2
1445,August 18,2011,Fiji,Samoa,5,1,Friendly,in Fiji,1,-1,1317,700,0,-1,130,215,1316,701,T1
1446,August 19,2011,Eritrea,Sudan,0,3,Friendly,in Eritrea,-13,13,1165,1390,-3,1,164,113,1178,1377,T2
1447,August 19,2011,Qatar,Iraq,0,1,Friendly,in Qatar,-12,12,1493,1561,-3,5,88,69,1505,1549,T2
1448,August 20,2011,Dominican Republic,Curaçao,1,0,Friendly,in the Dominican Republic,9,-9,1062,1115,2,-2,179,173,1053,1124,T1
1449,August 20,2011,Lesotho,Swaziland,0,0,Friendly,in Lesotho,-4,4,1158,1128,0,1,166,170,1162,1124,draw
1450,August 21,2011,Barbados,Saint Lucia,4,0,Friendly,in Barbados,6,-6,1246,1051,0,-1,146,181,1240,1057,T1
1451,August 21,2011,Dominican Republic,Curaçao,1,0,Friendly,in the Dominican Republic,9,-9,1071,1106,1,0,178,173,1062,1115,T1
1452,August 21,2011,Trinidad and Tobago,India,3,0,Friendly,in Trinidad and Tobago,4,-4,1498,1210,1,0,86,154,1494,1214,T1
1453,August 22,2011,Indonesia,Palestine,4,1,Friendly,in Indonesia,7,-7,1328,1171,0,-1,127,162,1321,1178,T1
1454,August 22,2011,Jordan,Tunisia,3,3,Friendly,in Jordan,0,0,1500,1586,0,0,85,63,1500,1586,draw
1455,August 22,2011,Lesotho,Swaziland,0,1,Friendly,in Lesotho,-14,14,1144,1142,-1,0,167,170,1158,1128,T2
1456,August 22,2011,Tuvalu,Samoa,3,0,Friendly,in Fiji,16,-16,737,684,2,-4,211,219,721,700,T1
1457,August 24,2011,Guyana,India,2,1,Friendly,in Guyana,5,-5,1326,1205,0,-1,128,155,1321,1210,T1
1458,August 24,2011,Thailand,Singapore,0,0,Friendly,in Thailand,-4,4,1389,1342,-2,3,113,122,1393,1338,draw
1459,August 25,2011,United Arab Emirates,Qatar,3,1,Friendly,in the United Arab Emirates,12,-12,1473,1481,2,-3,92,91,1461,1493,T1
1460,August 26,2011,Antigua and Barbuda,Saint Vincent and the Grenadines,1,0,Friendly,in Antigua and Barbuda,5,-5,1272,1185,2,-1,137,159,1267,1190,T1
1461,August 26,2011,Bahrain,Sudan,1,0,Friendly,in Bahrain,5,-5,1466,1385,1,-1,94,113,1461,1390,T1
1462,August 27,2011,Angola,Democratic Republic of Congo,1,2,Friendly,in Angola,-14,14,1429,1420,-3,2,103,105,1443,1406,T2
1463,August 27,2011,Fiji,Tahiti,3,0,Pacific Games,in New Caledonia,21,-21,1338,1154,4,-4,126,165,1317,1175,T1
1464,August 27,2011,Jordan,Indonesia,1,0,Friendly,in Jordan,3,-3,1503,1325,0,-2,85,129,1500,1328,T1
1465,August 27,2011,New Caledonia,Vanuatu,5,0,Pacific Games,in New Caledonia,28,-28,1288,1220,8,-7,134,151,1260,1248,T1
1466,August 27,2011,Oman,Kuwait,1,0,Friendly,in Oman,8,-8,1559,1584,3,-1,71,63,1551,1592,T1
1467,August 27,2011,Papua New Guinea,Cook Islands,4,0,Pacific Games,in New Caledonia,10,-10,1056,716,2,0,180,213,1046,726,T1
1468,August 27,2011,Solomon Islands,Guam,7,0,Pacific Games,in New Caledonia,2,-2,1278,598,-1,0,135,223,1276,600,T1
1469,August 27,2011,Tuvalu,Eastern Samoa,4,0,Pacific Games,in New Caledonia,7,-7,744,348,0,0,211,233,737,355,T1
1470,August 28,2011,Antigua and Barbuda,Saint Vincent and the Grenadines,2,2,Friendly,in Antigua and Barbuda,-5,5,1267,1190,-2,1,140,158,1272,1185,draw
1471,August 30,2011,Botswana,Lesotho,1,2,Friendly,in Botswana,-18,18,1418,1162,-6,2,106,165,1436,1144,T2
1472,August 30,2011,Fiji,Kiribati,9,0,Pacific Games,in New Caledonia,1,-1,1339,578,1,0,125,225,1338,579,T1
1473,August 30,2011,New Caledonia,Guam,9,0,Pacific Games,in New Caledonia,1,-1,1289,597,0,0,134,223,1288,598,T1
1474,August 30,2011,Solomon Islands,Eastern Samoa,4,0,Pacific Games,in New Caledonia,0,0,1278,348,0,0,135,233,1278,348,T1
1475,August 30,2011,Tahiti,Cook Islands,7,0,Pacific Games,in New Caledonia,7,-7,1161,709,-1,0,166,213,1154,716,T1
1476,August 30,2011,Vanuatu,Tuvalu,5,1,Pacific Games,in New Caledonia,5,-5,1225,739,2,0,149,211,1220,744,T1
1477,September 1,2011,Cook Islands,Kiribati,3,0,Pacific Games,in New Caledonia,22,-22,731,556,0,-3,213,228,709,578,T1
1478,September 1,2011,Guam,Eastern Samoa,2,0,Pacific Games,in New Caledonia,12,-12,609,336,0,0,223,233,597,348,T1
1479,September 1,2011,New Caledonia,Tuvalu,8,0,Pacific Games,in New Caledonia,2,-2,1291,737,1,0,133,211,1289,739,T1
1480,September 1,2011,Papua New Guinea,Tahiti,1,1,Pacific Games,in New Caledonia,6,-6,1062,1155,0,0,180,166,1056,1161,draw
1481,September 1,2011,Vanuatu,Solomon Islands,1,0,Pacific Games,in New Caledonia,23,-23,1248,1255,5,-8,144,143,1225,1278,T1
1482,September 2,2011,Albania,France,1,2,European Championship qualifier,in Albania,-9,9,1527,1851,-2,1,79,13,1536,1842,T2
1483,September 2,2011,Andorra,Armenia,0,3,European Championship qualifier,in Andorra,-9,9,1000,1443,-2,1,187,99,1009,1434,T2
1484,September 2,2011,Antigua and Barbuda,Curaçao,5,2,World Cup qualifier,in Antigua and Barbuda,13,-13,1280,1093,4,-2,135,175,1267,1106,T1
1485,September 2,2011,Argentina,Venezuela,1,0,Friendly tournament,in India,7,-7,1922,1711,0,-1,7,37,1915,1718,T1
1486,September 2,2011,Australia,Thailand,2,1,World Cup qualifier,in Australia,2,-2,1821,1387,0,0,16,112,1819,1389,T1
1487,September 2,2011,Azerbaijan,Belgium,1,1,European Championship qualifier,in Azerbaijan,9,-9,1415,1658,1,-4,107,51,1406,1667,draw
1488,September 2,2011,Bahrain,Qatar,0,0,World Cup qualifier,in Bahrain,-5,5,1461,1486,-1,0,95,91,1466,1481,draw
1489,September 2,2011,Belarus,Bosnia and Herzegovina,0,2,European Championship qualifier,in Belarus,-39,39,1604,1675,-5,13,59,44,1643,1636,T2
1490,September 2,2011,Bulgaria,England,0,3,European Championship qualifier,in Bulgaria,-24,24,1683,1944,-3,0,41,6,1707,1920,T2
1491,September 2,2011,Canada,Saint Lucia,4,1,World Cup qualifier,in Canada,1,-1,1616,1050,1,1,57,181,1615,1051,T1
1492,September 2,2011,China,Singapore,2,1,World Cup qualifier,in China,3,-3,1664,1339,2,-3,47,125,1661,1342,T1
1493,September 2,2011,Cyprus,Portugal,0,4,European Championship qualifier,in Cyprus,-13,13,1514,1913,-2,1,82,8,1527,1900,T2
1494,September 2,2011,Dominica,Nicaragua,0,2,World Cup qualifier,in Dominica,-39,39,1041,1111,-6,3,182,174,1080,1072,T2
1495,September 2,2011,Ecuador,Jamaica,5,2,Friendly,in Ecuador,11,-11,1726,1658,2,-5,35,51,1715,1669,T1
1496,September 2,2011,El Salvador,Dominican Republic,3,2,World Cup qualifier,in El Salvador,1,-1,1562,1070,-1,1,70,177,1561,1071,T1
1497,September 2,2011,Faroe Islands,Italy,0,1,European Championship qualifier,in the Faroe Islands,-2,2,1224,1877,0,0,149,11,1226,1875,T2
1498,September 2,2011,Finland,Moldova,4,1,European Championship qualifier,in Finland,13,-13,1614,1433,1,-1,58,100,1601,1446,T1
1499,September 2,2011,Georgia,Latvia,0,1,European Championship qualifier,in Georgia,-28,28,1506,1510,-8,6,86,84,1534,1482,T2
1500,September 2,2011,Germany,Austria,6,2,European Championship qualifier,in Germany,2,-2,2063,1550,0,1,3,73,2061,1552,T1
1501,September 2,2011,Ghana,Swaziland,2,0,African Nations Cup qualifier,in Ghana,1,-1,1765,1141,1,0,25,170,1764,1142,T1
1502,September 2,2011,Grenada,Belize,0,3,World Cup qualifier,in Grenada,-57,57,1177,1138,-11,4,159,171,1234,1081,T2
1503,September 2,2011,Guatemala,Saint Vincent and the Grenadines,4,0,World Cup qualifier,in Guatemala,8,-8,1459,1182,1,0,96,158,1451,1190,T1
1504,September 2,2011,Guyana,Barbados,2,0,World Cup qualifier,in Guyana,16,-16,1342,1230,6,-2,122,148,1326,1246,T1
1505,September 2,2011,Haiti,US Virgin Islands,6,0,World Cup qualifier,in Haiti,1,-1,1432,736,0,-1,101,212,1431,737,T1
1506,September 2,2011,Hungary,Sweden,2,1,European Championship qualifier,in Hungary,26,-26,1673,1837,7,-3,45,15,1647,1863,T1
1507,September 2,2011,Iran,Indonesia,3,0,World Cup qualifier,in Iran,3,-3,1741,1322,1,0,33,129,1738,1325,T1
1508,September 2,2011,Iraq,Jordan,0,2,World Cup qualifier,in Iraq,-43,43,1518,1546,-12,11,81,74,1561,1503,T2
1509,September 2,2011,Ireland,Slovakia,0,0,European Championship qualifier,in Ireland,-13,13,1788,1656,-3,1,22,53,1801,1643,draw
1510,September 2,2011,Israel,Greece,0,1,European Championship qualifier,in Israel,-22,22,1670,1775,-5,7,46,23,1692,1753,T2
1511,September 2,2011,Japan,North Korea,1,0,World Cup qualifier,in Japan,3,-3,1838,1495,1,-2,14,88,1835,1498,T1
1512,September 2,2011,Lithuania,Liechtenstein,0,0,European Championship qualifier,in Lithuania,-17,17,1536,1242,-2,4,75,146,1553,1225,draw
1513,September 2,2011,Luxembourg,Romania,0,2,European Championship qualifier,in Luxembourg,-4,4,1120,1710,-1,1,173,38,1124,1706,T2
1514,September 2,2011,Malta,Croatia,1,3,European Championship qualifier,in Malta,-2,2,1216,1890,1,0,151,10,1218,1888,T2
1515,September 2,2011,Netherlands,San Marino,11,0,European Championship qualifier,in the Netherlands,0,0,2113,898,0,0,2,198,2113,898,T1
1516,September 2,2011,Norway,Iceland,1,0,European Championship qualifier,in Norway,3,-3,1794,1425,0,0,20,103,1791,1428,T1
1517,September 2,2011,Northern Ireland,Serbia,0,1,European Championship qualifier,in Northern Ireland,-13,13,1513,1762,-1,4,83,28,1526,1749,T2
1518,September 2,2011,Oman,Saudi Arabia,0,0,World Cup qualifier,in Oman,-5,5,1554,1575,0,0,71,66,1559,1570,draw
1519,September 2,2011,Panama,Paraguay,0,2,Friendly,in Panama,-14,14,1649,1798,-6,3,54,19,1663,1784,T2
1520,September 2,2011,Peru,Bolivia,2,2,Friendly,in Peru,-8,8,1771,1535,-1,4,24,76,1779,1527,draw
1521,September 2,2011,Poland,Mexico,1,1,Friendly,in Poland,2,-2,1689,1856,3,1,40,12,1687,1858,draw
1522,September 2,2011,Russia,Macedonia,1,0,European Championship qualifier,in Russia,4,-4,1807,1535,1,-1,17,76,1803,1539,T1
1523,September 2,2011,Slovenia,Estonia,1,2,European Championship qualifier,in Slovenia,-35,35,1649,1485,-10,6,54,92,1684,1450,T2
1524,September 2,2011,South Korea,Lebanon,6,0,World Cup qualifier,in South Korea,1,-1,1807,1166,0,0,17,162,1806,1167,T1
1525,September 2,2011,Spain,Chile,3,2,Friendly,in Switzerland,4,-4,2125,1902,0,-1,1,9,2121,1906,T1
1526,September 2,2011,Saint Kitts and Nevis,Puerto Rico,0,0,World Cup qualifier,in Saint Kitts and Nevis,-14,14,1174,1013,-1,3,160,184,1188,999,draw
1527,September 2,2011,Suriname,Cayman Islands,1,0,World Cup qualifier,in Suriname,4,-4,1269,957,1,-1,139,192,1265,961,T1
1528,September 2,2011,Tajikistan,Uzbekistan,0,1,World Cup qualifier,in Tajikistan,-9,9,1253,1579,-2,2,143,64,1262,1570,T2
1529,September 2,2011,Trinidad and Tobago,Bermuda,1,0,World Cup qualifier,in Trinidad and Tobago,3,-3,1501,1150,-1,0,87,167,1498,1153,T1
1530,September 2,2011,Turkey,Kazakhstan,2,1,European Championship qualifier,in Turkey,2,-2,1789,1349,0,0,21,120,1787,1351,T1
1531,September 2,2011,United Arab Emirates,Kuwait,2,3,World Cup qualifier,in the United Arab Emirates,-19,19,1454,1603,-5,3,97,60,1473,1584,T2
1532,September 2,2011,Ukraine,Uruguay,2,3,Friendly,in Ukraine,-7,7,1753,1963,-4,0,31,5,1760,1956,T2
1533,September 2,2011,United States,Costa Rica,0,1,Friendly,in the United States,-15,15,1724,1660,-3,4,36,49,1739,1645,T2
1534,September 2,2011,Wales,Montenegro,2,1,European Championship qualifier,in Wales,24,-24,1563,1682,6,-3,69,42,1539,1706,T1
1535,September 3,2011,Burkina Faso,Equatorial Guinea,1,0,Friendly,in Burkina Faso,2,-2,1522,1207,0,0,80,153,1520,1209,T1
1536,September 3,2011,Cameroon,Mauritius,5,0,African Nations Cup qualifier,in Cameroon,1,-1,1640,1026,0,0,56,183,1639,1027,T1
1537,September 3,2011,Colombia,Honduras,2,0,Friendly,in the United States,11,-11,1776,1650,2,-5,23,53,1765,1661,T1
1538,September 3,2011,Fiji,Cook Islands,4,1,Pacific Games,in New Caledonia,2,-2,1341,729,3,0,122,213,1339,731,T1
1539,September 3,2011,Kenya,Guinea-Bissau,2,1,African Nations Cup qualifier,in Kenya,15,-15,1284,1256,3,-4,136,142,1269,1271,T1
1540,September 3,2011,Libya,Mozambique,1,0,African Nations Cup qualifier,in Egypt,12,-12,1502,1341,2,-3,88,122,1490,1353,T1
1541,September 3,2011,Malawi,Tunisia,0,0,African Nations Cup qualifier,in Malawi,4,-4,1423,1582,1,0,104,63,1419,1586,draw
1542,September 3,2011,Mali,Cape Verde,3,0,African Nations Cup qualifier,in Mali,17,-17,1509,1384,4,-3,85,112,1492,1401,T1
1543,September 3,2011,Namibia,Gambia,1,0,African Nations Cup qualifier,in Namibia,21,-21,1294,1374,3,-4,134,114,1273,1395,T1
1544,September 3,2011,New Caledonia,Eastern Samoa,8,0,Pacific Games,in New Caledonia,0,0,1291,336,-2,0,135,233,1291,336,T1
1545,September 3,2011,Papua New Guinea,Kiribati,17,1,Pacific Games,in New Caledonia,7,-7,1069,549,0,0,179,228,1062,556,T1
1546,September 3,2011,Rwanda,Ivory Coast,0,5,African Nations Cup qualifier,in Rwanda,-11,11,1328,1765,-3,4,128,26,1339,1754,T2
1547,September 3,2011,Scotland,Czechia,2,2,European Championship qualifier,in Scotland,-3,3,1687,1732,-1,1,40,33,1690,1729,draw
1548,September 3,2011,Senegal,Democratic Republic of Congo,2,0,African Nations Cup qualifier,in Senegal,10,-10,1604,1410,2,-4,59,108,1594,1420,T1
1549,September 3,2011,Sierra Leone,Egypt,2,1,African Nations Cup qualifier,in Sierra Leone,36,-36,1326,1720,5,-7,129,36,1290,1756,T1
1550,September 3,2011,Solomon Islands,Tuvalu,6,1,Pacific Games,in New Caledonia,4,-4,1259,733,2,-1,140,212,1255,737,T1
1551,September 3,2011,Tanzania,Algeria,1,1,African Nations Cup qualifier,in Tanzania,1,-1,1341,1462,1,0,122,94,1340,1463,draw
1552,September 3,2011,Vanuatu,Guam,4,1,Pacific Games,in New Caledonia,2,-2,1250,607,0,0,144,223,1248,609,T1
1553,September 4,2011,Angola,Uganda,2,0,African Nations Cup qualifier,in Angola,34,-34,1463,1542,8,-9,94,74,1429,1576,T1
1554,September 4,2011,Burundi,Benin,1,1,African Nations Cup qualifier,in Burundi,4,-4,1243,1411,2,0,145,106,1239,1415,draw
1555,September 4,2011,Central African Republic,Morocco,0,0,African Nations Cup qualifier,in Central African Republic,12,-12,1260,1582,5,0,140,62,1248,1594,draw
1556,September 4,2011,Comoros,Zambia,1,2,African Nations Cup qualifier,in the Comoros,-2,2,878,1535,0,2,203,76,880,1533,T2
1557,September 4,2011,Congo,Sudan,0,1,African Nations Cup qualifier,in Congo,-25,25,1342,1410,-4,4,120,107,1367,1385,T2
1558,September 4,2011,Guinea,Ethiopia,1,0,African Nations Cup qualifier,in Guinea,6,-6,1514,1313,4,-1,82,132,1508,1319,T1
1559,September 4,2011,Madagascar,Nigeria,0,2,African Nations Cup qualifier,in Madagascar,-7,7,1216,1683,0,2,150,41,1223,1676,T2
1560,September 4,2011,Mexico,Chile,1,0,Friendly,in Spain,11,-11,1867,1891,0,0,12,9,1856,1902,T1
1561,September 4,2011,Niger,South Africa,2,1,African Nations Cup qualifier,in Niger,32,-32,1341,1628,10,-8,122,56,1309,1660,T1
1562,September 4,2011,Togo,Botswana,1,0,African Nations Cup qualifier,in Togo,17,-17,1384,1401,3,-4,113,109,1367,1418,T1
1563,September 4,2011,Zimbabwe,Liberia,3,0,African Nations Cup qualifier,in Zimbabwe,16,-16,1385,1242,3,-5,112,146,1369,1258,T1
1564,September 5,2011,Bolivia,Peru,0,0,Friendly,in Bolivia,4,-4,1539,1767,1,0,75,25,1535,1771,draw
1565,September 5,2011,Brazil,Ghana,1,0,Friendly,in England,4,-4,2036,1761,0,-3,4,29,2032,1765,T1
1566,September 5,2011,Fiji,Papua New Guinea,2,0,Pacific Games,in New Caledonia,10,-10,1351,1059,4,0,118,179,1341,1069,T1
1567,September 5,2011,Guam,Tuvalu,1,1,Pacific Games,in New Caledonia,7,-7,614,726,0,-1,223,213,607,733,draw
1568,September 5,2011,New Caledonia,Solomon Islands,1,2,Pacific Games,in New Caledonia,-27,27,1264,1286,-5,6,140,135,1291,1259,T2
1569,September 5,2011,Tahiti,Kiribati,17,1,Pacific Games,in New Caledonia,4,-4,1159,545,0,0,166,228,1155,549,T1
1570,September 5,2011,Vanuatu,Eastern Samoa,8,0,Pacific Games,in New Caledonia,0,0,1250,336,0,0,144,233,1250,336,T1
1571,September 6,2011,Argentina,Nigeria,3,1,Friendly,in Bangladesh,6,-6,1928,1677,0,-3,7,44,1922,1683,T1
1572,September 6,2011,Austria,Turkey,0,0,European Championship qualifier,in Austria,8,-8,1558,1781,1,-1,71,22,1550,1789,draw
1573,September 6,2011,Azerbaijan,Kazakhstan,3,2,European Championship qualifier,in Azerbaijan,11,-11,1426,1338,2,-6,103,125,1415,1349,T1
1574,September 6,2011,Barbados,Trinidad and Tobago,0,2,World Cup qualifier,in Barbados,-16,16,1214,1517,-4,8,152,81,1230,1501,T2
1575,September 6,2011,Belgium,United States,1,0,Friendly,in Belgium,9,-9,1667,1715,4,-1,45,36,1658,1724,T1
1576,September 6,2011,Belize,Guatemala,1,2,World Cup qualifier,in Belize,-9,9,1129,1468,-1,2,172,95,1138,1459,T2
1577,September 6,2011,Bosnia and Herzegovina,Belarus,1,0,European Championship qualifier,in Bosnia and Herzegovina,11,-11,1686,1593,2,-1,42,60,1675,1604,T1
1578,September 6,2011,Cayman Islands,El Salvador,1,4,World Cup qualifier,in the Cayman Islands,-4,4,953,1566,0,1,192,68,957,1562,T2
1579,September 6,2011,Colombia,Jamaica,2,0,Friendly,in the United States,10,-10,1786,1648,2,-1,21,50,1776,1658,T1
1580,September 6,2011,Croatia,Israel,3,1,European Championship qualifier,in Croatia,8,-8,1898,1662,1,-1,9,47,1890,1670,T1
1581,September 6,2011,Curaçao,Haiti,2,4,World Cup qualifier,in Curaçao,-12,12,1081,1444,-1,2,176,100,1093,1432,T2
1582,September 6,2011,Czechia,Ukraine,4,0,Friendly,in Czechia,15,-15,1747,1738,2,-2,31,32,1732,1753,T1
1583,September 6,2011,Denmark,Norway,2,0,European Championship qualifier,in Denmark,25,-25,1776,1769,7,-5,24,25,1751,1794,T1
1584,September 6,2011,Dominican Republic,Suriname,1,1,World Cup qualifier,in the Dominican Republic,6,-6,1076,1263,0,-1,177,140,1070,1269,draw
1585,September 6,2011,Ecuador,Costa Rica,4,0,Friendly,in Ecuador,10,-10,1736,1650,1,-1,33,49,1726,1660,T1
1586,September 6,2011,England,Wales,1,0,European Championship qualifier,in England,2,-2,1946,1561,0,-1,6,69,1944,1563,T1
1587,September 6,2011,Estonia,Northern Ireland,4,1,European Championship qualifier,in Estonia,28,-28,1513,1485,10,-10,82,94,1485,1513,T1
1588,September 6,2011,Finland,Netherlands,0,2,European Championship qualifier,in Finland,-5,5,1609,2118,1,0,57,2,1614,2113,T2
1589,September 6,2011,Gabon,Niger,1,0,Friendly,in France,5,-5,1559,1336,0,-3,70,126,1554,1341,T1
1590,September 6,2011,Guyana,Bermuda,2,1,World Cup qualifier,in Guyana,6,-6,1348,1144,2,-1,119,168,1342,1150,T1
1591,September 6,2011,Honduras,Paraguay,0,3,Friendly,in Honduras,-15,15,1635,1813,-2,2,54,17,1650,1798,T2
1592,September 6,2011,Iceland,Cyprus,1,0,European Championship qualifier,in Iceland,19,-19,1444,1495,3,-8,100,90,1425,1514,T1
1593,September 6,2011,Indonesia,Bahrain,0,2,World Cup qualifier,in Indonesia,-27,27,1295,1488,-2,3,133,93,1322,1461,T2
1594,September 6,2011,Italy,Slovenia,1,0,European Championship qualifier,in Italy,5,-5,1882,1644,0,2,11,51,1877,1649,T1
1595,September 6,2011,Jordan,China,2,1,World Cup qualifier,in Jordan,21,-21,1567,1643,7,-5,66,52,1546,1664,T1
1596,September 6,2011,Kuwait,South Korea,1,1,World Cup qualifier,in Kuwait,6,-6,1609,1801,4,-1,57,18,1603,1807,draw
1597,September 6,2011,Latvia,Greece,1,1,European Championship qualifier,in Latvia,9,-9,1519,1766,5,-3,80,27,1510,1775,draw
1598,September 6,2011,Lebanon,United Arab Emirates,3,1,World Cup qualifier,in Lebanon,45,-45,1211,1409,9,-11,153,109,1166,1454,T1
1599,September 6,2011,Luxembourg,Albania,2,1,European Championship qualifier,in Luxembourg,34,-34,1154,1493,6,-13,167,92,1120,1527,T1
1600,September 6,2011,Macedonia,Andorra,1,0,European Championship qualifier,in Macedonia,1,-1,1536,999,1,0,76,187,1535,1000,T1
1601,September 6,2011,Malta,Georgia,1,1,European Championship qualifier,in Malta,10,-10,1226,1496,2,-2,148,89,1216,1506,draw
1602,September 6,2011,Moldova,Hungary,0,2,European Championship qualifier,in Moldova,-19,19,1414,1692,-4,4,105,41,1433,1673,T2
1603,September 6,2011,Nicaragua,Panama,1,2,World Cup qualifier,in Nicaragua,-3,3,1108,1652,0,5,174,48,1111,1649,T2
1604,September 6,2011,North Korea,Tajikistan,1,0,World Cup qualifier,in North Korea,5,-5,1500,1248,2,-1,88,144,1495,1253,T1
1605,September 6,2011,Poland,Germany,2,2,Friendly,in Poland,7,-7,1696,2056,0,0,39,3,1689,2063,draw
1606,September 6,2011,Puerto Rico,Canada,0,3,World Cup qualifier,in Puerto Rico,-4,4,1009,1620,-1,1,185,56,1013,1616,T2
1607,September 6,2011,Qatar,Iran,1,1,World Cup qualifier,in Qatar,8,-8,1494,1733,0,-2,91,34,1486,1741,draw
1608,September 6,2011,Romania,France,0,0,European Championship qualifier,in Romania,2,-2,1712,1849,0,0,38,13,1710,1851,draw
1609,September 6,2011,Russia,Ireland,0,0,European Championship qualifier,in Russia,-7,7,1800,1795,-2,2,19,20,1807,1788,draw
1610,September 6,2011,San Marino,Sweden,0,5,European Championship qualifier,in San Marino,-1,1,897,1838,0,0,198,15,898,1837,T2
1611,September 6,2011,Saudi Arabia,Australia,1,3,World Cup qualifier,in Saudi Arabia,-18,18,1557,1839,-7,2,72,14,1575,1821,T2
1612,September 6,2011,Scotland,Lithuania,1,0,European Championship qualifier,in Scotland,8,-8,1695,1528,0,-2,40,78,1687,1536,T1
1613,September 6,2011,Serbia,Faroe Islands,3,1,European Championship qualifier,in Serbia,1,-1,1763,1223,-1,0,29,149,1762,1224,T1
1614,September 6,2011,Singapore,Iraq,0,2,World Cup qualifier,in Singapore,-23,23,1316,1541,-3,7,130,74,1339,1518,T2
1615,September 6,2011,Slovakia,Armenia,0,4,European Championship qualifier,in Slovakia,-64,64,1592,1507,-10,14,61,86,1656,1443,T2
1616,September 6,2011,Spain,Liechtenstein,6,0,European Championship qualifier,in Spain,0,0,2125,1242,0,0,1,146,2125,1242,T1
1617,September 6,2011,Saint Lucia,Saint Kitts and Nevis,2,4,World Cup qualifier,in Saint Lucia,-28,28,1022,1202,-2,4,183,156,1050,1174,T2
1618,September 6,2011,Switzerland,Bulgaria,3,1,European Championship qualifier,in Switzerland,16,-16,1781,1667,4,-4,22,45,1765,1683,T1
1619,September 6,2011,Thailand,Oman,3,0,World Cup qualifier,in Thailand,42,-42,1429,1512,9,-13,102,83,1387,1554,T1
1620,September 6,2011,US Virgin Islands,Antigua and Barbuda,1,8,World Cup qualifier,in the US Virgin Islands,-6,6,730,1286,0,2,211,135,736,1280,T2
1621,September 6,2011,Uzbekistan,Japan,1,1,World Cup qualifier,in Uzbekistan,9,-9,1588,1829,2,-2,62,16,1579,1838,draw
1622,September 6,2011,Venezuela,Guinea,2,1,Friendly,in Venezuela,3,-3,1714,1511,0,-2,37,84,1711,1514,T1
1623,September 7,2011,Equatorial Guinea,Central African Republic,3,0,Friendly,in Equatorial Guinea,15,-15,1222,1245,4,-3,150,144,1207,1260,T1
1624,September 7,2011,New Caledonia,Tahiti,3,1,Pacific Games,in New Caledonia,14,-14,1278,1145,1,-1,138,167,1264,1159,T1
1625,September 7,2011,Solomon Islands,Fiji,2,1,Pacific Games,in New Caledonia,24,-24,1310,1327,3,-10,132,128,1286,1351,T1
1626,September 9,2011,New Caledonia,Solomon Islands,2,0,Pacific Games,in New Caledonia,24,-24,1302,1286,6,-4,132,136,1278,1310,T1
1627,September 9,2011,Tahiti,Fiji,2,1,Pacific Games,in New Caledonia,30,-30,1175,1297,5,-5,162,133,1145,1327,T1
1628,September 11,2011,Saint Vincent and the Grenadines,Dominica,1,0,Friendly,in Saint Vincent and the Grenadines,4,-4,1186,1037,1,0,159,181,1182,1041,T1
1629,September 14,2011,Argentina,Brazil,0,0,Friendly tournament,in Argentina,0,0,1928,2036,0,0,7,4,1928,2036,draw
1630,September 18,2011,Saint Vincent and the Grenadines,Grenada,2,1,World Cup qualifier,in Saint Vincent and the Grenadines,14,-14,1200,1163,2,-4,157,165,1186,1177,T1
1631,September 23,2011,Suriname,Curaçao,2,0,Friendly,in Suriname,5,-5,1268,1076,0,0,140,176,1263,1081,T1
1632,September 25,2011,Suriname,Curaçao,2,2,Friendly,in Suriname,-7,7,1261,1083,0,0,140,176,1268,1076,draw
1633,September 28,2011,Brazil,Argentina,2,0,Friendly tournament,in Brazil,10,-10,2046,1918,0,0,4,7,2036,1928,T1
1634,September 30,2011,Antigua and Barbuda,Martinique,1,0,Friendly,in Antigua and Barbuda,9,-9,1295,1331,2,-2,134,125,1286,1340,T1
1635,September 30,2011,Hong Kong,Philippines,3,3,Friendly tournament,in Taiwan,-7,7,1177,1016,0,1,160,184,1184,1009,draw
1636,September 30,2011,Taiwan,Macao,3,0,Friendly tournament,in Taiwan,6,-6,923,668,0,0,196,220,917,674,T1
1637,October 1,2011,Ethiopia,Sudan,1,2,Friendly,in Ethiopia,-10,10,1303,1420,-1,2,131,105,1313,1410,T2
1638,October 2,2011,Antigua and Barbuda,Martinique,1,2,Friendly,in Antigua and Barbuda,-12,12,1283,1343,-4,5,138,120,1295,1331,T2
1639,October 2,2011,Hong Kong,Macao,5,1,Friendly tournament,in Taiwan,3,-3,1180,665,0,0,160,220,1177,668,T1
1640,October 2,2011,Taiwan,Philippines,0,0,Friendly tournament,in Taiwan,0,0,923,1016,0,0,196,184,923,1016,draw
1641,October 4,2011,Ethiopia,Malawi,0,0,Friendly,in Ethiopia,1,-1,1304,1422,0,0,131,104,1303,1423,draw
1642,October 4,2011,Philippines,Macao,2,0,Friendly tournament,in Taiwan,5,-5,1021,660,0,0,184,220,1016,665,T1
1643,October 4,2011,Taiwan,Hong Kong,0,6,Friendly tournament,in Taiwan,-18,18,905,1198,-1,1,197,159,923,1180,T2
1644,October 5,2011,Iran,Palestine,7,0,Friendly,in Iran,1,-1,1734,1170,0,0,34,162,1733,1171,T1
1645,October 6,2011,China,United Arab Emirates,2,1,Friendly,in China,3,-3,1646,1406,1,0,51,109,1643,1409,T1
1646,October 6,2011,Thailand,Jordan,0,0,Friendly,in Thailand,1,-1,1430,1566,0,-1,102,67,1429,1567,draw
1647,October 7,2011,Andorra,Ireland,0,2,European Championship qualifier,in Andorra,-1,1,998,1796,0,1,187,19,999,1795,T2
1648,October 7,2011,Argentina,Chile,4,1,World Cup qualifier,in Argentina,23,-23,1941,1868,1,0,6,10,1918,1891,T1
1649,October 7,2011,Armenia,Macedonia,4,1,European Championship qualifier,in Armenia,28,-28,1535,1508,9,-9,77,85,1507,1536,T1
1650,October 7,2011,Australia,Malaysia,5,0,Friendly,in Australia,1,-1,1840,1214,-1,0,15,152,1839,1215,T1
1651,October 7,2011,Azerbaijan,Austria,1,4,European Championship qualifier,in Azerbaijan,-32,32,1394,1590,-7,9,110,62,1426,1558,T2
1652,October 7,2011,Barbados,Guyana,0,2,World Cup qualifier,in Barbados,-27,27,1187,1375,-7,2,160,116,1214,1348,T2
1653,October 7,2011,Belgium,Kazakhstan,4,1,European Championship qualifier,in Belgium,5,-5,1672,1333,0,-1,45,125,1667,1338,T1
1654,October 7,2011,Belize,Grenada,1,4,World Cup qualifier,in Belize,-42,42,1087,1205,-3,11,175,154,1129,1163,T2
1655,October 7,2011,Bermuda,Trinidad and Tobago,2,1,World Cup qualifier,in Bermuda,33,-33,1177,1484,6,-12,162,93,1144,1517,T1
1656,October 7,2011,Bosnia and Herzegovina,Luxembourg,5,0,European Championship qualifier,in Bosnia and Herzegovina,2,-2,1688,1152,-1,-1,43,168,1686,1154,T1
1657,October 7,2011,Cayman Islands,Suriname,0,1,World Cup qualifier,in the Cayman Islands,-9,9,944,1270,-1,0,193,140,953,1261,T2
1658,October 7,2011,Costa Rica,Brazil,0,1,Friendly,in Costa Rica,-3,3,1647,2049,-2,0,51,4,1650,2046,T2
1659,October 7,2011,Curaçao,Antigua and Barbuda,0,1,World Cup qualifier,in Curaçao,-14,14,1069,1297,-2,4,178,134,1083,1283,T2
1660,October 7,2011,Cyprus,Denmark,1,4,European Championship qualifier,in Cyprus,-18,18,1477,1794,-4,3,94,21,1495,1776,T2
1661,October 7,2011,Czechia,Spain,0,2,European Championship qualifier,in Czechia,-10,10,1737,2135,-2,0,33,1,1747,2125,T2
1662,October 7,2011,Dominica,Panama,0,5,World Cup qualifier,in Dominica,-4,4,1033,1656,0,0,181,48,1037,1652,T2
1663,October 7,2011,Dominican Republic,El Salvador,1,2,World Cup qualifier,in the Dominican Republic,-4,4,1072,1570,1,-1,176,68,1076,1566,T2
1664,October 7,2011,Democratic Republic of Congo,Cameroon,2,3,African Nations Cup qualifier,in the Democratic Republic of the Congo,-13,13,1397,1653,-1,4,109,49,1410,1640,T2
1665,October 7,2011,Ecuador,Venezuela,2,0,World Cup qualifier,in Ecuador,20,-20,1756,1694,3,-3,30,40,1736,1714,T1
1666,October 7,2011,Finland,Sweden,1,2,European Championship qualifier,in Finland,-13,13,1596,1851,-4,1,61,14,1609,1838,T2
1667,October 7,2011,France,Albania,3,0,European Championship qualifier,in France,5,-5,1854,1488,0,2,13,90,1849,1493,T1
1668,October 7,2011,Gabon,Equatorial Guinea,2,0,Friendly,in France,4,-4,1563,1218,-1,0,71,150,1559,1222,T1
1669,October 7,2011,Greece,Croatia,2,0,European Championship qualifier,in Greece,33,-33,1799,1865,9,-3,18,12,1766,1898,T1
1670,October 7,2011,Indonesia,Saudi Arabia,0,0,Friendly,in Malaysia,6,-6,1301,1551,1,0,133,72,1295,1557,draw
1671,October 7,2011,Japan,Vietnam,1,0,Friendly,in Japan,0,0,1829,1275,0,0,16,139,1829,1275,T1
1672,October 7,2011,Latvia,Malta,2,0,European Championship qualifier,in Latvia,6,-6,1525,1220,0,-1,80,149,1519,1226,T1
1673,October 7,2011,Montenegro,England,2,2,European Championship qualifier,in Montenegro,9,-9,1691,1937,1,-1,42,7,1682,1946,draw
1674,October 7,2011,Netherlands,Moldova,1,0,European Championship qualifier,in the Netherlands,0,0,2118,1414,0,1,2,105,2118,1414,T1
1675,October 7,2011,Northern Ireland,Estonia,1,2,European Championship qualifier,in Northern Ireland,-24,24,1461,1537,-4,7,98,75,1485,1513,T2
1676,October 7,2011,Peru,Paraguay,2,0,World Cup qualifier,in Peru,25,-25,1792,1788,4,-6,22,23,1767,1813,T1
1677,October 7,2011,Portugal,Iceland,5,3,European Championship qualifier,in Portugal,2,-2,1915,1442,0,-1,8,101,1913,1444,T1
1678,October 7,2011,Puerto Rico,Saint Kitts and Nevis,1,1,World Cup qualifier,in Puerto Rico,5,-5,1014,1197,1,-2,185,158,1009,1202,draw
1679,October 7,2011,Romania,Belarus,2,2,European Championship qualifier,in Romania,-11,11,1701,1604,1,2,37,58,1712,1593,draw
1680,October 7,2011,Serbia,Italy,1,1,European Championship qualifier,in Serbia,1,-1,1764,1881,1,2,28,9,1763,1882,draw
1681,October 7,2011,Singapore,Philippines,2,0,Friendly,in Singapore,3,-3,1319,1018,0,1,129,183,1316,1021,T1
1682,October 7,2011,Slovakia,Russia,0,1,European Championship qualifier,in Slovakia,-14,14,1578,1814,-5,2,66,17,1592,1800,T2
1683,October 7,2011,South Korea,Poland,2,2,Friendly,in South Korea,-5,5,1796,1701,-1,2,19,37,1801,1696,draw
1684,October 7,2011,Saint Lucia,Canada,0,7,World Cup qualifier,in Saint Lucia,-5,5,1017,1625,-1,0,184,56,1022,1620,T2
1685,October 7,2011,Saint Vincent and the Grenadines,Guatemala,0,3,World Cup qualifier,in Saint Vincent and the Grenadines,-19,19,1181,1487,-4,3,161,92,1200,1468,T2
1686,October 7,2011,Turkey,Germany,1,3,European Championship qualifier,in Turkey,-16,16,1765,2072,-4,0,26,3,1781,2056,T2
1687,October 7,2011,Ukraine,Bulgaria,3,0,Friendly,in Ukraine,10,-10,1748,1657,1,-2,31,47,1738,1667,T1
1688,October 7,2011,Uruguay,Bolivia,4,2,World Cup qualifier,in Uruguay,3,-3,1966,1536,0,-1,5,76,1963,1539,T1
1689,October 7,2011,US Virgin Islands,Haiti,0,7,World Cup qualifier,in the US Virgin Islands,-3,3,727,1447,-1,0,212,100,730,1444,T2
1690,October 7,2011,Wales,Switzerland,2,0,European Championship qualifier,in Wales,40,-40,1601,1741,9,-10,60,32,1561,1781,T1
1691,October 8,2011,Cape Verde,Zimbabwe,2,1,African Nations Cup qualifier,in Cape Verde,14,-14,1398,1371,4,-5,109,117,1384,1385,T1
1692,October 8,2011,Chad,Malawi,2,2,African Nations Cup qualifier,in Chad,7,-7,1206,1415,3,0,153,103,1199,1422,draw
1693,October 8,2011,Egypt,Niger,3,0,African Nations Cup qualifier,in Egypt,4,-4,1724,1332,0,-2,35,126,1720,1336,T1
1694,October 8,2011,Ethiopia,Madagascar,4,2,African Nations Cup qualifier,in Ethiopia,15,-15,1319,1201,2,-5,129,156,1304,1216,T1
1695,October 8,2011,Gambia,Burkina Faso,1,1,African Nations Cup qualifier,in The Gambia,3,-3,1377,1519,3,-1,114,82,1374,1522,draw
1696,October 8,2011,Guinea-Bissau,Angola,0,2,African Nations Cup qualifier,in Guinea-Bissau,-21,21,1235,1484,-6,3,147,93,1256,1463,T2
1697,October 8,2011,Liberia,Mali,2,2,African Nations Cup qualifier,in Liberia,9,-9,1251,1500,5,-2,141,86,1242,1509,draw
1698,October 8,2011,Liechtenstein,Scotland,0,1,European Championship qualifier,in Liechtenstein,-5,5,1237,1700,0,0,146,39,1242,1695,T2
1699,October 8,2011,Mozambique,Comoros,3,0,African Nations Cup qualifier,in Mozambique,3,-3,1344,875,2,0,120,203,1341,878,T1
1700,October 8,2011,Nigeria,Guinea,2,2,African Nations Cup qualifier,in Nigeria,-13,13,1664,1524,-1,2,45,81,1677,1511,draw
1701,October 8,2011,South Africa,Sierra Leone,0,0,African Nations Cup qualifier,in South Africa,-16,16,1612,1342,-1,5,56,123,1628,1326,draw
1702,October 8,2011,Sudan,Ghana,0,2,African Nations Cup qualifier,in Sudan,-12,12,1408,1773,-2,4,106,25,1420,1761,T2
1703,October 8,2011,Swaziland,Congo,0,1,African Nations Cup qualifier,in Swaziland,-14,14,1127,1356,-1,3,172,118,1141,1342,T2
1704,October 8,2011,Tunisia,Togo,2,0,African Nations Cup qualifier,in Tunisia,9,-9,1591,1375,2,-2,62,115,1582,1384,T1
1705,October 8,2011,Uganda,Kenya,0,0,African Nations Cup qualifier,in Uganda,-15,15,1527,1299,-6,4,79,134,1542,1284,draw
1706,October 8,2011,United States,Honduras,1,0,Friendly,in the United States,5,-5,1720,1630,0,0,36,54,1715,1635,T1
1707,October 8,2011,Zambia,Libya,0,0,African Nations Cup qualifier,in Zambia,-7,7,1528,1509,0,2,77,84,1535,1502,draw
1708,October 9,2011,Algeria,Central African Republic,2,0,African Nations Cup qualifier,in Algeria,8,-8,1470,1237,1,-1,96,145,1462,1245,T1
1709,October 9,2011,Benin,Rwanda,0,1,African Nations Cup qualifier,in Benin,-30,30,1381,1358,-7,10,112,118,1411,1328,T2
1710,October 9,2011,Ivory Coast,Burundi,2,1,African Nations Cup qualifier,in Ivory Coast,1,-1,1766,1242,0,1,27,144,1765,1243,T1
1711,October 9,2011,Mauritius,Senegal,0,2,African Nations Cup qualifier,in Mauritius,-4,4,1022,1608,0,0,182,58,1026,1604,T2
1712,October 9,2011,Morocco,Tanzania,3,1,African Nations Cup qualifier,in Morocco,7,-7,1589,1334,1,-1,64,125,1582,1341,T1
1713,October 11,2011,Albania,Romania,1,1,European Championship qualifier,in Albania,6,-6,1494,1695,2,-4,88,41,1488,1701,draw
1714,October 11,2011,Antigua and Barbuda,US Virgin Islands,10,0,World Cup qualifier,in Antigua and Barbuda,2,-2,1299,725,3,-1,132,213,1297,727,T1
1715,October 11,2011,Australia,Oman,3,0,World Cup qualifier,in Australia,5,-5,1845,1507,1,-1,14,84,1840,1512,T1
1716,October 11,2011,Bermuda,Guyana,1,1,World Cup qualifier,in Bermuda,5,-5,1182,1370,2,-2,160,117,1177,1375,draw
1717,October 11,2011,Bolivia,Colombia,1,2,World Cup qualifier,in Bolivia,-12,12,1524,1798,-3,3,78,21,1536,1786,T2
1718,October 11,2011,Bulgaria,Wales,0,1,European Championship qualifier,in Bulgaria,-28,28,1629,1629,-6,7,53,53,1657,1601,T2
1719,October 11,2011,Canada,Puerto Rico,0,0,World Cup qualifier,in Canada,-19,19,1606,1033,-4,4,59,181,1625,1014,draw
1720,October 11,2011,Chile,Peru,4,2,World Cup qualifier,in Chile,16,-16,1884,1776,1,-2,9,24,1868,1792,T1
1721,October 11,2011,China,Iraq,0,1,World Cup qualifier,in China,-31,31,1615,1572,-3,4,55,69,1646,1541,T2
1722,October 11,2011,Croatia,Latvia,2,0,European Championship qualifier,in Croatia,4,-4,1869,1521,0,0,12,80,1865,1525,T1
1723,October 11,2011,Denmark,Portugal,2,1,European Championship qualifier,in Denmark,21,-21,1815,1894,4,0,17,8,1794,1915,T1
1724,October 11,2011,El Salvador,Cayman Islands,4,0,World Cup qualifier,in El Salvador,1,-1,1571,943,-2,0,70,193,1570,944,T1
1725,October 11,2011,Equatorial Guinea,Cameroon,1,1,Friendly,in Equatorial Guinea,7,-7,1225,1646,3,-1,147,50,1218,1653,draw
1726,October 11,2011,Estonia,Ukraine,0,2,Friendly,in Estonia,-10,10,1527,1758,-2,-1,76,32,1537,1748,T2
1727,October 11,2011,France,Bosnia and Herzegovina,1,1,European Championship qualifier,in France,-13,13,1841,1701,-2,4,15,39,1854,1688,draw
1728,October 11,2011,Georgia,Greece,1,2,European Championship qualifier,in Georgia,-9,9,1487,1808,-3,-1,91,19,1496,1799,T2
1729,October 11,2011,Germany,Belgium,3,1,European Championship qualifier,in Germany,3,-3,2075,1669,0,0,3,44,2072,1672,T1
1730,October 11,2011,Ghana,Nigeria,0,0,Friendly,in England,-3,3,1770,1667,-1,-1,26,46,1773,1664,draw
1731,October 11,2011,Guatemala,Belize,3,1,World Cup qualifier,in Guatemala,3,-3,1490,1084,2,-2,90,177,1487,1087,T1
1732,October 11,2011,Haiti,Curaçao,2,2,World Cup qualifier,in Haiti,-18,18,1429,1087,-2,2,102,176,1447,1069,draw
1733,October 11,2011,Honduras,Jamaica,2,1,Friendly,in Honduras,8,-8,1638,1640,2,-1,52,51,1630,1648,T1
1734,October 11,2011,Hungary,Finland,0,0,European Championship qualifier,in Hungary,-10,10,1682,1606,-1,2,42,59,1692,1596,draw
1735,October 11,2011,Indonesia,Qatar,2,3,World Cup qualifier,in Indonesia,-15,15,1286,1509,-4,7,137,82,1301,1494,T2
1736,October 11,2011,Iran,Bahrain,6,0,World Cup qualifier,in Iran,10,-10,1744,1478,1,-4,33,94,1734,1488,T1
1737,October 11,2011,Ireland,Armenia,2,1,European Championship qualifier,in Ireland,4,-4,1800,1531,-1,2,20,74,1796,1535,T1
1738,October 11,2011,Italy,Northern Ireland,3,0,European Championship qualifier,in Italy,3,-3,1884,1458,0,0,9,98,1881,1461,T1
1739,October 11,2011,Japan,Tajikistan,8,0,World Cup qualifier,in Japan,2,-2,1831,1246,0,1,16,142,1829,1248,T1
1740,October 11,2011,Kazakhstan,Austria,0,0,European Championship qualifier,in Kazakhstan,8,-8,1341,1582,1,-3,125,66,1333,1590,draw
1741,October 11,2011,Lebanon,Kuwait,2,2,World Cup qualifier,in Lebanon,14,-14,1225,1595,5,-4,147,61,1211,1609,draw
1742,October 11,2011,Lithuania,Czechia,1,4,European Championship qualifier,in Lithuania,-24,24,1504,1761,-9,3,86,30,1528,1737,T2
1743,October 11,2011,Macedonia,Slovakia,1,1,European Championship qualifier,in Macedonia,-2,2,1506,1580,0,-1,85,67,1508,1578,draw
1744,October 11,2011,Malta,Israel,0,2,European Championship qualifier,in Malta,-7,7,1213,1669,-3,2,152,44,1220,1662,T2
1745,October 11,2011,Mexico,Brazil,1,2,Friendly,in Mexico,-8,8,1859,2057,-2,0,13,4,1867,2049,T2
1746,October 11,2011,Moldova,San Marino,4,0,European Championship qualifier,in Moldova,2,-2,1416,895,1,0,103,198,1414,897,T1
1747,October 11,2011,North Korea,Uzbekistan,0,1,World Cup qualifier,in North Korea,-21,21,1479,1609,-7,8,93,57,1500,1588,T2
1748,October 11,2011,Norway,Cyprus,3,1,European Championship qualifier,in Norway,6,-6,1775,1471,1,0,25,95,1769,1477,T1
1749,October 11,2011,Panama,Nicaragua,5,1,World Cup qualifier,in Panama,2,-2,1658,1106,0,-1,48,174,1656,1108,T1
1750,October 11,2011,Paraguay,Uruguay,1,1,World Cup qualifier,in Paraguay,4,-4,1792,1962,0,0,23,5,1788,1966,draw
1751,October 11,2011,Philippines,Nepal,4,0,Friendly,in the Philippines,12,-12,1030,969,0,-1,183,190,1018,981,T1
1752,October 11,2011,Poland,Belarus,2,0,Friendly,in Germany,11,-11,1712,1593,0,-3,37,62,1701,1604,T1
1753,October 11,2011,Russia,Andorra,6,0,European Championship qualifier,in Russia,0,0,1814,998,-1,0,18,187,1814,998,T1
1754,October 11,2011,Singapore,Jordan,0,3,World Cup qualifier,in Singapore,-21,21,1298,1587,-5,5,134,65,1319,1566,T2
1755,October 11,2011,Slovenia,Serbia,1,0,European Championship qualifier,in Slovenia,21,-21,1665,1743,6,-5,47,34,1644,1764,T1
1756,October 11,2011,South Korea,United Arab Emirates,2,1,World Cup qualifier,in South Korea,2,-2,1798,1404,-2,0,21,106,1796,1406,T1
1757,October 11,2011,Spain,Scotland,3,1,European Championship qualifier,in Spain,3,-3,2138,1697,0,-1,1,40,2135,1700,T1
1758,October 11,2011,Saint Kitts and Nevis,Saint Lucia,1,1,World Cup qualifier,in Saint Kitts and Nevis,-13,13,1184,1030,-1,1,159,183,1197,1017,draw
1759,October 11,2011,Suriname,Dominican Republic,1,3,World Cup qualifier,in Suriname,-51,51,1219,1123,-10,3,150,173,1270,1072,T2
1760,October 11,2011,Sweden,Netherlands,3,2,European Championship qualifier,in Sweden,29,-29,1880,2089,3,0,11,2,1851,2118,T1
1761,October 11,2011,Switzerland,Montenegro,2,0,European Championship qualifier,in Switzerland,18,-18,1759,1673,1,-1,31,43,1741,1691,T1
1762,October 11,2011,Thailand,Saudi Arabia,0,0,World Cup qualifier,in Thailand,1,-1,1431,1550,1,-1,101,73,1430,1551,draw
1763,October 11,2011,Trinidad and Tobago,Barbados,4,0,World Cup qualifier,in Trinidad and Tobago,7,-7,1491,1180,4,-2,89,162,1484,1187,T1
1764,October 11,2011,Turkey,Azerbaijan,1,0,European Championship qualifier,in Turkey,2,-2,1767,1392,0,0,28,110,1765,1394,T1
1765,October 11,2011,United States,Ecuador,0,1,Friendly,in the United States,-12,12,1708,1768,-2,3,38,27,1720,1756,T2
1766,October 11,2011,Venezuela,Argentina,1,0,World Cup qualifier,in Venezuela,28,-28,1722,1913,4,-1,36,7,1694,1941,T1
1767,October 15,2011,Grenada,Saint Vincent and the Grenadines,1,1,World Cup qualifier,in Grenada,-7,7,1198,1188,-2,2,156,159,1205,1181,draw
1768,October 31,2011,Namibia,Lesotho,0,0,Friendly,in Namibia,-6,6,1288,1168,0,2,136,165,1294,1162,draw
1769,November 1,2011,Djibouti,Somalia,1,0,Friendly,in Djibouti,10,-10,803,898,0,-1,207,197,793,908,T1
1770,November 4,2011,Kuwait,Bahrain,0,1,Friendly,in Kuwait,-16,16,1579,1494,-6,6,67,88,1595,1478,T2
1771,November 4,2011,Qatar,Oman,0,0,Friendly,in Qatar,-3,3,1506,1510,-2,2,84,82,1509,1507,draw
1772,November 5,2011,Antigua and Barbuda,Guadeloupe,0,0,Friendly,in Antigua and Barbuda,2,-2,1301,1465,0,0,132,97,1299,1467,draw
1773,November 6,2011,Democratic Republic of Congo,Lesotho,3,0,Friendly,in South Africa,7,-7,1404,1161,3,-2,106,167,1397,1168,T1
1774,November 6,2011,Iraq,Lebanon,1,0,Friendly,in Qatar,2,-2,1574,1223,1,-1,68,148,1572,1225,T1
1775,November 8,2011,Lebanon,Thailand,3,1,Friendly,in Qatar,23,-23,1246,1408,6,-3,142,104,1223,1431,T1
1776,November 10,2011,Gabon,Brazil,0,2,Friendly,in Gabon,-3,3,1560,2060,0,0,72,4,1563,2057,T2
1777,November 11,2011,Albania,Azerbaijan,0,1,Friendly,in Albania,-15,15,1479,1407,-4,6,92,104,1494,1392,T2
1778,November 11,2011,Antigua and Barbuda,Haiti,1,0,World Cup qualifier,in Antigua and Barbuda,22,-22,1323,1407,3,-3,129,104,1301,1429,T1
1779,November 11,2011,Argentina,Bolivia,1,1,World Cup qualifier,in Argentina,-18,18,1895,1542,-2,4,9,74,1913,1524,draw
1780,November 11,2011,Bahrain,Iran,1,1,World Cup qualifier,in Bahrain,8,-8,1502,1736,1,1,87,32,1494,1744,draw
1781,November 11,2011,Belgium,Romania,2,1,Friendly,in Belgium,8,-8,1677,1687,1,0,43,41,1669,1695,T1
1782,November 11,2011,Belize,Saint Vincent and the Grenadines,1,1,World Cup qualifier,in Belize,0,0,1084,1188,0,0,177,159,1084,1188,draw
1783,November 11,2011,Bermuda,Barbados,2,1,World Cup qualifier,in Bermuda,14,-14,1196,1166,5,-4,156,166,1182,1180,T1
1784,November 11,2011,Bosnia and Herzegovina,Portugal,0,0,European Championship qualifier,in Bosnia and Herzegovina,5,-5,1706,1889,2,-2,37,10,1701,1894,draw
1785,November 11,2011,Burkina Faso,Mali,1,1,Friendly,in France,-1,1,1518,1501,1,-1,80,88,1519,1500,draw
1786,November 11,2011,Cameroon,Sudan,3,1,Friendly tournament,in Morocco,9,-9,1655,1399,1,-3,49,107,1646,1408,T1
1787,November 11,2011,Chad,Tanzania,1,2,World Cup qualifier,in Chad,-18,18,1188,1352,-6,5,159,121,1206,1334,T2
1788,November 11,2011,Colombia,Venezuela,1,1,World Cup qualifier,in Colombia,-9,9,1789,1731,-2,1,23,35,1798,1722,draw
1789,November 11,2011,Comoros,Mozambique,0,1,World Cup qualifier,in the Comoros,-4,4,871,1348,0,-1,203,122,875,1344,T2
1790,November 11,2011,Cyprus,Scotland,1,2,Friendly,in Cyprus,-7,7,1464,1704,-2,2,97,38,1471,1697,T2
1791,November 11,2011,Czechia,Montenegro,2,0,European Championship qualifier,in Czechia,15,-15,1776,1658,6,-5,24,48,1761,1673,T1
1792,November 11,2011,Denmark,Sweden,2,0,Friendly,in Denmark,13,-13,1828,1867,1,0,16,11,1815,1880,T1
1793,November 11,2011,Djibouti,Namibia,0,4,World Cup qualifier,in Djibouti,-7,7,796,1295,0,1,207,135,803,1288,T2
1794,November 11,2011,Dominican Republic,Cayman Islands,4,0,World Cup qualifier,in the Dominican Republic,12,-12,1135,931,2,-1,171,194,1123,943,T1
1795,November 11,2011,Equatorial Guinea,Madagascar,2,0,World Cup qualifier,in Equatorial Guinea,20,-20,1245,1181,5,-6,143,161,1225,1201,T1
1796,November 11,2011,Eritrea,Rwanda,1,1,World Cup qualifier,in Eritrea,5,-5,1170,1353,1,-2,164,120,1165,1358,draw
1797,November 11,2011,Estonia,Ireland,0,4,European Championship qualifier,in Estonia,-20,20,1507,1820,-8,3,84,17,1527,1800,T2
1798,November 11,2011,France,United States,1,0,Friendly,in France,4,-4,1845,1704,1,0,14,38,1841,1708,T1
1799,November 11,2011,Georgia,Moldova,2,0,Friendly,in Georgia,8,-8,1495,1408,2,-1,90,103,1487,1416,T1
1800,November 11,2011,Greece,Russia,1,1,Friendly,in Greece,-3,3,1805,1817,-2,0,21,18,1808,1814,draw
1801,November 11,2011,Guatemala,Grenada,3,0,World Cup qualifier,in Guatemala,7,-7,1497,1191,2,-2,89,158,1490,1198,T1
1802,November 11,2011,Guinea-Bissau,Togo,1,1,World Cup qualifier,in Guinea-Bissau,2,-2,1237,1373,2,-2,145,117,1235,1375,draw
1803,November 11,2011,Guyana,Trinidad and Tobago,2,1,World Cup qualifier,in Guyana,21,-21,1391,1470,5,-4,112,94,1370,1491,T1
1804,November 11,2011,Hungary,Liechtenstein,5,0,Friendly,in Hungary,2,-2,1684,1235,0,-2,42,147,1682,1237,T1
1805,November 11,2011,Iraq,China,1,0,World Cup qualifier,in Qatar,22,-22,1596,1593,9,-5,59,60,1574,1615,T1
1806,November 11,2011,Jordan,Singapore,2,0,World Cup qualifier,in Jordan,6,-6,1593,1292,4,-2,60,136,1587,1298,T1
1807,November 11,2011,Kuwait,Lebanon,0,1,World Cup qualifier,in Kuwait,-37,37,1542,1283,-7,4,74,138,1579,1246,T2
1808,November 11,2011,Lesotho,Burundi,1,0,World Cup qualifier,in Lesotho,19,-19,1180,1223,5,-4,162,148,1161,1242,T1
1809,November 11,2011,Mexico,Serbia,2,0,Friendly,in Mexico,7,-7,1866,1736,1,2,12,32,1859,1743,T1
1810,November 11,2011,Morocco,Uganda,0,1,Friendly tournament,in Morocco,-22,22,1567,1549,-6,3,69,73,1589,1527,T2
1811,November 11,2011,Netherlands,Switzerland,0,0,Friendly,in the Netherlands,-8,8,2081,1767,0,3,2,28,2089,1759,draw
1812,November 11,2011,Nicaragua,Dominica,1,0,World Cup qualifier,in Nicaragua,11,-11,1117,1022,1,-2,173,183,1106,1033,T1
1813,November 11,2011,Oman,Australia,1,0,World Cup qualifier,in Oman,32,-32,1542,1813,8,-5,74,19,1510,1845,T1
1814,November 11,2011,Panama,Costa Rica,2,0,Friendly,in Panama,10,-10,1668,1637,3,-3,45,52,1658,1647,T1
1815,November 11,2011,Paraguay,Ecuador,2,1,World Cup qualifier,in Paraguay,13,-13,1805,1755,2,-4,21,31,1792,1768,T1
1816,November 11,2011,Poland,Italy,0,2,Friendly,in Poland,-12,12,1700,1896,-3,1,40,8,1712,1884,T2
1817,November 11,2011,Puerto Rico,Saint Lucia,4,0,World Cup qualifier,in Puerto Rico,27,-27,1060,1003,3,-3,178,186,1033,1030,T1
1818,November 11,2011,Qatar,Indonesia,4,0,World Cup qualifier,in Qatar,10,-10,1516,1276,3,-2,81,139,1506,1286,T1
1819,November 11,2011,São Tomé and Príncipe,Congo,0,5,World Cup qualifier,in São Tomé and Príncipe,-19,19,1037,1375,-1,3,181,116,1056,1356,T2
1820,November 11,2011,Saudi Arabia,Thailand,3,0,World Cup qualifier,in Saudi Arabia,14,-14,1564,1394,2,-6,71,110,1550,1408,T1
1821,November 11,2011,Senegal,Guinea,4,1,Friendly,in France,13,-13,1621,1511,3,-4,55,82,1608,1524,T1
1822,November 11,2011,Seychelles,Kenya,0,3,World Cup qualifier,in the Seychelles,-23,23,1047,1322,-2,3,180,130,1070,1299,T2
1823,November 11,2011,Saint Kitts and Nevis,Canada,0,0,World Cup qualifier,in Saint Kitts and Nevis,15,-15,1199,1591,6,-4,154,63,1184,1606,draw
1824,November 11,2011,Suriname,El Salvador,1,3,World Cup qualifier,in Suriname,-11,11,1208,1582,-2,5,152,65,1219,1571,T2
1825,November 11,2011,Swaziland,Democratic Republic of Congo,1,3,World Cup qualifier,in Swaziland,-16,16,1111,1420,-2,5,174,101,1127,1404,T2
1826,November 11,2011,Tajikistan,Japan,0,4,World Cup qualifier,in Tajikistan,-4,4,1242,1835,-2,1,144,15,1246,1831,T2
1827,November 11,2011,Turkey,Croatia,0,3,European Championship qualifier,in Turkey,-35,35,1732,1904,-6,5,34,7,1767,1869,T2
1828,November 11,2011,United Arab Emirates,South Korea,0,2,World Cup qualifier,in the United Arab Emirates,-9,9,1395,1807,-3,1,109,20,1404,1798,T2
1829,November 11,2011,Ukraine,Germany,3,3,Friendly,in Ukraine,6,-6,1764,2069,2,0,30,3,1758,2075,draw
1830,November 11,2011,Uruguay,Chile,4,0,World Cup qualifier,in Uruguay,20,-20,1982,1864,0,-4,5,13,1962,1884,T1
1831,November 11,2011,US Virgin Islands,Curaçao,0,3,World Cup qualifier,in the US Virgin Islands,-13,13,712,1100,0,1,213,175,725,1087,T2
1832,November 11,2011,Uzbekistan,North Korea,1,0,World Cup qualifier,in Uzbekistan,8,-8,1617,1471,1,1,56,93,1609,1479,T1
1833,November 12,2011,Algeria,Tunisia,1,0,Friendly,in Algeria,11,-11,1481,1580,2,-3,92,66,1470,1591,T1
1834,November 12,2011,England,Spain,1,0,Friendly,in England,13,-13,1950,2125,0,0,6,1,1937,2138,T1
1835,November 12,2011,Ethiopia,Somalia,0,0,World Cup qualifier,in Djibouti,-17,17,1302,915,-1,1,132,196,1319,898,draw
1836,November 12,2011,Nigeria,Botswana,0,0,Friendly,in Nigeria,-8,8,1659,1409,-1,3,47,103,1667,1401,draw
1837,November 12,2011,South Africa,Ivory Coast,1,1,Friendly,in South Africa,2,-2,1614,1764,0,1,57,28,1612,1766,draw
1838,November 12,2011,Wales,Norway,4,1,Friendly,in Wales,20,-20,1649,1755,3,-4,50,30,1629,1775,T1
1839,November 13,2011,India,Malaysia,1,1,Friendly,in India,-3,3,1202,1217,0,0,153,150,1205,1214,draw
1840,November 13,2011,Morocco,Cameroon,1,1,Friendly tournament,in Morocco,-1,1,1566,1656,-1,0,70,49,1567,1655,draw
1841,November 13,2011,Sudan,Uganda,0,0,Friendly tournament,in Morocco,6,-6,1405,1543,0,0,107,73,1399,1549,draw
1842,November 14,2011,Bermuda,Barbados,2,1,World Cup qualifier,in Bermuda,13,-13,1209,1153,4,-1,152,167,1196,1166,T1
1843,November 14,2011,Brazil,Egypt,2,0,Friendly,in Qatar,4,-4,2064,1720,0,0,4,36,2060,1724,T1
1844,November 14,2011,Cayman Islands,Dominican Republic,1,1,World Cup qualifier,in the Cayman Islands,6,-6,937,1129,1,0,193,171,931,1135,draw
1845,November 14,2011,Honduras,Serbia,2,0,Friendly,in Honduras,15,-15,1653,1721,2,-3,50,35,1638,1736,T1
1846,November 14,2011,Puerto Rico,Saint Lucia,3,0,World Cup qualifier,in Puerto Rico,20,-20,1080,983,0,-2,178,188,1060,1003,T1
1847,November 15,2011,Belarus,Libya,1,1,Friendly,in the United Arab Emirates,-2,2,1591,1511,-2,0,62,83,1593,1509,draw
1848,November 15,2011,Burkina Faso,Guinea,1,1,Friendly,in France,0,0,1518,1511,-1,-1,81,83,1518,1511,draw
1849,November 15,2011,Burundi,Lesotho,2,2,World Cup qualifier,in Burundi,-8,8,1215,1188,-3,2,151,160,1223,1180,draw
1850,November 15,2011,Canada,Saint Kitts and Nevis,4,0,World Cup qualifier,in Canada,4,-4,1595,1195,2,-3,61,158,1591,1199,T1
1851,November 15,2011,Chile,Paraguay,2,0,World Cup qualifier,in Chile,17,-17,1881,1788,2,0,11,21,1864,1805,T1
1852,November 15,2011,Colombia,Argentina,1,2,World Cup qualifier,in Colombia,-20,20,1769,1915,-3,2,26,7,1789,1895,T2
1853,November 15,2011,Congo,São Tomé and Príncipe,1,1,World Cup qualifier,in Congo,-17,17,1358,1054,-3,1,119,180,1375,1037,draw
1854,November 15,2011,Costa Rica,Spain,2,2,Friendly,in Costa Rica,8,-8,1645,2117,2,0,51,1,1637,2125,draw
1855,November 15,2011,Croatia,Turkey,0,0,European Championship qualifier,in Croatia,-13,13,1891,1745,-2,1,9,32,1904,1732,draw
1856,November 15,2011,Curaçao,US Virgin Islands,6,1,World Cup qualifier,in Curaçao,5,-5,1105,707,0,0,175,213,1100,712,T1
1857,November 15,2011,Denmark,Finland,2,1,Friendly,in Denmark,3,-3,1831,1603,1,-1,15,59,1828,1606,T1
1858,November 15,2011,Democratic Republic of Congo,Swaziland,5,1,World Cup qualifier,in the Democratic Republic of the Congo,7,-7,1427,1104,0,-2,101,176,1420,1111,T1
1859,November 15,2011,Ecuador,Peru,2,0,World Cup qualifier,in Ecuador,23,-23,1778,1753,7,-7,23,31,1755,1776,T1
1860,November 15,2011,El Salvador,Suriname,4,0,World Cup qualifier,in El Salvador,5,-5,1587,1203,1,-1,63,154,1582,1208,T1
1861,November 15,2011,England,Sweden,1,0,Friendly,in England,5,-5,1955,1862,0,-2,6,13,1950,1867,T1
1862,November 15,2011,France,Belgium,0,0,Friendly,in France,-6,6,1839,1683,0,1,14,42,1845,1677,draw
1863,November 15,2011,Germany,Netherlands,3,0,Friendly,in Germany,13,-13,2082,2068,1,-1,2,3,2069,2081,T1
1864,November 15,2011,Ghana,Gabon,2,1,Friendly,in France,5,-5,1775,1555,2,1,24,71,1770,1560,T1
1865,November 15,2011,Grenada,Guatemala,1,4,World Cup qualifier,in Grenada,-16,16,1175,1513,-3,7,161,82,1191,1497,T2
1866,November 15,2011,Haiti,Antigua and Barbuda,2,1,World Cup qualifier,in Haiti,10,-10,1417,1313,3,-2,102,131,1407,1323,T1
1867,November 15,2011,Indonesia,Iran,1,4,World Cup qualifier,in Indonesia,-8,8,1268,1744,-1,-1,140,33,1276,1736,T2
1868,November 15,2011,Ireland,Estonia,1,1,European Championship qualifier,in Ireland,-17,17,1803,1524,-1,6,18,78,1820,1507,draw
1869,November 15,2011,Italy,Uruguay,0,1,Friendly,in Italy,-10,10,1886,1992,-2,0,10,5,1896,1982,T2
1870,November 15,2011,Jordan,Iraq,1,3,World Cup qualifier,in Jordan,-38,38,1555,1634,-11,5,71,54,1593,1596,T2
1871,November 15,2011,Kenya,Seychelles,4,0,World Cup qualifier,in Kenya,8,-8,1330,1039,2,-1,128,181,1322,1047,T1
1872,November 15,2011,Kuwait,United Arab Emirates,2,1,World Cup qualifier,in Kuwait,8,-8,1550,1387,1,-2,73,111,1542,1395,T1
1873,November 15,2011,Lebanon,South Korea,2,1,World Cup qualifier,in Lebanon,37,-37,1320,1770,9,-5,129,25,1283,1807,T1
1874,November 15,2011,Luxembourg,Switzerland,0,1,Friendly,in Luxembourg,-1,1,1151,1768,1,0,167,27,1152,1767,T2
1875,November 15,2011,Macedonia,Albania,0,0,Friendly,in Macedonia,-4,4,1502,1483,-4,-1,89,94,1506,1479,draw
1876,November 15,2011,Madagascar,Equatorial Guinea,2,1,World Cup qualifier,in Madagascar,18,-18,1199,1227,5,-4,156,147,1181,1245,T1
1877,November 15,2011,Montenegro,Czechia,0,1,European Championship qualifier,in Montenegro,-19,19,1639,1795,-5,4,53,20,1658,1776,T2
1878,November 15,2011,Mozambique,Comoros,4,1,World Cup qualifier,in Mozambique,2,-2,1350,869,1,0,121,203,1348,871,T1
1879,November 15,2011,Namibia,Djibouti,4,0,World Cup qualifier,in Namibia,2,-2,1297,794,0,0,135,207,1295,796,T1
1880,November 15,2011,Niger,Botswana,1,1,Friendly,in Niger,-1,1,1331,1410,1,-1,126,104,1332,1409,draw
1881,November 15,2011,Nigeria,Zambia,2,0,Friendly,in Nigeria,6,-6,1665,1522,1,-1,46,79,1659,1528,T1
1882,November 15,2011,North Korea,Japan,1,0,World Cup qualifier,in North Korea,33,-33,1504,1802,7,-4,87,19,1471,1835,T1
1883,November 15,2011,Panama,Dominica,3,0,World Cup qualifier,in Panama,1,-1,1669,1021,1,-1,44,184,1668,1022,T1
1884,November 15,2011,Poland,Hungary,2,1,Friendly,in Poland,7,-7,1707,1677,2,-1,38,43,1700,1684,T1
1885,November 15,2011,Portugal,Bosnia and Herzegovina,6,2,European Championship qualifier,in Portugal,12,-12,1901,1694,2,-4,8,41,1889,1706,T1
1886,November 15,2011,Qatar,Bahrain,0,0,World Cup qualifier,in Qatar,-6,6,1510,1508,-4,1,85,86,1516,1502,draw
1887,November 15,2011,Romania,Greece,3,1,Friendly,in Austria,20,-20,1707,1785,3,-1,38,22,1687,1805,T1
1888,November 15,2011,Rwanda,Eritrea,3,1,World Cup qualifier,in Rwanda,10,-10,1363,1160,2,-1,118,165,1353,1170,T1
1889,November 15,2011,Saudi Arabia,Oman,0,0,World Cup qualifier,in Saudi Arabia,-7,7,1557,1549,1,0,70,74,1564,1542,draw
1890,November 15,2011,Singapore,China,0,4,World Cup qualifier,in Singapore,-18,18,1274,1611,-3,2,139,58,1292,1593,T2
1891,November 15,2011,Slovenia,United States,2,3,Friendly,in Slovenia,-12,12,1653,1716,-2,1,48,37,1665,1704,T2
1892,November 15,2011,Saint Vincent and the Grenadines,Belize,0,2,World Cup qualifier,in Saint Vincent and the Grenadines,-46,46,1142,1130,-11,6,170,171,1188,1084,T2
1893,November 15,2011,Tanzania,Chad,0,1,World Cup qualifier,in Tanzania,-33,33,1319,1221,-9,10,130,149,1352,1188,T2
1894,November 15,2011,Thailand,Australia,0,1,World Cup qualifier,in Thailand,-5,5,1389,1818,0,3,110,16,1394,1813,T2
1895,November 15,2011,Togo,Guinea-Bissau,1,0,World Cup qualifier,in Togo,8,-8,1381,1229,4,-1,113,146,1373,1237,T1
1896,November 15,2011,Trinidad and Tobago,Guyana,2,0,World Cup qualifier,in Trinidad and Tobago,16,-16,1486,1375,3,-5,92,117,1470,1391,T1
1897,November 15,2011,Ukraine,Austria,2,1,Friendly,in Ukraine,3,-3,1767,1579,0,-2,28,66,1764,1582,T1
1898,November 15,2011,Uzbekistan,Tajikistan,3,0,World Cup qualifier,in Uzbekistan,4,-4,1621,1238,0,1,56,143,1617,1242,T1
1899,November 15,2011,Venezuela,Bolivia,1,0,World Cup qualifier,in Venezuela,6,-6,1737,1536,0,-2,34,76,1731,1542,T1
1900,November 15,2011,Zimbabwe,South Africa,2,1,Friendly,in Zimbabwe,14,-14,1385,1600,6,-3,112,60,1371,1614,T1
1901,November 16,2011,Ethiopia,Somalia,5,0,World Cup qualifier,in Ethiopia,5,-5,1307,910,0,0,133,196,1302,915,T1
1902,November 16,2011,India,Malaysia,3,2,Friendly,in India,8,-8,1210,1209,3,-3,152,153,1202,1217,T1
1903,November 22,2011,Eastern Samoa,Tonga,2,1,World Cup and Oceania Cup qualifier,in Samoa,35,-35,371,655,0,-3,233,220,336,690,T1
1904,November 22,2011,Maldives,Seychelles,3,0,Friendly,in the Maldives,10,-10,1100,1029,0,-1,177,182,1090,1039,T1
1905,November 22,2011,Samoa,Cook Islands,3,2,World Cup and Oceania Cup qualifier,in Samoa,17,-17,701,712,5,-1,214,212,684,729,T1
1906,November 24,2011,Cook Islands,Eastern Samoa,1,1,World Cup and Oceania Cup qualifier,in Samoa,-15,15,697,386,-3,0,215,233,712,371,draw
1907,November 24,2011,Maldives,Seychelles,2,1,Friendly,in the Maldives,5,-5,1105,1024,2,0,175,182,1100,1029,T1
1908,November 24,2011,Samoa,Tonga,1,1,World Cup and Oceania Cup qualifier,in Samoa,-8,8,693,663,-3,1,217,219,701,655,draw
1909,November 25,2011,Burundi,Somalia,4,1,CECAFA Cup,in Tanzania,10,-10,1225,900,2,-1,148,197,1215,910,T1
1910,November 25,2011,Uganda,Zanzibar,2,1,CECAFA Cup,in Tanzania,10,-10,1553,1344,2,-1,73,121,1543,1354,T1
1911,November 26,2011,Tanzania,Rwanda,0,1,CECAFA Cup,in Tanzania,-23,23,1296,1386,-6,6,136,112,1319,1363,T2
1912,November 26,2011,Tonga,Cook Islands,2,1,World Cup and Oceania Cup qualifier,in Samoa,22,-22,685,675,1,-4,218,219,663,697,T1
1913,November 26,2011,Samoa,Eastern Samoa,1,0,World Cup and Oceania Cup qualifier,in Samoa,4,-4,697,382,2,0,215,233,693,386,T1
1914,November 27,2011,Burundi,Zanzibar,0,0,CECAFA Cup,in Tanzania,7,-7,1232,1337,2,-4,146,125,1225,1344,draw
1915,November 27,2011,Zimbabwe,Djibouti,2,0,CECAFA Cup,in Tanzania,2,-2,1387,792,2,0,111,207,1385,794,T1
1916,November 28,2011,Ethiopia,Sudan,1,1,CECAFA Cup,in Tanzania,5,-5,1312,1400,2,0,130,107,1307,1405,draw
1917,November 28,2011,Malawi,Kenya,2,0,CECAFA Cup,in Tanzania,23,-23,1438,1307,2,-4,101,132,1415,1330,T1
1918,November 28,2011,Uganda,Somalia,4,0,CECAFA Cup,in Tanzania,2,-2,1555,898,2,0,71,197,1553,900,T1
1919,November 29,2011,India,Zambia,0,5,Friendly,in India,-9,9,1201,1531,-3,2,155,77,1210,1522,T2
1920,November 29,2011,Rwanda,Zimbabwe,2,0,CECAFA Cup,in Tanzania,30,-30,1416,1357,9,-8,104,119,1386,1387,T1
1921,November 29,2011,Tanzania,Djibouti,3,0,CECAFA Cup,in Tanzania,2,-2,1298,790,2,0,134,207,1296,792,T1
1922,November 30,2011,Kenya,Ethiopia,2,0,CECAFA Cup,in Tanzania,30,-30,1337,1282,7,-7,125,137,1307,1312,T1
1923,November 30,2011,Malawi,Sudan,0,0,CECAFA Cup,in Tanzania,-2,2,1436,1402,0,0,101,108,1438,1400,draw
1924,December 1,2011,Burundi,Uganda,1,0,CECAFA Cup,in Tanzania,35,-35,1267,1520,5,-9,141,80,1232,1555,T1
1925,December 1,2011,Zanzibar,Somalia,3,0,CECAFA Cup,in Tanzania,5,-5,1342,893,2,-2,123,199,1337,898,T1
1926,December 2,2011,Bangladesh,Pakistan,0,0,South Asian Cup,in India,-6,6,989,892,-1,2,188,200,995,886,draw
1927,December 2,2011,Bonaire,Curaçao,3,1,Friendly tournament,in Suriname,30,-30,1011,1075,3,-3,186,178,981,1105,T1
1928,December 2,2011,Ethiopia,Malawi,1,1,CECAFA Cup,in Tanzania,8,-8,1290,1428,1,0,136,101,1282,1436,draw
1929,December 2,2011,Maldives,Nepal,1,1,South Asian Cup,in India,-7,7,1098,976,-1,0,176,190,1105,969,draw
1930,December 2,2011,Rwanda,Djibouti,5,2,CECAFA Cup,in Tanzania,2,-2,1418,788,1,0,103,207,1416,790,T1
1931,December 2,2011,Suriname,Aruba,0,0,Friendly tournament,in Suriname,-12,12,1191,962,-5,1,159,191,1203,950,draw
1932,December 3,2011,India,Afghanistan,1,1,South Asian Cup,in India,-17,17,1184,856,-6,1,160,204,1201,839,draw
1933,December 3,2011,Sri Lanka,Bhutan,3,0,South Asian Cup,in India,9,-9,899,556,4,-1,197,227,890,565,T1
1934,December 3,2011,Sudan,Kenya,1,0,CECAFA Cup,in Tanzania,16,-16,1418,1321,5,-2,103,128,1402,1337,T1
1935,December 3,2011,Tanzania,Zimbabwe,1,2,CECAFA Cup,in Tanzania,-22,22,1276,1379,-4,4,137,115,1298,1357,T2
1936,December 4,2011,Aruba,Bonaire,2,2,Friendly tournament,in Suriname,2,-2,964,1009,0,0,191,186,962,1011,draw
1937,December 4,2011,Maldives,Pakistan,0,0,South Asian Cup,in India,-11,11,1087,903,0,4,176,197,1098,892,draw
1938,December 4,2011,Nepal,Bangladesh,1,0,South Asian Cup,in India,21,-21,997,968,2,-2,188,190,976,989,T1
1939,December 4,2011,Suriname,Curaçao,2,0,Friendly tournament,in Suriname,10,-10,1201,1065,4,0,154,178,1191,1075,T1
1940,December 5,2011,Afghanistan,Sri Lanka,3,1,South Asian Cup,in India,34,-34,890,865,3,-6,201,204,856,899,T1
1941,December 5,2011,India,Bhutan,5,0,South Asian Cup,in India,1,-1,1185,555,0,0,160,227,1184,556,T1
1942,December 5,2011,Rwanda,Zanzibar,2,1,CECAFA Cup,in Tanzania,16,-16,1434,1326,1,-4,102,127,1418,1342,T1
1943,December 5,2011,Sudan,Burundi,2,0,CECAFA Cup,in Tanzania,18,-18,1436,1249,2,-2,101,143,1418,1267,T1
1944,December 6,2011,Bahrain,Palestine,0,1,Friendly,in Bahrain,-19,19,1489,1189,-5,4,91,159,1508,1170,T2
1945,December 6,2011,Maldives,Bangladesh,3,1,South Asian Cup,in India,20,-20,1107,948,1,-2,175,192,1087,968,T1
1946,December 6,2011,Nepal,Pakistan,1,1,South Asian Cup,in India,-5,5,992,908,0,1,188,196,997,903,draw
1947,December 6,2011,Tanzania,Malawi,1,0,CECAFA Cup,in Tanzania,23,-23,1299,1405,4,-5,133,108,1276,1428,T1
1948,December 6,2011,Uganda,Zimbabwe,1,0,CECAFA Cup,in Tanzania,12,-12,1532,1367,4,-3,76,118,1520,1379,T1
1949,December 7,2011,Afghanistan,Bhutan,8,1,South Asian Cup,in India,11,-11,901,544,3,-1,198,228,890,555,T1
1950,December 7,2011,India,Sri Lanka,3,0,South Asian Cup,in India,6,-6,1191,859,2,0,159,204,1185,865,T1
1951,December 8,2011,Rwanda,Sudan,2,1,CECAFA Cup,in Tanzania,20,-20,1454,1416,3,-3,99,104,1434,1436,T1
1952,December 8,2011,Tanzania,Uganda,1,3,CECAFA Cup,in Tanzania,-19,19,1280,1551,-4,3,137,73,1299,1532,T2
1953,December 9,2011,Afghanistan,Nepal,1,0,South Asian Cup,in India,25,-25,926,967,2,-1,196,189,901,992,T1
1954,December 9,2011,India,Maldives,3,1,South Asian Cup,in India,15,-15,1206,1092,5,-1,154,176,1191,1107,T1
1955,December 10,2011,Qatar,Bahrain,2,2,Pan Arab Games,in Qatar,-7,7,1503,1496,-2,1,87,90,1510,1489,draw
1956,December 10,2011,Rwanda,Uganda,2,2,CECAFA Cup,in Tanzania,5,-5,1459,1546,1,-2,98,75,1454,1551,draw
1957,December 10,2011,Tanzania,Sudan,0,1,CECAFA Cup,in Tanzania,-18,18,1262,1434,-3,2,140,102,1280,1416,T2
1958,December 11,2011,Cuba,Costa Rica,1,1,Friendly,in Cuba,4,-4,1396,1641,0,0,110,51,1392,1645,draw
1959,December 11,2011,India,Afghanistan,4,0,South Asian Cup,in India,8,-8,1214,918,3,0,151,196,1206,926,T1
1960,December 11,2011,Jordan,Palestine,4,1,Pan Arab Games,in Qatar,8,-8,1563,1181,1,-1,70,161,1555,1189,T1
1961,December 13,2011,Bahrain,Iraq,3,0,Pan Arab Games,in Qatar,48,-48,1544,1586,14,-9,76,63,1496,1634,T1
1962,December 14,2011,Libya,Palestine,1,1,Pan Arab Games,in Qatar,-15,15,1496,1196,-6,3,90,158,1511,1181,draw
1963,December 16,2011,Qatar,Iraq,0,0,Pan Arab Games,in Qatar,-1,1,1502,1587,0,1,87,62,1503,1586,draw
1964,December 17,2011,Jordan,Libya,0,0,Pan Arab Games,in Qatar,-4,4,1559,1500,0,0,70,90,1563,1496,draw
1965,December 18,2011,Angola,Zambia,1,0,Friendly,in Angola,8,-8,1492,1523,1,-2,92,80,1484,1531,T1
1966,December 20,2011,Bahrain,Palestine,3,1,Pan Arab Games,in Qatar,7,-7,1551,1189,3,-2,73,160,1544,1196,T1
1967,December 20,2011,Jordan,Kuwait,2,0,Pan Arab Games,in Qatar,29,-29,1588,1521,8,-7,62,80,1559,1550,T1
1968,December 21,2011,Botswana,Lesotho,3,0,Friendly,in South Africa,8,-8,1418,1180,1,0,104,161,1410,1188,T1
1969,December 21,2011,Chile,Paraguay,3,2,Friendly,in Chile,5,-5,1886,1783,1,-1,10,22,1881,1788,T1
1970,December 22,2011,Angola,Namibia,0,0,Friendly,in Angola,-7,7,1485,1304,-1,1,93,132,1492,1297,draw
1971,December 22,2011,Kuwait,Palestine,3,0,Pan Arab Games,in Qatar,9,-9,1530,1180,2,0,78,160,1521,1189,T1
1972,December 22,2011,Venezuela,Costa Rica,0,2,Friendly,in Venezuela,-23,23,1714,1664,-3,4,37,47,1737,1641,T2
1973,January 6,2012,Equatorial Guinea,South Africa,0,0,Friendly,in Equatorial Guinea,7,-7,1234,1593,1,-1,147,60,1227,1600,draw
1974,January 7,2012,Botswana,Zimbabwe,0,0,Friendly,in Botswana,-4,4,1414,1371,-1,0,105,118,1418,1367,draw
1975,January 9,2012,Gabon,Burkina Faso,0,0,Friendly,in Gabon,-4,4,1551,1522,0,1,73,81,1555,1518,draw
1976,January 9,2012,Tunisia,Sudan,3,0,Friendly,in the United Arab Emirates,11,-11,1591,1423,3,-1,61,103,1580,1434,T1
1977,January 11,2012,Nigeria,Angola,0,0,Friendly,in Nigeria,-7,7,1658,1492,-1,1,47,92,1665,1485,draw
1978,January 11,2012,South Africa,Zambia,1,1,Friendly,in South Africa,-5,5,1588,1528,-2,1,62,79,1593,1523,draw
1979,January 12,2012,Senegal,Sudan,1,0,Friendly,in Senegal,3,-3,1624,1420,0,0,55,103,1621,1423,T1
1980,January 13,2012,Ivory Coast,Tunisia,2,0,Friendly,in the United Arab Emirates,8,-8,1772,1583,4,-4,25,64,1764,1591,T1
1981,January 14,2012,Angola,Sierra Leone,3,1,Friendly,in Angola,6,-6,1498,1336,1,-1,91,124,1492,1342,T1
1982,January 14,2012,Namibia,Zambia,0,0,Friendly,in South Africa,6,-6,1310,1522,1,-1,131,80,1304,1528,draw
1983,January 15,2012,Oman,Democratic Republic of Congo,2,2,Friendly,in Oman,-6,6,1543,1433,-1,0,75,102,1549,1427,draw
1984,January 15,2012,São Tomé and Príncipe,Lesotho,1,0,African Nations Cup qualifier,in São Tomé and Príncipe,21,-21,1075,1159,2,-5,178,165,1054,1180,T1
1985,January 15,2012,South Africa,Ghana,1,1,Friendly,in South Africa,2,-2,1590,1773,0,0,61,24,1588,1775,draw
1986,January 16,2012,Gabon,Sudan,0,0,Friendly,in Gabon,-6,6,1545,1426,-1,0,74,103,1551,1420,draw
1987,January 16,2012,Ivory Coast,Libya,1,0,Friendly,in the United Arab Emirates,3,-3,1775,1497,1,-1,24,91,1772,1500,T1
1988,January 17,2012,Kuwait,Uzbekistan,1,0,Friendly,in Kuwait,10,-10,1540,1611,2,0,76,56,1530,1621,T1
1989,January 18,2012,Sweden,Bahrain,2,0,Friendly,in Qatar,5,-5,1867,1568,1,0,12,68,1862,1573,T1
1990,January 18,2012,Thailand,Norway,0,1,King's Cup,in Thailand,-5,5,1384,1760,-1,0,112,30,1389,1755,T2
1991,January 21,2012,Equatorial Guinea,Libya,1,0,African Nations Cup,in Equatorial Guinea,36,-36,1270,1461,8,-6,139,97,1234,1497,T1
1992,January 21,2012,United States,Venezuela,1,0,Friendly,in the United States,7,-7,1723,1707,2,0,34,37,1716,1714,T1
1993,January 21,2012,Zambia,Senegal,2,1,African Nations Cup,in Equatorial Guinea,32,-32,1554,1592,7,-4,73,59,1522,1624,T1
1994,January 22,2012,Angola,Burkina Faso,2,1,African Nations Cup,in Equatorial Guinea,27,-27,1525,1495,10,-9,80,90,1498,1522,T1
1995,January 22,2012,Ivory Coast,Sudan,1,0,African Nations Cup,in Equatorial Guinea,6,-6,1781,1420,1,0,23,103,1775,1426,T1
1996,January 22,2012,Lebanon,Iraq,1,0,Friendly,in Lebanon,14,-14,1334,1573,4,-5,125,67,1320,1587,T1
1997,January 22,2012,Lesotho,São Tomé and Príncipe,0,0,African Nations Cup qualifier,in Lesotho,-10,10,1149,1085,-2,1,167,177,1159,1075,draw
1998,January 22,2012,Trinidad and Tobago,Finland,2,3,Friendly,in Trinidad and Tobago,-10,10,1476,1613,-2,2,94,55,1486,1603,T2
1999,January 23,2012,Gabon,Niger,2,0,African Nations Cup,in Gabon,11,-11,1556,1320,3,-3,72,129,1545,1331,T1
2000,January 23,2012,Tunisia,Morocco,2,1,African Nations Cup,in Gabon,24,-24,1607,1542,5,-6,58,76,1583,1566,T1
2001,January 24,2012,Ghana,Botswana,1,0,African Nations Cup,in Gabon,6,-6,1779,1408,1,0,24,105,1773,1414,T1
2002,January 24,2012,Mali,Guinea,1,0,African Nations Cup,in Gabon,26,-26,1527,1485,9,-7,80,91,1501,1511,T1
2003,January 25,2012,Equatorial Guinea,Senegal,2,1,African Nations Cup,in Equatorial Guinea,39,-39,1309,1553,7,-12,132,72,1270,1592,T1
2004,January 25,2012,Libya,Zambia,2,2,African Nations Cup,in Equatorial Guinea,7,-7,1468,1547,2,0,95,73,1461,1554,draw
2005,January 25,2012,Mexico,Venezuela,3,1,Friendly,in the United States,9,-9,1875,1698,1,-3,12,40,1866,1707,T1
2006,January 25,2012,Panama,United States,0,1,Friendly,in Panama,-11,11,1658,1734,-2,0,46,34,1669,1723,T2
2007,January 26,2012,Angola,Sudan,2,2,African Nations Cup,in Equatorial Guinea,-7,7,1518,1427,-2,0,83,103,1525,1420,draw
2008,January 26,2012,Ivory Coast,Burkina Faso,2,0,African Nations Cup,in Equatorial Guinea,12,-12,1793,1483,2,-2,21,91,1781,1495,T1
2009,January 27,2012,Gabon,Morocco,3,2,African Nations Cup,in Gabon,17,-17,1573,1525,5,-4,66,80,1556,1542,T1
2010,January 27,2012,Romania,Turkmenistan,4,0,Friendly,in Turkey,4,-4,1711,1340,0,-2,37,123,1707,1344,T1
2011,January 27,2012,Tunisia,Niger,2,1,African Nations Cup,in Gabon,8,-8,1615,1312,3,-1,55,130,1607,1320,T1
2012,January 28,2012,Ghana,Mali,2,0,African Nations Cup,in Gabon,14,-14,1793,1513,3,-5,21,84,1779,1527,T1
2013,January 28,2012,Guinea,Botswana,6,1,African Nations Cup,in Gabon,39,-39,1524,1369,10,-13,80,118,1485,1408,T1
2014,January 29,2012,Equatorial Guinea,Zambia,0,1,African Nations Cup,in Equatorial Guinea,-16,16,1293,1563,-3,2,135,71,1309,1547,T2
2015,January 29,2012,Libya,Senegal,2,1,African Nations Cup,in Equatorial Guinea,31,-31,1499,1522,5,-9,90,81,1468,1553,T1
2016,January 29,2012,United Arab Emirates,Uzbekistan,1,0,Friendly,in the United Arab Emirates,13,-13,1400,1598,2,-1,108,58,1387,1611,T1
2017,January 30,2012,Ivory Coast,Angola,2,0,African Nations Cup,in Equatorial Guinea,13,-13,1806,1505,3,-2,18,85,1793,1518,T1
2018,January 30,2012,Sudan,Burkina Faso,2,1,African Nations Cup,in Equatorial Guinea,29,-29,1456,1454,4,-8,99,100,1427,1483,T1
2019,January 31,2012,Gabon,Tunisia,1,0,African Nations Cup,in Gabon,21,-21,1594,1594,7,-4,59,59,1573,1615,T1
2020,January 31,2012,Morocco,Niger,1,0,African Nations Cup,in Gabon,11,-11,1536,1301,2,-3,76,133,1525,1312,T1
2021,February 1,2012,Ghana,Guinea,1,1,African Nations Cup,in Gabon,-16,16,1777,1540,-3,4,25,75,1793,1524,draw
2022,February 1,2012,Mali,Botswana,2,1,African Nations Cup,in Gabon,15,-15,1528,1354,3,-1,80,119,1513,1369,T1
2023,February 4,2012,Equatorial Guinea,Ivory Coast,0,3,African Nations Cup,in Equatorial Guinea,-7,7,1286,1813,-1,0,136,18,1293,1806,T2
2024,February 4,2012,Zambia,Sudan,3,0,African Nations Cup,in Equatorial Guinea,31,-31,1594,1425,12,-4,59,103,1563,1456,T1
2025,February 5,2012,Gabon,Mali,1,1,African Nations Cup,in Gabon,-11,11,1583,1539,-4,3,63,77,1594,1528,draw
2026,February 5,2012,Ghana,Tunisia,2,1,African Nations Cup,in Gabon,13,-13,1790,1581,3,-5,22,64,1777,1594,T1
2027,February 8,2012,Ivory Coast,Mali,1,0,African Nations Cup,in Gabon,9,-9,1822,1530,2,-3,16,80,1813,1539,T1
2028,February 8,2012,Zambia,Ghana,1,0,African Nations Cup,in Equatorial Guinea,38,-38,1632,1752,5,-9,54,31,1594,1790,T1
2029,February 11,2012,Mali,Ghana,2,0,African Nations Cup,in Equatorial Guinea,59,-59,1589,1693,18,-10,62,41,1530,1752,T1
2030,February 12,2012,Ivory Coast,Zambia,0,0,African Nations Cup,in Gabon,-12,12,1810,1644,-2,2,18,52,1822,1632,draw
2031,February 15,2012,Liberia,Nigeria,0,2,Friendly,in Liberia,-4,4,1247,1662,-2,0,144,46,1251,1658,T2
2032,February 15,2012,Paraguay,Chile,2,0,Friendly,in Paraguay,15,-15,1798,1871,2,-2,21,12,1783,1886,T1
2033,February 17,2012,Kuwait,North Korea,1,1,Friendly,in China,-1,1,1539,1505,-1,1,77,85,1540,1504,draw
2034,February 19,2012,Saint Vincent and the Grenadines,Guyana,1,0,Friendly,in Saint Vincent and the Grenadines,14,-14,1156,1361,5,-1,165,117,1142,1375,T1
2035,February 22,2012,China,Kuwait,2,0,Friendly,in China,8,-8,1619,1531,1,-2,56,79,1611,1539,T1
2036,February 22,2012,Grenada,Guyana,1,2,Friendly,in Grenada,-8,8,1167,1369,-1,0,162,117,1175,1361,T2
2037,February 22,2012,Jamaica,Cuba,1,0,Friendly,in Jamaica,2,-2,1642,1394,0,0,53,110,1640,1396,T1
2038,February 22,2012,Namibia,Mozambique,3,0,Friendly,in Namibia,15,-15,1325,1335,2,-4,128,124,1310,1350,T1
2039,February 22,2012,Paraguay,Guatemala,2,1,Friendly,in Paraguay,2,-2,1800,1511,0,0,21,84,1798,1513,T1
2040,February 23,2012,Iran,Jordan,2,2,Friendly,in the United Arab Emirates,-5,5,1739,1571,0,2,32,70,1744,1566,draw
2041,February 23,2012,Oman,India,5,1,Friendly,in Oman,3,-3,1546,1211,1,-1,74,152,1543,1214,T1
2042,February 23,2012,Tanzania,Democratic Republic of Congo,0,0,Friendly,in Tanzania,2,-2,1264,1431,0,0,141,102,1262,1433,draw
2043,February 24,2012,Azerbaijan,Singapore,2,2,Friendly,in the United Arab Emirates,-4,4,1403,1278,-2,1,108,138,1407,1274,draw
2044,February 24,2012,Jamaica,Cuba,3,0,Friendly,in Jamaica,4,-4,1646,1390,1,0,52,110,1642,1394,T1
2045,February 24,2012,Japan,Iceland,3,1,Friendly,in Japan,2,-2,1804,1440,1,0,19,101,1802,1442,T1
2046,February 24,2012,Nicaragua,Puerto Rico,1,0,Friendly,in Nicaragua,6,-6,1123,1074,0,0,174,178,1117,1080,T1
2047,February 24,2012,Thailand,Maldives,3,0,Friendly,in Thailand,3,-3,1387,1089,0,0,111,176,1384,1092,T1
2048,February 24,2012,United Arab Emirates,Palestine,3,0,Friendly,in the United Arab Emirates,5,-5,1405,1175,2,0,106,160,1400,1180,T1
2049,February 25,2012,South Korea,Uzbekistan,4,2,Friendly,in South Korea,5,-5,1775,1593,0,-1,25,59,1770,1598,T1
2050,February 26,2012,Nicaragua,Puerto Rico,4,1,Friendly,in Nicaragua,10,-10,1133,1064,3,-1,171,179,1123,1074,T1
2051,February 27,2012,Azerbaijan,India,3,0,Friendly,in the United Arab Emirates,9,-9,1412,1202,3,-2,105,154,1403,1211,T1
2052,February 28,2012,Brazil,Bosnia and Herzegovina,2,1,Friendly,in Switzerland,2,-2,2066,1692,0,-1,4,41,2064,1694,T1
2053,February 28,2012,Serbia,Armenia,2,0,Friendly,in Cyprus,8,-8,1729,1523,0,-2,34,81,1721,1531,T1
2054,February 29,2012,Antigua and Barbuda,Trinidad and Tobago,0,4,Friendly,in Antigua and Barbuda,-15,15,1298,1491,-3,2,133,92,1313,1476,T2
2055,February 29,2012,Armenia,Canada,3,1,Friendly,in Cyprus,18,-18,1541,1577,3,-10,78,68,1523,1595,T1
2056,February 29,2012,Australia,Saudi Arabia,4,2,World Cup qualifier,in Australia,7,-7,1825,1550,0,-1,16,74,1818,1557,T1
2057,February 29,2012,Austria,Finland,3,1,Friendly,in Austria,12,-12,1591,1601,7,-1,60,58,1579,1613,T1
2058,February 29,2012,Bahrain,Indonesia,10,0,World Cup qualifier,in Bahrain,10,-10,1578,1258,4,-3,67,143,1568,1268,T1
2059,February 29,2012,Belarus,Moldova,0,0,Friendly,in Turkey,-5,5,1586,1413,-2,-1,62,107,1591,1408,draw
2060,February 29,2012,Bolivia,Cuba,1,0,Friendly,in Bolivia,4,-4,1540,1386,-2,0,79,110,1536,1390,T1
2061,February 29,2012,Burundi,Zimbabwe,2,1,African Nations Cup qualifier,in Burundi,21,-21,1270,1350,4,-3,139,119,1249,1371,T1
2062,February 29,2012,Chad,Malawi,3,2,African Nations Cup qualifier,in Chad,25,-25,1246,1380,4,-5,146,112,1221,1405,T1
2063,February 29,2012,Chile,Ghana,1,1,Friendly,in the United States,-5,5,1866,1698,0,1,12,39,1871,1693,draw
2064,February 29,2012,China,Jordan,3,1,World Cup qualifier,in China,18,-18,1637,1553,2,-3,54,73,1619,1571,T1
2065,February 29,2012,Colombia,Mexico,2,0,Friendly,in the United States,19,-19,1788,1856,4,-3,22,14,1769,1875,T1
2066,February 29,2012,Congo,Uganda,3,1,African Nations Cup qualifier,in Congo,37,-37,1395,1509,10,-11,108,85,1358,1546,T1
2067,February 29,2012,Croatia,Sweden,1,3,Friendly,in Croatia,-20,20,1871,1887,-1,4,10,9,1891,1867,T2
2068,February 29,2012,Cyprus,Serbia,0,0,Friendly,in Cyprus,4,-4,1468,1725,1,1,95,33,1464,1729,draw
2069,February 29,2012,Denmark,Russia,0,2,Friendly,in Denmark,-20,20,1811,1837,-2,2,17,15,1831,1817,T2
2070,February 29,2012,Ecuador,Honduras,2,0,Friendly,in Ecuador,6,-6,1784,1647,1,-2,23,51,1778,1653,T1
2071,February 29,2012,Egypt,Niger,1,0,Friendly,in Qatar,2,-2,1722,1299,0,1,35,132,1720,1301,T1
2072,February 29,2012,England,Netherlands,2,3,Friendly,in England,-10,10,1945,2078,0,1,6,2,1955,2068,T2
2073,February 29,2012,Estonia,El Salvador,2,0,Friendly,in the United States,18,-18,1542,1569,3,-7,77,70,1524,1587,T1
2074,February 29,2012,Ethiopia,Benin,0,0,African Nations Cup qualifier,in Ethiopia,-1,1,1289,1382,0,1,135,111,1290,1381,draw
2075,February 29,2012,Gambia,Algeria,1,2,African Nations Cup qualifier,in The Gambia,-20,20,1357,1501,-1,4,116,89,1377,1481,T2
2076,February 29,2012,Georgia,Albania,2,1,Friendly,in Georgia,7,-7,1502,1476,3,-2,88,94,1495,1483,T1
2077,February 29,2012,Germany,France,1,2,Friendly,in Germany,-18,18,2064,1857,-2,1,4,13,2082,1839,T2
2078,February 29,2012,Greece,Belgium,1,1,Friendly,in Greece,-5,5,1780,1688,-2,0,25,42,1785,1683,draw
2079,February 29,2012,Guinea-Bissau,Cameroon,0,1,African Nations Cup qualifier,in Guinea-Bissau,-5,5,1224,1661,-1,3,149,45,1229,1656,T2
2080,February 29,2012,Guyana,Guatemala,0,2,Friendly,in Guyana,-13,13,1356,1524,0,3,117,81,1369,1511,T2
2081,February 29,2012,Hong Kong,Taiwan,5,1,Friendly,in Hong Kong,4,-4,1202,901,3,0,154,198,1198,905,T1
2082,February 29,2012,Hungary,Bulgaria,1,1,Friendly,in Hungary,-4,4,1673,1633,-1,-1,44,56,1677,1629,draw
2083,February 29,2012,Iran,Qatar,2,2,World Cup qualifier,in Iran,-15,15,1724,1517,-2,5,34,83,1739,1502,draw
2084,February 29,2012,Iraq,Singapore,7,1,World Cup qualifier,in Qatar,13,-13,1586,1265,7,-3,62,141,1573,1278,T1
2085,February 29,2012,Ireland,Czechia,1,1,Friendly,in Ireland,-3,3,1800,1798,0,1,20,21,1803,1795,draw
2086,February 29,2012,Israel,Ukraine,2,3,Friendly,in Israel,-10,10,1659,1777,-2,2,46,26,1669,1767,T2
2087,February 29,2012,Italy,United States,0,1,Friendly,in Italy,-16,16,1870,1750,-1,2,11,31,1886,1734,T2
2088,February 29,2012,Ivory Coast,Guinea,0,0,Friendly,in Ivory Coast,-8,8,1802,1548,-1,1,19,75,1810,1540,draw
2089,February 29,2012,Japan,Uzbekistan,0,1,World Cup qualifier,in Japan,-34,34,1770,1627,-8,2,27,57,1804,1593,T2
2090,February 29,2012,Kazakhstan,Latvia,0,0,Friendly,in Turkey,5,-5,1346,1516,1,-1,120,84,1341,1521,draw
2091,February 29,2012,Kenya,Togo,2,1,African Nations Cup qualifier,in Kenya,18,-18,1339,1363,6,-3,123,115,1321,1381,T1
2092,February 29,2012,Liberia,Namibia,1,0,African Nations Cup qualifier,in Liberia,19,-19,1266,1306,4,-2,140,130,1247,1325,T1
2093,February 29,2012,Luxembourg,Macedonia,2,1,Friendly,in Luxembourg,16,-16,1167,1486,5,-5,162,93,1151,1502,T1
2094,February 29,2012,Madagascar,Cape Verde,0,4,African Nations Cup qualifier,in Madagascar,-27,27,1172,1425,-5,6,161,103,1199,1398,T2
2095,February 29,2012,Malta,Liechtenstein,2,1,Friendly,in Malta,8,-8,1221,1227,0,-1,151,148,1213,1235,T1
2096,February 29,2012,Montenegro,Iceland,2,1,Friendly,in Montenegro,3,-3,1642,1437,1,-1,53,102,1639,1440,T1
2097,February 29,2012,Morocco,Burkina Faso,2,0,Friendly,in Morocco,8,-8,1544,1446,1,-1,76,100,1536,1454,T1
2098,February 29,2012,New Zealand,Jamaica,2,3,Friendly,in New Zealand,-11,11,1556,1657,0,5,72,47,1567,1646,T2
2099,February 29,2012,Northern Ireland,Norway,0,3,Friendly,in Northern Ireland,-8,8,1450,1768,-1,1,99,28,1458,1760,T2
2100,February 29,2012,Oman,Thailand,2,0,World Cup qualifier,in Oman,11,-11,1557,1376,3,-3,71,114,1546,1387,T1
2101,February 29,2012,Palestine,Azerbaijan,2,0,Friendly,in the United Arab Emirates,24,-24,1199,1388,3,-4,157,109,1175,1412,T1
2102,February 29,2012,Paraguay,Panama,1,0,Friendly,in Paraguay,4,-4,1804,1654,3,-2,18,49,1800,1658,T1
2103,February 29,2012,Philippines,Malaysia,1,1,Friendly,in the Philippines,2,-2,1032,1207,0,-1,181,153,1030,1209,draw
2104,February 29,2012,Poland,Portugal,0,0,Friendly,in Poland,3,-3,1710,1898,0,0,37,8,1707,1901,draw
2105,February 29,2012,Romania,Uruguay,1,1,Friendly,in Romania,5,-5,1716,1987,0,0,36,5,1711,1992,draw
2106,February 29,2012,Rwanda,Nigeria,0,0,African Nations Cup qualifier,in Rwanda,6,-6,1465,1656,1,-2,96,48,1459,1662,draw
2107,February 29,2012,São Tomé and Príncipe,Sierra Leone,2,1,African Nations Cup qualifier,in São Tomé and Príncipe,28,-28,1113,1308,2,-6,175,129,1085,1336,T1
2108,February 29,2012,Seychelles,Democratic Republic of Congo,0,4,African Nations Cup qualifier,in the Seychelles,-11,11,1013,1442,-2,1,184,101,1024,1431,T2
2109,February 29,2012,Slovenia,Scotland,1,1,Friendly,in Slovenia,-1,1,1652,1705,-1,0,50,38,1653,1704,draw
2110,February 29,2012,South Africa,Senegal,0,0,Friendly,in South Africa,-4,4,1586,1526,-1,2,62,80,1590,1522,draw
2111,February 29,2012,South Korea,Kuwait,2,0,World Cup qualifier,in South Korea,7,-7,1782,1524,1,-2,24,81,1775,1531,T1
2112,February 29,2012,Spain,Venezuela,5,0,Friendly,in Spain,2,-2,2119,1696,0,-1,1,40,2117,1698,T1
2113,February 29,2012,Switzerland,Argentina,1,3,Friendly,in Switzerland,-13,13,1755,1928,-2,0,29,7,1768,1915,T2
2114,February 29,2012,Tajikistan,North Korea,1,1,World Cup qualifier,in Tajikistan,9,-9,1247,1496,0,-6,145,91,1238,1505,draw
2115,February 29,2012,Tanzania,Mozambique,1,1,African Nations Cup qualifier,in Tanzania,-2,2,1262,1337,-1,0,142,124,1264,1335,draw
2116,February 29,2012,Tunisia,Peru,1,1,Friendly,in Tunisia,2,-2,1583,1751,0,0,65,30,1581,1753,draw
2117,February 29,2012,Turkey,Slovakia,1,2,Friendly,in Turkey,-16,16,1729,1596,-1,7,32,59,1745,1580,T2
2118,February 29,2012,United Arab Emirates,Lebanon,4,2,World Cup qualifier,in the United Arab Emirates,16,-16,1421,1318,2,-2,105,127,1405,1334,T1
2119,February 29,2012,Wales,Costa Rica,0,1,Friendly,in Wales,-12,12,1637,1676,-3,2,54,43,1649,1664,T2
2120,March 2,2012,Democratic Republic of Congo,Egypt,0,0,Friendly,in Qatar,7,-7,1449,1715,1,-1,100,36,1442,1722,draw
2121,March 3,2012,Martinique,Guadeloupe,1,2,Friendly,in Martinique,-9,9,1334,1474,-3,1,124,95,1343,1465,T2
2122,March 3,2012,Saint Kitts and Nevis,Antigua and Barbuda,1,0,Friendly,in Saint Kitts and Nevis,10,-10,1205,1288,4,-2,154,135,1195,1298,T1
2123,March 8,2012,Nepal,Palestine,0,2,Asian Cup qual &amp; Asian Challenge Cup,in Nepal,-19,19,948,1218,-2,6,191,152,967,1199,T2
2124,March 8,2012,Turkmenistan,Maldives,3,1,Asian Cup qual &amp; Asian Challenge Cup,in Nepal,11,-11,1351,1078,2,0,119,177,1340,1089,T1
2125,March 9,2012,North Korea,Philippines,2,0,Asian Cup qual &amp; Asian Challenge Cup,in Nepal,4,-4,1500,1028,1,0,90,181,1496,1032,T1
2126,March 9,2012,Tajikistan,India,2,0,Asian Cup qual &amp; Asian Challenge Cup,in Nepal,26,-26,1273,1176,6,-3,139,159,1247,1202,T1
2127,March 10,2012,Nepal,Maldives,0,1,Asian Cup qual &amp; Asian Challenge Cup,in Nepal,-18,18,930,1096,-3,0,194,177,948,1078,T2
2128,March 10,2012,Palestine,Turkmenistan,0,0,Asian Cup qual &amp; Asian Challenge Cup,in Nepal,7,-7,1225,1344,3,-2,149,121,1218,1351,draw
2129,March 11,2012,North Korea,Tajikistan,2,0,Asian Cup qual &amp; Asian Challenge Cup,in Nepal,13,-13,1513,1260,5,-4,85,143,1500,1273,T1
2130,March 11,2012,Philippines,India,2,0,Asian Cup qual &amp; Asian Challenge Cup,in Nepal,42,-42,1070,1134,3,-11,178,170,1028,1176,T1
2131,March 12,2012,Nepal,Turkmenistan,0,3,Asian Cup qual &amp; Asian Challenge Cup,in Nepal,-10,10,920,1354,-1,3,195,118,930,1344,T2
2132,March 12,2012,Palestine,Maldives,2,0,Asian Cup qual &amp; Asian Challenge Cup,in Nepal,19,-19,1244,1077,2,0,147,177,1225,1096,T1
2133,March 13,2012,North Korea,India,4,0,Asian Cup qual &amp; Asian Challenge Cup,in Nepal,8,-8,1521,1126,2,-4,83,174,1513,1134,T1
2134,March 13,2012,Philippines,Tajikistan,2,1,Asian Cup qual &amp; Asian Challenge Cup,in Nepal,30,-30,1100,1230,1,-5,177,148,1070,1260,T1
2135,March 16,2012,North Korea,Palestine,2,0,Asian Cup qual &amp; Asian Challenge Cup,in Nepal,10,-10,1531,1234,3,-1,80,147,1521,1244,T1
2136,March 16,2012,Turkmenistan,Philippines,2,1,Asian Cup qual &amp; Asian Challenge Cup,in Nepal,8,-8,1362,1092,2,0,116,177,1354,1100,T1
2137,March 19,2012,North Korea,Turkmenistan,2,1,Asian Cup qual &amp; Asian Challenge Cup,in Nepal,11,-11,1542,1351,3,-3,77,119,1531,1362,T1
2138,March 19,2012,Philippines,Palestine,4,3,Asian Cup qual &amp; Asian Challenge Cup,in Nepal,28,-28,1120,1206,2,-7,175,154,1092,1234,T1
2139,March 21,2012,Chile,Peru,3,1,Pacific Cup,in Chile,10,-10,1876,1741,2,-1,10,31,1866,1751,T1
2140,March 21,2012,French Guiana,Guyana,1,0,Friendly,in French Guiana,12,-12,1205,1344,3,-4,155,121,1193,1356,T1
2141,March 21,2012,Jamaica,Costa Rica,0,0,Friendly,in Jamaica,-2,2,1655,1678,-1,0,48,43,1657,1676,draw
2142,March 22,2012,French Guiana,Guyana,0,2,Friendly,in French Guiana,-13,13,1192,1357,-3,5,158,116,1205,1344,T2
2143,March 29,2012,Egypt,Uganda,2,1,Friendly,in Sudan,5,-5,1720,1504,1,-1,35,87,1715,1509,T1
2144,March 30,2012,Saint Vincent and the Grenadines,Antigua and Barbuda,1,0,Friendly,in Saint Vincent and the Grenadines,11,-11,1167,1277,4,-2,161,137,1156,1288,T1
2145,March 31,2012,Egypt,Chad,4,0,Friendly,in Sudan,2,-2,1722,1244,0,0,35,145,1720,1246,T1
2146,April 1,2012,Saint Vincent and the Grenadines,Antigua and Barbuda,1,2,Friendly,in Saint Vincent and the Grenadines,-10,10,1157,1287,-4,2,165,135,1167,1277,T2
2147,April 7,2012,Guadeloupe,Martinique,0,1,Friendly,in Guadeloupe,-16,16,1458,1350,-2,4,97,120,1474,1334,T2
2148,April 11,2012,Costa Rica,Honduras,1,1,Friendly,in Costa Rica,-4,4,1674,1651,0,0,43,51,1678,1647,draw
2149,April 11,2012,Peru,Chile,0,3,Pacific Cup,in Peru,-24,24,1717,1900,-4,2,35,8,1741,1876,T2
2150,April 12,2012,Egypt,Nigeria,3,2,Friendly,in the United Arab Emirates,8,-8,1730,1648,3,-4,31,51,1722,1656,T1
2151,April 15,2012,Egypt,Mauritania,3,0,Friendly,in the United Arab Emirates,1,-1,1731,1142,0,-1,31,169,1730,1143,T1
2152,April 17,2012,Egypt,Iraq,0,0,Friendly,in the United Arab Emirates,-4,4,1727,1590,-1,1,32,61,1731,1586,draw
2153,April 18,2012,Iran,Mauritania,2,0,Friendly,in Iran,1,-1,1725,1141,1,0,33,169,1724,1142,T1
2154,April 25,2012,Guatemala,Paraguay,0,1,Friendly,in Guatemala,-5,5,1519,1809,-1,0,83,18,1524,1804,T2
2155,April 28,2012,Malaysia,Sri Lanka,6,0,Friendly,in Malaysia,3,-3,1210,856,1,0,152,204,1207,859,T1
2156,May 2,2012,Iran,Mozambique,3,0,Friendly,in Iran,2,-2,1727,1335,1,0,32,124,1725,1337,T1
2157,May 2,2012,Martinique,Guyana,2,2,Friendly,in Martinique,-3,3,1347,1360,-1,0,121,116,1350,1357,draw
2158,May 4,2012,Guadeloupe,Guyana,1,2,Friendly,in Guadeloupe,-15,15,1443,1375,-4,1,101,115,1458,1360,T2
2159,May 7,2012,Egypt,Libya,4,0,Friendly,in Egypt,5,-5,1732,1494,1,0,31,91,1727,1499,T1
2160,May 11,2012,Lebanon,Egypt,1,4,Friendly,in Lebanon,-5,5,1313,1737,0,0,127,31,1318,1732,T2
2161,May 15,2012,Kurdistan,Mauritania,3,1,Friendly tournament,in Palestine,8,-8,1408,1133,0,-1,108,170,1400,1141,T1
2162,May 16,2012,Angola,Zambia,0,0,Friendly,in Angola,1,-1,1506,1643,0,0,86,52,1505,1644,draw
2163,May 17,2012,Indonesia,Mauritania,2,0,Friendly tournament,in Palestine,15,-15,1273,1118,4,-6,140,176,1258,1133,T1
2164,May 18,2012,Jamaica,Guyana,1,0,Friendly,in Jamaica,2,-2,1657,1373,0,0,47,116,1655,1375,T1
2165,May 18,2012,Lebanon,Jordan,1,2,Friendly,in Lebanon,-6,6,1307,1559,-2,2,130,71,1313,1553,T2
2166,May 19,2012,Indonesia,Kurdistan,1,1,Friendly tournament,in Palestine,6,-6,1279,1402,1,0,139,108,1273,1408,draw
2167,May 20,2012,Egypt,Cameroon,2,1,Friendly,in Sudan,8,-8,1745,1653,0,-3,31,48,1737,1661,T1
2168,May 20,2012,Panama,Guyana,2,0,Friendly,in Panama,3,-3,1657,1370,2,0,46,116,1654,1373,T1
2169,May 22,2012,Albania,Qatar,2,1,Friendly,in Spain,11,-11,1487,1506,1,-1,93,85,1476,1517,T1
2170,May 22,2012,Egypt,Togo,3,0,Friendly,in Sudan,3,-3,1748,1360,0,0,31,117,1745,1363,T1
2171,May 22,2012,Palestine,Indonesia,2,1,Friendly tournament,in Palestine,14,-14,1220,1265,2,-3,153,142,1206,1279,T1
2172,May 22,2012,Poland,Latvia,1,0,Friendly,in Austria,5,-5,1715,1511,0,1,37,84,1710,1516,T1
2173,May 23,2012,Botswana,Lesotho,3,0,Friendly,in Botswana,5,-5,1359,1144,1,0,118,168,1354,1149,T1
2174,May 23,2012,El Salvador,New Zealand,2,2,Friendly,in the United States,0,0,1569,1556,0,0,70,73,1569,1556,draw
2175,May 23,2012,Iraq,Sierra Leone,1,0,Friendly,in Turkey,3,-3,1593,1305,1,-2,60,131,1590,1308,T1
2176,May 23,2012,Japan,Azerbaijan,2,0,Friendly,in Japan,2,-2,1772,1386,0,0,27,110,1770,1388,T1
2177,May 23,2012,Libya,Rwanda,2,0,Friendly,in Tunisia,14,-14,1508,1451,6,-1,85,97,1494,1465,T1
2178,May 23,2012,Peru,Nigeria,1,0,Friendly,in Peru,5,-5,1722,1643,0,0,35,51,1717,1648,T1
2179,May 23,2012,Venezuela,Moldova,4,0,Friendly,in Venezuela,4,-4,1700,1409,1,0,39,107,1696,1413,T1
2180,May 24,2012,Turkey,Georgia,3,1,Friendly,in Austria,6,-6,1735,1496,0,-1,32,91,1729,1502,T1
2181,May 25,2012,Belgium,Montenegro,2,2,Friendly,in Belgium,-4,4,1684,1646,0,2,42,51,1688,1642,draw
2182,May 25,2012,Costa Rica,Guatemala,3,2,Friendly,in Costa Rica,4,-4,1678,1515,0,0,43,83,1674,1519,T1
2183,May 25,2012,Croatia,Estonia,3,1,Friendly,in Croatia,2,-2,1873,1540,0,-1,11,78,1871,1542,T1
2184,May 25,2012,Morocco,Senegal,0,1,Friendly,in Morocco,-13,13,1531,1539,-5,1,81,80,1544,1526,T2
2185,May 25,2012,Russia,Uruguay,1,1,Friendly,in Russia,1,-1,1838,1986,0,0,15,5,1837,1987,draw
2186,May 26,2012,Algeria,Niger,3,0,Friendly,in Algeria,5,-5,1506,1294,4,-1,86,134,1501,1299,T1
2187,May 26,2012,Brazil,Denmark,3,1,Friendly,in Germany,6,-6,2072,1805,1,-1,2,18,2066,1811,T1
2188,May 26,2012,Burkina Faso,Benin,2,2,Friendly,in Burkina Faso,-4,4,1442,1386,-1,2,101,110,1446,1382,draw
2189,May 26,2012,Cameroon,Guinea,2,1,Friendly,in France,7,-7,1660,1541,3,-1,45,76,1653,1548,T1
2190,May 26,2012,Czechia,Israel,2,1,Friendly,in Austria,6,-6,1804,1653,1,-4,20,49,1798,1659,T1
2191,May 26,2012,El Salvador,Moldova,2,0,Friendly,in the United States,9,-9,1578,1400,3,-1,67,108,1569,1409,T1
2192,May 26,2012,Finland,Turkey,3,2,Friendly,in Austria,14,-14,1615,1721,0,-4,58,36,1601,1735,T1
2193,May 26,2012,Greece,Slovenia,1,1,Friendly,in Austria,-4,4,1776,1656,-2,1,27,48,1780,1652,draw
2194,May 26,2012,Ireland,Bosnia and Herzegovina,1,0,Friendly,in Ireland,5,-5,1805,1687,2,0,18,41,1800,1692,T1
2195,May 26,2012,Jordan,Sierra Leone,4,0,Friendly,in Jordan,4,-4,1563,1301,-1,-1,72,132,1559,1305,T1
2196,May 26,2012,Mozambique,Namibia,0,0,Friendly,in Germany,-1,1,1334,1307,0,1,125,129,1335,1306,draw
2197,May 26,2012,Netherlands,Bulgaria,1,2,Friendly,in the Netherlands,-19,19,2059,1652,-1,6,3,50,2078,1633,T2
2198,May 26,2012,New Zealand,Honduras,1,0,Friendly,in the United States,13,-13,1569,1638,2,-4,71,54,1556,1651,T1
2199,May 26,2012,Norway,England,0,1,Friendly,in Norway,-8,8,1760,1953,-2,0,30,6,1768,1945,T2
2200,May 26,2012,Poland,Slovakia,1,0,Friendly,in Austria,7,-7,1722,1589,4,-2,33,61,1715,1596,T1
2201,May 26,2012,Portugal,Macedonia,0,0,Friendly,in Portugal,-9,9,1889,1495,0,2,9,92,1898,1486,draw
2202,May 26,2012,Spain,Serbia,2,0,Friendly,in Switzerland,3,-3,2122,1722,0,1,1,33,2119,1725,T1
2203,May 26,2012,Switzerland,Germany,5,3,Friendly,in Switzerland,23,-23,1778,2041,4,0,25,4,1755,2064,T1
2204,May 26,2012,Tanzania,Malawi,0,0,Friendly,in Tanzania,1,-1,1263,1379,0,0,144,113,1262,1380,draw
2205,May 26,2012,United States,Scotland,5,1,Friendly,in the United States,11,-11,1761,1694,1,-2,29,40,1750,1705,T1
2206,May 27,2012,Albania,Iran,1,0,Friendly,in Turkey,16,-16,1503,1711,3,-5,91,37,1487,1727,T1
2207,May 27,2012,France,Iceland,3,2,Friendly,in France,1,-1,1858,1436,-1,0,14,102,1857,1437,T1
2208,May 27,2012,Ivory Coast,Mali,2,1,Friendly,in France,5,-5,1807,1584,3,-4,18,65,1802,1589,T1
2209,May 27,2012,Jamaica,Panama,0,1,Friendly,in Jamaica,-13,13,1644,1670,-5,1,51,45,1657,1657,T2
2210,May 27,2012,Libya,Chad,1,0,Friendly,in Tunisia,4,-4,1512,1240,1,0,84,146,1508,1244,T1
2211,May 27,2012,Mexico,Wales,2,0,Friendly,in the United States,7,-7,1863,1630,1,-1,13,56,1856,1637,T1
2212,May 27,2012,Oman,Lebanon,1,1,Friendly,in Oman,-8,8,1549,1315,-1,1,74,128,1557,1307,draw
2213,May 27,2012,Tunisia,Rwanda,5,1,Friendly,in Tunisia,8,-8,1591,1443,5,-2,60,99,1583,1451,T1
2214,May 28,2012,Botswana,Iraq,1,1,Friendly,in Turkey,6,-6,1365,1587,1,-3,117,62,1359,1593,draw
2215,May 28,2012,Colombia,Guyana,7,1,Friendly,in Colombia,2,-2,1790,1368,0,0,22,116,1788,1370,T1
2216,May 28,2012,Qatar,Palestine,0,0,Friendly,in Qatar,-8,8,1498,1228,-5,4,91,149,1506,1220,draw
2217,May 28,2012,Ukraine,Estonia,4,0,Friendly,in Austria,8,-8,1785,1532,3,-2,23,80,1777,1540,T1
2218,May 28,2012,Zanzibar,Malawi,1,1,Friendly,in Zanzibar,-1,1,1325,1380,0,0,127,113,1326,1379,draw
2219,May 29,2012,Angola,Macedonia,0,0,Friendly,in Portugal,0,0,1506,1495,-1,0,87,93,1506,1495,draw
2220,May 29,2012,Lithuania,Russia,0,0,Friendly,in Switzerland,7,-7,1511,1831,3,0,85,15,1504,1838,draw
2221,May 29,2012,Turkey,Bulgaria,2,0,Friendly,in Austria,12,-12,1733,1640,3,-4,32,53,1721,1652,T1
2222,May 30,2012,Andorra,Azerbaijan,0,0,Friendly,in Germany,8,-8,1006,1378,0,-4,188,114,998,1386,draw
2223,May 30,2012,Chad,Rwanda,1,1,Friendly,in Tunisia,5,-5,1245,1438,0,-2,146,101,1240,1443,draw
2224,May 30,2012,Netherlands,Slovakia,2,0,Friendly,in the Netherlands,1,-1,2060,1588,0,0,3,61,2059,1589,T1
2225,May 30,2012,Spain,South Korea,4,1,Friendly,in Switzerland,4,-4,2126,1778,0,0,1,25,2122,1782,T1
2226,May 30,2012,Sweden,Iceland,3,2,Friendly,in Sweden,1,-1,1888,1435,0,0,10,102,1887,1436,T1
2227,May 30,2012,Switzerland,Romania,0,1,Friendly,in Switzerland,-14,14,1764,1730,-2,3,28,33,1778,1716,T2
2228,May 30,2012,United States,Brazil,1,4,Friendly,in the United States,-8,8,1753,2080,-1,0,30,2,1761,2072,T2
2229,May 31,2012,France,Serbia,2,0,Friendly,in France,6,-6,1864,1716,0,-2,14,36,1858,1722,T1
2230,May 31,2012,Germany,Israel,2,0,Friendly,in Germany,2,-2,2043,1651,0,0,4,48,2041,1653,T1
2231,May 31,2012,Greece,Armenia,1,0,Friendly,in Austria,4,-4,1780,1537,1,-3,25,79,1776,1541,T1
2232,May 31,2012,Mexico,Bosnia and Herzegovina,2,1,Friendly,in the United States,5,-5,1868,1682,0,-1,13,42,1863,1687,T1
2233,June 1,2012,Austria,Ukraine,3,2,Friendly,in Austria,13,-13,1604,1772,0,-3,59,26,1591,1785,T1
2234,June 1,2012,Czechia,Hungary,1,2,Friendly,in Czechia,-16,16,1788,1689,-1,3,22,41,1804,1673,T2
2235,June 1,2012,Egypt,Mozambique,2,0,World Cup qualifier,in Egypt,3,-3,1751,1331,0,-1,31,126,1748,1334,T1
2236,June 1,2012,Estonia,Finland,1,2,Baltic Cup,in Estonia,-16,16,1516,1631,-4,2,84,56,1532,1615,T2
2237,June 1,2012,Ghana,Lesotho,7,0,World Cup qualifier,in Ghana,2,-2,1700,1142,1,-1,38,169,1698,1144,T1
2238,June 1,2012,Guatemala,Costa Rica,1,0,Friendly,in Guatemala,12,-12,1527,1666,1,-2,82,45,1515,1678,T1
2239,June 1,2012,Hong Kong,Singapore,1,0,Friendly,in Hong Kong,9,-9,1211,1256,3,-2,154,144,1202,1265,T1
2240,June 1,2012,Kazakhstan,Kyrgyzstan,5,2,Friendly,in Kazakhstan,5,-5,1351,1123,3,-1,120,174,1346,1128,T1
2241,June 1,2012,Latvia,Lithuania,5,0,Baltic Cup,in Estonia,30,-30,1541,1481,9,-9,76,94,1511,1511,T1
2242,June 1,2012,Malaysia,Philippines,0,0,Friendly,in Malaysia,-5,5,1205,1125,-2,2,156,173,1210,1120,draw
2243,June 1,2012,New Caledonia,Vanuatu,5,2,World Cup qualifier and Oceania Cup,in the Solomon Islands,37,-37,1339,1213,7,-8,124,153,1302,1250,T1
2244,June 1,2012,Panama,Jamaica,2,1,Friendly,in Panama,7,-7,1677,1637,1,-4,44,54,1670,1644,T1
2245,June 1,2012,Puerto Rico,Nicaragua,3,1,Friendly,in Puerto Rico,14,-14,1078,1119,2,-5,179,175,1064,1133,T1
2246,June 1,2012,Russia,Italy,3,0,Friendly,in Switzerland,19,-19,1850,1851,0,-2,15,14,1831,1870,T1
2247,June 1,2012,Tahiti,Samoa,10,1,World Cup qualifier and Oceania Cup,in the Solomon Islands,7,-7,1182,690,0,-1,160,217,1175,697,T1
2248,June 2,2012,Algeria,Rwanda,4,0,World Cup qualifier,in Algeria,21,-21,1527,1417,5,-3,81,104,1506,1438,T1
2249,June 2,2012,Argentina,Ecuador,4,0,World Cup qualifier,in Argentina,15,-15,1943,1769,0,-4,7,27,1928,1784,T1
2250,June 2,2012,Bolivia,Chile,0,2,World Cup qualifier,in Bolivia,-11,11,1529,1911,-2,0,80,8,1540,1900,T2
2251,June 2,2012,Burkina Faso,Congo,0,0,World Cup qualifier,in Burkina Faso,-8,8,1434,1403,-2,2,102,107,1442,1395,draw
2252,June 2,2012,Cameroon,Democratic Republic of Congo,1,0,World Cup qualifier,in Cameroon,6,-6,1666,1443,1,-1,45,99,1660,1449,T1
2253,June 2,2012,Central African Republic,Botswana,2,0,World Cup qualifier,in Central African Republic,32,-32,1269,1333,5,-8,141,125,1237,1365,T1
2254,June 2,2012,Denmark,Australia,2,0,Friendly,in Denmark,12,-12,1817,1813,3,-1,16,17,1805,1825,T1
2255,June 2,2012,England,Belgium,1,0,Friendly,in England,2,-2,1955,1682,0,0,6,42,1953,1684,T1
2256,June 2,2012,Gambia,Morocco,1,1,World Cup qualifier,in The Gambia,4,-4,1361,1527,2,0,117,81,1357,1531,draw
2257,June 2,2012,Honduras,El Salvador,3,0,Friendly,in the United States,15,-15,1653,1563,5,-4,48,71,1638,1578,T1
2258,June 2,2012,Ivory Coast,Tanzania,2,0,World Cup qualifier,in Ivory Coast,1,-1,1808,1262,-1,0,19,143,1807,1263,T1
2259,June 2,2012,Kenya,Malawi,0,0,World Cup qualifier,in Kenya,-3,3,1336,1383,0,0,124,112,1339,1380,draw
2260,June 2,2012,Luxembourg,Malta,0,2,Friendly,in Luxembourg,-17,17,1150,1238,-5,5,167,147,1167,1221,T2
2261,June 2,2012,Netherlands,Northern Ireland,6,0,Friendly,in the Netherlands,1,-1,2061,1449,0,-1,3,98,2060,1450,T1
2262,June 2,2012,New Zealand,Fiji,1,0,World Cup qualifier and Oceania Cup,in the Solomon Islands,9,-9,1578,1288,4,-3,67,136,1569,1297,T1
2263,June 2,2012,Norway,Croatia,1,1,Friendly,in Norway,0,0,1760,1873,0,1,29,10,1760,1873,draw
2264,June 2,2012,Poland,Andorra,4,0,Friendly,in Poland,0,0,1722,1006,0,0,34,188,1722,1006,T1
2265,June 2,2012,Portugal,Turkey,1,3,Friendly,in Portugal,-24,24,1865,1757,-3,2,12,30,1889,1733,T2
2266,June 2,2012,Senegal,Liberia,3,1,World Cup qualifier,in Senegal,6,-6,1545,1260,4,-3,75,144,1539,1266,T1
2267,June 2,2012,Sierra Leone,Cape Verde,2,1,World Cup qualifier,in Sierra Leone,21,-21,1322,1404,3,-3,129,106,1301,1425,T1
2268,June 2,2012,Solomon Islands,Papua New Guinea,1,0,World Cup qualifier and Oceania Cup,in the Solomon Islands,7,-7,1293,1052,3,0,134,182,1286,1059,T1
2269,June 2,2012,Sudan,Zambia,2,0,World Cup qualifier,in Sudan,40,-40,1465,1603,7,-9,96,59,1425,1643,T1
2270,June 2,2012,Tunisia,Equatorial Guinea,3,1,World Cup qualifier,in Tunisia,5,-5,1596,1281,0,-1,60,138,1591,1286,T1
2271,June 2,2012,Uruguay,Venezuela,1,1,World Cup qualifier,in Uruguay,-16,16,1970,1716,0,2,5,36,1986,1700,draw
2272,June 3,2012,Angola,Uganda,1,1,World Cup qualifier,in Angola,-6,6,1500,1510,-3,1,90,87,1506,1504,draw
2273,June 3,2012,Benin,Mali,1,0,World Cup qualifier,in Benin,25,-25,1411,1559,4,-6,106,71,1386,1584,T1
2274,June 3,2012,Canada,United States,0,0,Friendly,in Canada,2,-2,1579,1751,5,0,64,31,1577,1753,draw
2275,June 3,2012,Estonia,Lithuania,1,0,Baltic Cup,in Estonia,9,-9,1525,1472,1,0,84,94,1516,1481,T1
2276,June 3,2012,Finland,Latvia,1,1,Baltic Cup,in Estonia,-4,4,1627,1545,-1,2,56,75,1631,1541,draw
2277,June 3,2012,Japan,Oman,3,0,World Cup qualifier,in Japan,9,-9,1781,1540,2,-4,23,78,1772,1549,T1
2278,June 3,2012,Jordan,Iraq,1,1,World Cup qualifier,in Jordan,-4,4,1559,1591,0,1,71,61,1563,1587,draw
2279,June 3,2012,Lebanon,Qatar,0,1,World Cup qualifier,in Lebanon,-15,15,1300,1513,-4,4,134,86,1315,1498,T2
2280,June 3,2012,Mexico,Brazil,2,0,Friendly,in the United States,23,-23,1891,2057,2,-1,9,3,1868,2080,T1
2281,June 3,2012,Niger,Gabon,0,0,World Cup qualifier,in Niger,10,-10,1304,1573,2,-2,131,68,1294,1583,draw
2282,June 3,2012,Nigeria,Namibia,1,0,World Cup qualifier,in Nigeria,3,-3,1646,1304,1,1,50,131,1643,1307,T1
2283,June 3,2012,Peru,Colombia,0,1,World Cup qualifier,in Peru,-22,22,1700,1812,-4,3,38,18,1722,1790,T2
2284,June 3,2012,Puerto Rico,Nicaragua,1,1,Friendly,in Puerto Rico,-2,2,1076,1121,-1,0,180,175,1078,1119,draw
2285,June 3,2012,South Africa,Ethiopia,1,1,World Cup qualifier,in South Africa,-16,16,1570,1305,-6,5,69,130,1586,1289,draw
2286,June 3,2012,Spain,China,1,0,Friendly,in Spain,1,-1,2127,1636,0,-1,1,54,2126,1637,T1
2287,June 3,2012,Tahiti,New Caledonia,4,3,World Cup qualifier and Oceania Cup,in the Solomon Islands,36,-36,1218,1303,7,-10,153,133,1182,1339,T1
2288,June 3,2012,Togo,Libya,1,1,World Cup qualifier,in Togo,3,-3,1363,1509,1,-2,117,88,1360,1512,draw
2289,June 3,2012,Uzbekistan,Iran,0,1,World Cup qualifier,in Uzbekistan,-21,21,1606,1732,0,5,57,33,1627,1711,T2
2290,June 3,2012,Vanuatu,Samoa,5,0,World Cup qualifier and Oceania Cup,in the Solomon Islands,5,-5,1218,685,0,-1,153,218,1213,690,T1
2291,June 3,2012,Zimbabwe,Guinea,0,1,World Cup qualifier,in Zimbabwe,-15,15,1335,1556,-2,4,123,73,1350,1541,T2
2292,June 4,2012,Hungary,Ireland,0,0,Friendly,in Hungary,0,0,1689,1805,0,0,41,21,1689,1805,draw
2293,June 4,2012,Kurdistan,Western Sahara,6,0,VIVA World Cup,in Kurdistan,4,-4,1406,996,2,0,107,189,1402,1000,T1
2294,June 4,2012,New Zealand,Papua New Guinea,2,1,World Cup qualifier and Oceania Cup,in the Solomon Islands,2,-2,1580,1050,1,0,64,182,1578,1052,T1
2295,June 4,2012,Solomon Islands,Fiji,0,0,World Cup qualifier and Oceania Cup,in the Solomon Islands,-7,7,1286,1295,-2,1,137,135,1293,1288,draw
2296,June 5,2012,Armenia,Kazakhstan,3,0,Friendly,in Armenia,6,-6,1543,1345,2,-2,77,121,1537,1351,T1
2297,June 5,2012,Austria,Romania,0,0,Friendly,in Austria,1,-1,1605,1729,0,0,58,34,1604,1730,draw
2298,June 5,2012,France,Estonia,4,0,Friendly,in France,3,-3,1867,1522,1,-1,12,85,1864,1525,T1
2299,June 5,2012,New Caledonia,Samoa,9,0,World Cup qualifier and Oceania Cup,in the Solomon Islands,3,-3,1306,682,3,-1,130,220,1303,685,T1
2300,June 5,2012,Philippines,Indonesia,2,2,Friendly,in the Philippines,1,-1,1126,1264,1,0,172,142,1125,1265,draw
2301,June 5,2012,Sweden,Serbia,2,1,Friendly,in Sweden,3,-3,1891,1713,1,-1,9,37,1888,1716,T1
2302,June 5,2012,Tahiti,Vanuatu,4,1,World Cup qualifier and Oceania Cup,in the Solomon Islands,44,-44,1262,1174,10,-7,143,160,1218,1218,T1
2303,June 5,2012,Turkey,Ukraine,2,0,Friendly,in Germany,16,-16,1773,1756,4,-4,26,30,1757,1772,T1
2304,June 6,2012,Fiji,Papua New Guinea,1,1,World Cup qualifier and Oceania Cup,in the Solomon Islands,-15,15,1280,1065,-3,1,138,181,1295,1050,draw
2305,June 6,2012,Solomon Islands,New Zealand,1,1,World Cup qualifier and Oceania Cup,in the Solomon Islands,13,-13,1299,1567,2,-5,135,69,1286,1580,draw
2306,June 7,2012,Belarus,Lithuania,1,1,Friendly,in Belarus,-5,5,1581,1477,0,0,63,94,1586,1472,draw
2307,June 8,2012,Bahrain,Kuwait,1,1,Friendly,in Egypt,-2,2,1576,1526,0,2,65,82,1578,1524,draw
2308,June 8,2012,China,Vietnam,3,0,Friendly,in China,2,-2,1638,1273,1,0,53,139,1636,1275,T1
2309,June 8,2012,Costa Rica,El Salvador,2,2,World Cup qualifier,in Costa Rica,-11,11,1655,1574,-2,4,47,66,1666,1563,draw
2310,June 8,2012,Cuba,Canada,0,1,World Cup qualifier,in Cuba,-15,15,1371,1594,-4,3,115,61,1386,1579,T2
2311,June 8,2012,Honduras,Panama,0,2,World Cup qualifier,in Honduras,-36,36,1617,1713,-8,7,56,37,1653,1677,T2
2312,June 8,2012,Jamaica,Guatemala,2,1,World Cup qualifier,in Jamaica,9,-9,1646,1518,4,-3,49,84,1637,1527,T1
2313,June 8,2012,Japan,Jordan,6,0,World Cup qualifier,in Japan,12,-12,1793,1547,0,-3,23,74,1781,1559,T1
2314,June 8,2012,Lebanon,Uzbekistan,1,1,World Cup qualifier,in Lebanon,11,-11,1311,1595,5,-3,129,60,1300,1606,draw
2315,June 8,2012,Mexico,Guyana,3,1,World Cup qualifier,in Mexico,2,-2,1893,1366,0,-1,9,117,1891,1368,T1
2316,June 8,2012,New Caledonia,New Zealand,2,0,Oceania Nations Cup,in the Solomon Islands,61,-61,1367,1506,14,-18,116,87,1306,1567,T1
2317,June 8,2012,Northern Cyprus,Zanzibar,2,0,VIVA World Cup,in Kurdistan,19,-19,1473,1306,2,-4,95,131,1454,1325,T1
2318,June 8,2012,Oman,Australia,0,0,World Cup qualifier,in Oman,9,-9,1549,1804,6,-4,73,21,1540,1813,draw
2319,June 8,2012,Poland,Greece,1,1,European Championship,in Poland,-3,3,1719,1783,0,0,35,24,1722,1780,draw
2320,June 8,2012,Qatar,South Korea,1,4,World Cup qualifier,in Qatar,-20,20,1493,1798,-6,3,92,22,1513,1778,T2
2321,June 8,2012,Russia,Czechia,4,1,European Championship,in Poland,36,-36,1886,1752,4,-9,11,31,1850,1788,T1
2322,June 8,2012,Singapore,Malaysia,2,2,Friendly,in Singapore,-4,4,1252,1209,0,1,146,155,1256,1205,draw
2323,June 8,2012,Solomon Islands,Tahiti,0,1,Oceania Nations Cup,in the Solomon Islands,-34,34,1265,1296,-7,8,142,135,1299,1262,T2
2324,June 8,2012,United States,Antigua and Barbuda,3,1,World Cup qualifier,in the United States,2,-2,1753,1285,1,0,30,136,1751,1287,T1
2325,June 9,2012,Argentina,Brazil,4,3,Friendly,in the United States,13,-13,1956,2044,1,0,6,3,1943,2057,T1
2326,June 9,2012,Bolivia,Paraguay,3,1,World Cup qualifier,in Bolivia,44,-44,1573,1765,10,-8,69,26,1529,1809,T1
2327,June 9,2012,Botswana,South Africa,1,1,World Cup qualifier,in Botswana,8,-8,1341,1562,2,-1,123,70,1333,1570,draw
2328,June 9,2012,Cape Verde,Tunisia,1,2,World Cup qualifier,in Cape Verde,-15,15,1389,1611,-3,1,111,58,1404,1596,T2
2329,June 9,2012,Congo,Niger,1,0,World Cup qualifier,in Congo,10,-10,1413,1294,2,-2,107,135,1403,1304,T1
2330,June 9,2012,Denmark,Netherlands,1,0,European Championship,in Ukraine,40,-40,1857,2021,2,-2,14,4,1817,2061,T1
2331,June 9,2012,Equatorial Guinea,Sierra Leone,2,2,World Cup qualifier,in Equatorial Guinea,-3,3,1278,1325,-1,1,138,127,1281,1322,draw
2332,June 9,2012,French Guiana,Suriname,2,1,Friendly,in French Guiana,7,-7,1199,1194,1,-1,158,159,1192,1201,T1
2333,June 9,2012,Gabon,Burkina Faso,1,0,World Cup qualifier,in Gabon,8,-8,1581,1426,4,0,64,102,1573,1434,T1
2334,June 9,2012,Germany,Portugal,1,0,European Championship,in Ukraine,13,-13,2056,1852,2,-1,2,15,2043,1865,T1
2335,June 9,2012,Kurdistan,Northern Cyprus,2,1,VIVA World Cup,in Kurdistan,18,-18,1424,1455,4,-2,103,97,1406,1473,T1
2336,June 9,2012,Malawi,Nigeria,1,1,World Cup qualifier,in Malawi,9,-9,1392,1637,1,-4,110,53,1383,1646,draw
2337,June 9,2012,Morocco,Ivory Coast,2,2,World Cup qualifier,in Morocco,10,-10,1537,1798,0,-1,80,20,1527,1808,draw
2338,June 9,2012,Namibia,Kenya,1,0,World Cup qualifier,in Namibia,16,-16,1320,1320,5,-5,128,128,1304,1336,T1
2339,June 9,2012,Uganda,Senegal,1,1,World Cup qualifier,in Uganda,-4,4,1506,1549,-1,1,86,74,1510,1545,draw
2340,June 9,2012,Venezuela,Chile,0,2,World Cup qualifier,in Venezuela,-22,22,1694,1933,-3,0,39,8,1716,1911,T2
2341,June 9,2012,Zambia,Ghana,1,0,World Cup qualifier,in Zambia,20,-20,1623,1680,2,-5,56,44,1603,1700,T1
2342,June 10,2012,Croatia,Ireland,3,1,European Championship,in Poland,30,-30,1903,1775,3,-6,9,24,1873,1805,T1
2343,June 10,2012,Democratic Republic of Congo,Togo,2,0,World Cup qualifier,in the Democratic Republic of the Congo,16,-16,1459,1347,3,0,96,118,1443,1363,T1
2344,June 10,2012,Ecuador,Colombia,1,0,World Cup qualifier,in Ecuador,17,-17,1786,1795,3,-3,22,20,1769,1812,T1
2345,June 10,2012,Ethiopia,Central African Republic,2,0,World Cup qualifier,in Ethiopia,19,-19,1324,1250,4,-4,129,145,1305,1269,T1
2346,June 10,2012,Guinea,Egypt,2,3,World Cup qualifier,in Guinea,-15,15,1541,1766,-7,6,79,26,1556,1751,T2
2347,June 10,2012,Hong Kong,Vietnam,1,2,Friendly,in Hong Kong,-11,11,1200,1284,-3,2,157,137,1211,1273,T2
2348,June 10,2012,Italy,Spain,1,1,European Championship,in Poland,17,-17,1868,2110,3,0,13,1,1851,2127,draw
2349,June 10,2012,Lesotho,Sudan,0,0,World Cup qualifier,in Lesotho,11,-11,1153,1454,3,-2,166,98,1142,1465,draw
2350,June 10,2012,Liberia,Angola,0,0,World Cup qualifier,in Liberia,8,-8,1268,1492,3,-3,142,92,1260,1500,draw
2351,June 10,2012,Libya,Cameroon,2,1,World Cup qualifier,in Tunisia,28,-28,1537,1638,5,-6,80,51,1509,1666,T1
2352,June 10,2012,Mali,Algeria,2,1,World Cup qualifier,in Burkina Faso,18,-18,1577,1509,5,-5,66,86,1559,1527,T1
2353,June 10,2012,Mozambique,Zimbabwe,0,0,World Cup qualifier,in Mozambique,-5,5,1326,1340,-1,1,126,123,1331,1335,draw
2354,June 10,2012,Rwanda,Benin,1,1,World Cup qualifier,in Rwanda,-6,6,1411,1417,-3,3,108,105,1417,1411,draw
2355,June 10,2012,Solomon Islands,New Zealand,3,4,Oceania Nations Cup,in the Solomon Islands,-15,15,1250,1521,-3,2,145,84,1265,1506,T2
2356,June 10,2012,Tahiti,New Caledonia,1,0,Oceania Nations Cup,in the Solomon Islands,30,-30,1326,1337,8,-8,126,124,1296,1367,T1
2357,June 10,2012,Tanzania,Gambia,2,1,World Cup qualifier,in Tanzania,20,-20,1282,1341,6,-2,138,121,1262,1361,T1
2358,June 10,2012,Uruguay,Peru,4,2,World Cup qualifier,in Uruguay,6,-6,1976,1694,0,0,5,38,1970,1700,T1
2359,June 11,2012,England,France,1,1,European Championship,in Ukraine,-6,6,1949,1873,0,2,7,12,1955,1867,draw
2360,June 11,2012,Ukraine,Sweden,2,1,European Championship,in Ukraine,28,-28,1784,1863,7,-3,23,14,1756,1891,T1
2361,June 12,2012,Antigua and Barbuda,Jamaica,0,0,World Cup qualifier,in Antigua and Barbuda,13,-13,1298,1633,1,-5,135,53,1285,1646,draw
2362,June 12,2012,Australia,Japan,1,1,World Cup qualifier,in Australia,-6,6,1798,1799,-2,3,19,18,1804,1793,draw
2363,June 12,2012,Canada,Honduras,0,0,World Cup qualifier,in Canada,-4,4,1590,1621,0,0,61,57,1594,1617,draw
2364,June 12,2012,Czechia,Greece,2,1,European Championship,in Poland,27,-27,1779,1756,8,-7,24,31,1752,1783,T1
2365,June 12,2012,El Salvador,Mexico,1,2,World Cup qualifier,in El Salvador,-9,9,1565,1902,-1,0,69,10,1574,1893,T2
2366,June 12,2012,Guatemala,United States,1,1,World Cup qualifier,in Guatemala,7,-7,1525,1746,2,-1,83,32,1518,1753,draw
2367,June 12,2012,Guyana,Costa Rica,0,4,World Cup qualifier,in Guyana,-19,19,1347,1674,-1,1,117,45,1366,1655,T2
2368,June 12,2012,Iran,Qatar,0,0,World Cup qualifier,in Iran,-15,15,1717,1508,-2,4,35,87,1732,1493,draw
2369,June 12,2012,Iraq,Oman,1,1,World Cup qualifier,in Qatar,-2,2,1589,1551,0,1,62,72,1591,1549,draw
2370,June 12,2012,Kuwait,Bahrain,1,0,Friendly,in Egypt,11,-11,1537,1565,2,-2,80,69,1526,1576,T1
2371,June 12,2012,Malaysia,Singapore,2,0,Friendly,in Malaysia,13,-13,1222,1239,0,-3,154,147,1209,1252,T1
2372,June 12,2012,Panama,Cuba,1,0,World Cup qualifier,in Panama,3,-3,1716,1368,0,0,36,115,1713,1371,T1
2373,June 12,2012,Philippines,Guam,3,0,Friendly,in the Philippines,1,-1,1127,613,0,0,172,225,1126,614,T1
2374,June 12,2012,Poland,Russia,1,1,European Championship,in Poland,5,-5,1724,1881,1,0,34,11,1719,1886,draw
2375,June 12,2012,South Korea,Lebanon,3,0,World Cup qualifier,in South Korea,2,-2,1800,1309,1,0,17,132,1798,1311,T1
2376,June 13,2012,Germany,Netherlands,2,1,European Championship,in Ukraine,22,-22,2078,1999,0,0,2,4,2056,2021,T1
2377,June 13,2012,Portugal,Denmark,3,2,European Championship,in Ukraine,25,-25,1877,1832,4,-1,12,16,1852,1857,T1
2378,June 14,2012,Croatia,Italy,1,1,European Championship,in Poland,-3,3,1900,1871,-1,0,10,14,1903,1868,draw
2379,June 14,2012,Spain,Ireland,4,0,European Championship,in Poland,12,-12,2122,1763,0,-4,1,29,2110,1775,T1
2380,June 15,2012,Algeria,Gambia,4,1,African Nations Cup qualifier,in Algeria,12,-12,1521,1329,1,-4,85,125,1509,1341,T1
2381,June 15,2012,Egypt,Central African Republic,2,3,African Nations Cup qualifier,in Egypt,-39,39,1727,1289,-7,7,33,137,1766,1250,T2
2382,June 15,2012,England,Sweden,3,2,European Championship,in Ukraine,19,-19,1968,1844,1,0,6,15,1949,1863,T1
2383,June 15,2012,South Africa,Gabon,3,0,Friendly,in South Africa,13,-13,1575,1568,5,-5,66,69,1562,1581,T1
2384,June 15,2012,Ukraine,France,0,2,European Championship,in Ukraine,-39,39,1745,1912,-8,4,31,9,1784,1873,T2
2385,June 16,2012,Cameroon,Guinea-Bissau,1,0,African Nations Cup qualifier,in Cameroon,2,-2,1640,1222,0,-1,50,153,1638,1224,T1
2386,June 16,2012,Cape Verde,Madagascar,3,1,African Nations Cup qualifier,in Cape Verde,8,-8,1397,1164,1,-2,110,163,1389,1172,T1
2387,June 16,2012,Greece,Russia,1,0,European Championship,in Poland,34,-34,1790,1847,6,-2,23,14,1756,1881,T1
2388,June 16,2012,Malawi,Chad,2,0,African Nations Cup qualifier,in Malawi,12,-12,1404,1233,3,-2,107,148,1392,1245,T1
2389,June 16,2012,Namibia,Liberia,0,0,African Nations Cup qualifier,in Namibia,-8,8,1312,1276,-1,1,131,142,1320,1268,draw
2390,June 16,2012,Nigeria,Rwanda,2,0,African Nations Cup qualifier,in Nigeria,8,-8,1645,1403,3,0,49,108,1637,1411,T1
2391,June 16,2012,Poland,Czechia,0,1,European Championship,in Poland,-28,28,1696,1807,-3,6,37,17,1724,1779,T2
2392,June 16,2012,Sierra Leone,São Tomé and Príncipe,4,2,African Nations Cup qualifier,in Sierra Leone,9,-9,1334,1104,4,0,124,177,1325,1113,T1
2393,June 16,2012,Uganda,Congo,4,0,African Nations Cup qualifier,in Uganda,19,-19,1525,1394,5,-4,83,111,1506,1413,T1
2394,June 17,2012,Benin,Ethiopia,1,1,African Nations Cup qualifier,in Benin,-10,10,1407,1334,-1,5,106,124,1417,1324,draw
2395,June 17,2012,Democratic Republic of Congo,Seychelles,3,0,African Nations Cup qualifier,in the Democratic Republic of the Congo,3,-3,1462,1010,0,-1,96,186,1459,1013,T1
2396,June 17,2012,Germany,Denmark,2,1,European Championship,in Ukraine,10,-10,2088,1822,0,0,2,16,2078,1832,T1
2397,June 17,2012,Mozambique,Tanzania,1,1,African Nations Cup qualifier,in Mozambique,-8,8,1318,1290,-2,2,129,137,1326,1282,draw
2398,June 17,2012,Portugal,Netherlands,2,1,European Championship,in Ukraine,33,-33,1910,1966,2,-2,10,6,1877,1999,T1
2399,June 17,2012,Togo,Kenya,1,0,African Nations Cup qualifier,in Togo,13,-13,1360,1307,1,-3,116,133,1347,1320,T1
2400,June 17,2012,Zimbabwe,Burundi,1,0,African Nations Cup qualifier,in Zimbabwe,11,-11,1351,1259,5,-1,117,144,1340,1270,T1
2401,June 18,2012,Italy,Ireland,2,0,European Championship,in Poland,26,-26,1897,1737,1,-3,12,31,1871,1763,T1
2402,June 18,2012,Spain,Croatia,1,0,European Championship,in Poland,11,-11,2133,1889,0,-1,1,13,2122,1900,T1
2403,June 18,2012,Yemen,Palestine,1,2,Friendly,in Yemen,-15,15,1294,1243,-4,4,135,146,1309,1228,T2
2404,June 19,2012,Sweden,France,2,0,European Championship,in Ukraine,45,-45,1889,1867,3,-5,12,14,1844,1912,T1
2405,June 19,2012,Ukraine,England,0,1,European Championship,in Ukraine,-17,17,1728,1985,-2,1,32,4,1745,1968,T2
2406,June 21,2012,Portugal,Czechia,1,0,European Championship,in Poland,18,-18,1928,1789,0,-6,9,23,1910,1807,T1
2407,June 22,2012,Germany,Greece,4,2,European Championship,in Poland,11,-11,2099,1779,0,-2,2,24,2088,1790,T1
2408,June 22,2012,Saudi Arabia,Kuwait,4,0,Arab Nations Cup,in Saudi Arabia,26,-26,1576,1511,7,-7,66,87,1550,1537,T1
2409,June 23,2012,Libya,Yemen,3,1,Arab Nations Cup,in Saudi Arabia,12,-12,1549,1282,6,-4,74,139,1537,1294,T1
2410,June 23,2012,Morocco,Bahrain,4,0,Arab Nations Cup,in Saudi Arabia,41,-41,1578,1524,15,-12,65,83,1537,1565,T1
2411,June 23,2012,Spain,France,2,0,European Championship,in Ukraine,13,-13,2146,1854,0,0,1,14,2133,1867,T1
2412,June 23,2012,Vietnam,Mozambique,1,0,Friendly,in Vietnam,8,-8,1292,1310,3,-1,136,130,1284,1318,T1
2413,June 24,2012,England,Italy,0,0,European Championship,in Ukraine,-6,6,1979,1903,0,1,4,10,1985,1897,draw
2414,June 24,2012,Iraq,Lebanon,1,0,Arab Nations Cup,in Saudi Arabia,7,-7,1596,1302,2,-2,60,133,1589,1309,T1
2415,June 25,2012,Kuwait,Palestine,2,0,Arab Nations Cup,in Saudi Arabia,11,-11,1522,1232,3,-3,84,149,1511,1243,T1
2416,June 26,2012,Libya,Morocco,0,0,Arab Nations Cup,in Saudi Arabia,2,-2,1551,1576,1,-1,73,66,1549,1578,draw
2417,June 26,2012,Yemen,Bahrain,2,0,Arab Nations Cup,in Saudi Arabia,48,-48,1330,1476,12,-11,127,94,1282,1524,T1
2418,June 27,2012,Portugal,Spain,0,0,European Championship,in Ukraine,14,-14,1942,2132,1,0,8,1,1928,2146,draw
2419,June 27,2012,Sudan,Lebanon,2,0,Arab Nations Cup,in Saudi Arabia,18,-18,1472,1284,3,-5,95,139,1454,1302,T1
2420,June 28,2012,Italy,Germany,2,1,European Championship,in Poland,38,-38,1941,2061,1,0,9,2,1903,2099,T1
2421,June 28,2012,Saudi Arabia,Palestine,2,2,Arab Nations Cup,in Saudi Arabia,-17,17,1559,1249,-6,3,72,146,1576,1232,draw
2422,June 29,2012,Libya,Bahrain,2,1,Arab Nations Cup,in Saudi Arabia,16,-16,1567,1460,2,-3,71,97,1551,1476,T1
2423,June 29,2012,Morocco,Yemen,4,0,Arab Nations Cup,in Saudi Arabia,15,-15,1591,1315,4,-2,62,129,1576,1330,T1
2424,June 30,2012,Central African Republic,Egypt,1,1,African Nations Cup qualifier,in Central African Republic,15,-15,1304,1712,4,-3,134,36,1289,1727,draw
2425,June 30,2012,Iraq,Sudan,1,1,Arab Nations Cup,in Saudi Arabia,-7,7,1589,1479,-3,1,63,93,1596,1472,draw
2426,July 1,2012,Spain,Italy,4,0,European Championship,in Ukraine,23,-23,2155,1918,0,-1,1,10,2132,1941,T1
2427,July 3,2012,Morocco,Iraq,2,1,Arab Nations Cup,in Saudi Arabia,20,-20,1611,1569,3,-7,58,70,1591,1589,T1
2428,July 3,2012,Saudi Arabia,Libya,0,2,Arab Nations Cup,in Saudi Arabia,-38,38,1521,1605,-11,11,84,60,1559,1567,T2
2429,July 5,2012,Saudi Arabia,Iraq,0,1,Arab Nations Cup,in Saudi Arabia,-23,23,1498,1592,-4,7,88,63,1521,1569,T2
2430,July 6,2012,Malawi,Zambia,1,0,Friendly,in Malawi,13,-13,1417,1610,2,-3,105,59,1404,1623,T1
2431,July 6,2012,Morocco,Libya,1,1,Arab Nations Cup,in Saudi Arabia,0,0,1611,1605,1,0,57,60,1611,1605,draw
2432,July 7,2012,British Virgin Islands,Anguilla,1,0,Friendly,in the British Virgin Islands,3,-3,767,566,1,0,211,227,764,569,T1
2433,July 10,2012,South Sudan,Uganda,2,2,Friendly,in South Sudan,7,-7,1107,1518,0,-5,177,85,1100,1525,draw
2434,July 12,2012,Kenya,Botswana,3,1,Friendly,in Kenya,12,-12,1319,1329,3,-4,129,126,1307,1341,T1
2435,July 13,2012,Aruba,Curaçao,3,2,Friendly tournament,in Aruba,15,-15,979,1050,0,-1,192,183,964,1065,T1
2436,July 13,2012,Suriname,Bonaire,8,0,Friendly tournament,in Aruba,18,-18,1212,991,4,-2,155,190,1194,1009,T1
2437,July 15,2012,Aruba,Suriname,1,0,Friendly tournament,in Aruba,20,-20,999,1192,3,-4,189,159,979,1212,T1
2438,July 15,2012,Curaçao,Bonaire,9,2,Friendly tournament,in Aruba,28,-28,1078,963,3,-2,180,192,1050,991,T1
2439,July 16,2012,Botswana,Zimbabwe,1,0,Friendly tournament,in Botswana,12,-12,1341,1339,5,-5,121,122,1329,1351,T1
2440,July 17,2012,Zimbabwe,Lesotho,5,3,Friendly tournament,in Botswana,11,-11,1350,1142,4,-3,118,169,1339,1153,T1
2441,July 18,2012,Botswana,Lesotho,0,0,Friendly tournament,in Botswana,-10,10,1331,1152,-3,2,125,167,1341,1142,draw
2442,July 18,2012,Guam,Northern Mariana Islands,3,1,East Asian Cup qualifier,in Guam,14,-14,627,485,0,0,226,234,613,499,T1
2443,July 20,2012,Macao,Northern Mariana Islands,5,1,East Asian Cup qualifier,in Guam,20,-20,680,465,1,0,222,234,660,485,T1
2444,July 22,2012,Guam,Macao,3,0,East Asian Cup qualifier,in Guam,30,-30,657,650,3,-2,223,224,627,680,T1
2445,August 8,2012,Zambia,Zimbabwe,2,1,Friendly,in Zambia,2,-2,1612,1348,2,0,57,118,1610,1350,T1
2446,August 11,2012,El Salvador,Guatemala,1,0,Friendly,in the United States,9,-9,1574,1516,3,-5,69,85,1565,1525,T1
2447,August 13,2012,Jordan,Uzbekistan,0,1,Friendly,in Jordan,-11,11,1536,1606,-4,2,79,60,1547,1595,T2
2448,August 14,2012,Burkina Faso,Togo,3,0,Friendly,in France,14,-14,1440,1346,1,-4,101,120,1426,1360,T1
2449,August 14,2012,Liechtenstein,Andorra,1,0,Friendly,in Liechtenstein,3,-3,1230,1003,1,0,150,188,1227,1006,T1
2450,August 14,2012,San Marino,Malta,2,3,Friendly,in San Marino,-4,4,891,1242,-2,1,204,147,895,1238,T2
2451,August 15,2012,Albania,Moldova,0,0,Friendly,in Albania,-5,5,1498,1405,-2,1,89,108,1503,1400,draw
2452,August 15,2012,Angola,Mozambique,2,0,Friendly,in Angola,5,-5,1497,1305,0,-1,91,133,1492,1310,T1
2453,August 15,2012,Armenia,Belarus,1,2,Friendly,in Armenia,-12,12,1531,1593,-4,2,80,64,1543,1581,T2
2454,August 15,2012,Austria,Turkey,2,0,Friendly,in Austria,18,-18,1623,1755,6,-3,55,28,1605,1773,T1
2455,August 15,2012,Azerbaijan,Bahrain,3,0,Friendly,in Azerbaijan,17,-17,1395,1443,2,-2,111,99,1378,1460,T1
2456,August 15,2012,Belgium,Netherlands,4,2,Friendly,in Belgium,22,-22,1704,1944,3,-2,39,8,1682,1966,T1
2457,August 15,2012,Bolivia,Guyana,2,0,Friendly,in Bolivia,4,-4,1577,1343,4,-3,67,121,1573,1347,T1
2458,August 15,2012,Botswana,Tanzania,3,3,Friendly,in Botswana,-4,4,1327,1294,-2,1,127,137,1331,1290,draw
2459,August 15,2012,Bulgaria,Cyprus,1,0,Friendly,in Bulgaria,3,-3,1643,1465,0,0,50,95,1640,1468,T1
2460,August 15,2012,Canada,Trinidad and Tobago,2,0,Friendly,in the United States,11,-11,1601,1480,2,0,62,92,1590,1491,T1
2461,August 15,2012,China,Ghana,1,1,Friendly,in China,-2,2,1636,1682,-1,0,53,44,1638,1680,draw
2462,August 15,2012,Costa Rica,Peru,0,1,Friendly,in Costa Rica,-12,12,1662,1706,-1,0,46,38,1674,1694,T2
2463,August 15,2012,Croatia,Switzerland,2,4,Friendly,in Croatia,-24,24,1865,1788,-1,3,13,24,1889,1764,T2
2464,August 15,2012,Denmark,Slovakia,1,3,Friendly,in Denmark,-26,26,1796,1614,-3,8,19,57,1822,1588,T2
2465,August 15,2012,Ecuador,Chile,3,0,Friendly,in the United States,24,-24,1810,1909,7,-1,16,10,1786,1933,T1
2466,August 15,2012,England,Italy,2,1,Friendly,in Switzerland,8,-8,1987,1910,0,1,4,9,1979,1918,T1
2467,August 15,2012,Equatorial Guinea,Liberia,1,0,Friendly,in Equatorial Guinea,7,-7,1285,1269,2,0,139,142,1278,1276,T1
2468,August 15,2012,Estonia,Poland,1,0,Friendly,in Estonia,12,-12,1534,1684,1,-6,79,43,1522,1696,T1
2469,August 15,2012,France,Uruguay,0,0,Friendly,in France,1,-1,1855,1975,0,-1,14,6,1854,1976,draw
2470,August 15,2012,Germany,Argentina,1,3,Friendly,in Germany,-23,23,2038,1979,-1,2,3,5,2061,1956,T2
2471,August 15,2012,Guatemala,Paraguay,3,3,Friendly,in the United States,6,-6,1522,1759,4,-1,81,27,1516,1765,draw
2472,August 15,2012,Hungary,Israel,1,1,Friendly,in Hungary,-4,4,1685,1655,-1,0,42,47,1689,1651,draw
2473,August 15,2012,Iceland,Faroe Islands,2,0,Friendly,in Iceland,4,-4,1439,1219,0,-2,102,154,1435,1223,T1
2474,August 15,2012,Iran,Tunisia,2,2,Friendly,in Hungary,-3,3,1714,1614,0,1,33,57,1717,1611,draw
2475,August 15,2012,Jamaica,El Salvador,2,0,Friendly,in the United States,12,-12,1645,1562,4,-3,49,72,1633,1574,T1
2476,August 15,2012,Japan,Venezuela,1,1,Friendly,in Japan,-5,5,1794,1699,-3,-2,21,40,1799,1694,draw
2477,August 15,2012,Jordan,Uzbekistan,2,0,Friendly,in Jordan,14,-14,1550,1592,4,-5,75,65,1536,1606,T1
2478,August 15,2012,Libya,Ethiopia,2,1,Friendly,in Libya,2,-2,1607,1332,0,-1,61,124,1605,1334,T1
2479,August 15,2012,Luxembourg,Georgia,1,2,Friendly,in Luxembourg,-4,4,1146,1500,0,1,168,88,1150,1496,T2
2480,August 15,2012,Macedonia,Lithuania,1,0,Friendly,in Macedonia,7,-7,1502,1470,3,0,87,94,1495,1477,T1
2481,August 15,2012,Mexico,United States,0,1,Friendly,in Mexico,-16,16,1886,1762,0,3,11,26,1902,1746,T2
2482,August 15,2012,Montenegro,Latvia,2,0,Friendly,in Montenegro,7,-7,1653,1538,0,-3,48,78,1646,1545,T1
2483,August 15,2012,Morocco,Guinea,1,2,Friendly,in Morocco,-15,15,1596,1556,-5,5,63,73,1611,1541,T2
2484,August 15,2012,Niger,Nigeria,0,0,Friendly,in Niger,6,-6,1300,1639,1,-3,135,52,1294,1645,draw
2485,August 15,2012,Norway,Greece,2,3,Friendly,in Norway,-12,12,1748,1791,-1,2,29,22,1760,1779,T2
2486,August 15,2012,Northern Ireland,Finland,3,3,Friendly,in Northern Ireland,2,-2,1451,1625,1,1,98,54,1449,1627,draw
2487,August 15,2012,Oman,Egypt,1,1,Friendly,in Oman,2,-2,1553,1710,-1,0,74,36,1551,1712,draw
2488,August 15,2012,Portugal,Panama,2,0,Friendly,in Portugal,4,-4,1946,1712,1,0,7,34,1942,1716,T1
2489,August 15,2012,Puerto Rico,Spain,1,2,Friendly,in Puerto Rico,0,0,1076,2155,0,0,182,1,1076,2155,T2
2490,August 15,2012,Russia,Ivory Coast,1,1,Friendly,in Russia,-4,4,1843,1802,0,1,15,18,1847,1798,draw
2491,August 15,2012,Scotland,Australia,3,1,Friendly,in Scotland,15,-15,1709,1783,1,-6,37,25,1694,1798,T1
2492,August 15,2012,Serbia,Ireland,0,0,Friendly,in Serbia,-2,2,1711,1739,0,0,35,30,1713,1737,draw
2493,August 15,2012,Singapore,Hong Kong,2,0,Friendly,in Singapore,9,-9,1248,1191,1,-2,147,159,1239,1200,T1
2494,August 15,2012,Slovenia,Romania,4,3,Friendly,in Slovenia,9,-9,1665,1720,1,-1,45,32,1656,1729,T1
2495,August 15,2012,South Korea,Zambia,2,1,Friendly,in South Korea,3,-3,1803,1609,0,-3,17,60,1800,1612,T1
2496,August 15,2012,Sweden,Brazil,0,3,Friendly,in Sweden,-15,15,1874,2059,0,1,12,2,1889,2044,T2
2497,August 15,2012,Ukraine,Czechia,0,0,Friendly,in Ukraine,-1,1,1727,1790,1,-1,31,23,1728,1789,draw
2498,August 15,2012,Wales,Bosnia and Herzegovina,0,2,Friendly,in Wales,-17,17,1613,1699,-5,2,59,40,1630,1682,T2
2499,August 22,2012,India,Syria,2,1,Nehru Gold Cup,in India,35,-35,1161,1539,9,-7,164,77,1126,1574,T1
2500,August 23,2012,Maldives,Nepal,2,1,Nehru Gold Cup,in India,12,-12,1089,908,1,-1,180,199,1077,920,T1
2501,August 25,2012,India,Maldives,3,0,Nehru Gold Cup,in India,19,-19,1180,1070,4,-2,160,182,1161,1089,T1
2502,August 26,2012,Botswana,Uganda,0,0,Friendly,in Botswana,3,-3,1330,1515,1,0,126,85,1327,1518,draw
2503,August 26,2012,Libya,Sudan,3,0,Friendly,in Tunisia,11,-11,1618,1468,4,-1,57,94,1607,1479,T1
2504,August 27,2012,Maldives,Syria,2,1,Nehru Gold Cup,in India,37,-37,1107,1502,5,-9,177,86,1070,1539,T1
2505,August 28,2012,India,Nepal,0,0,Nehru Gold Cup,in India,-16,16,1164,924,-3,1,163,198,1180,908,draw
2506,August 30,2012,Syria,Nepal,2,0,Nehru Gold Cup,in India,2,-2,1504,922,0,0,86,198,1502,924,T1
2507,September 1,2012,Saint Vincent and the Grenadines,Barbados,2,0,Friendly,in Saint Vincent and the Grenadines,11,-11,1168,1142,5,-3,161,170,1157,1153,T1
2508,September 2,2012,Saint Vincent and the Grenadines,Barbados,1,1,Friendly,in Saint Vincent and the Grenadines,-3,3,1165,1145,-1,1,162,169,1168,1142,draw
2509,September 4,2012,Liberia,Malawi,1,0,Friendly,in Liberia,11,-11,1280,1406,1,-2,141,107,1269,1417,T1
2510,September 5,2012,Cambodia,Philippines,0,0,Friendly,in Cambodia,6,-6,783,1121,0,-1,211,174,777,1127,draw
2511,September 5,2012,Jordan,Iran,0,0,Friendly,in Jordan,2,-2,1552,1712,0,0,74,33,1550,1714,draw
2512,September 5,2012,Martinique,British Virgin Islands,16,0,CONCACAF Champ &amp; Carib Champ qual,in Martinique,3,-3,1350,764,1,-1,117,213,1347,767,T1
2513,September 5,2012,Suriname,Montserrat,7,1,CONCACAF Champ &amp; Carib Champ qual,in Martinique,2,-2,1194,511,0,0,158,233,1192,513,T1
2514,September 6,2012,Japan,United Arab Emirates,1,0,Friendly,in Japan,1,-1,1795,1420,1,0,20,104,1794,1421,T1
2515,September 6,2012,Lebanon,Australia,0,3,Friendly,in Lebanon,-3,3,1281,1786,0,0,140,25,1284,1783,T2
2516,September 6,2012,Sweden,China,1,0,Friendly,in Sweden,3,-3,1877,1633,0,0,12,53,1874,1636,T1
2517,September 6,2012,Tajikistan,Qatar,2,1,Friendly,in Germany,17,-17,1247,1491,2,-6,148,91,1230,1508,T1
2518,September 7,2012,Albania,Cyprus,3,1,World Cup qualifier,in Albania,19,-19,1517,1446,5,-4,83,99,1498,1465,T1
2519,September 7,2012,Andorra,Hungary,0,5,World Cup qualifier,in Andorra,-3,3,1000,1688,0,1,188,41,1003,1685,T2
2520,September 7,2012,Argentina,Paraguay,3,1,World Cup qualifier,in Argentina,8,-8,1987,1751,0,1,5,26,1979,1759,T1
2521,September 7,2012,Azerbaijan,Israel,1,1,World Cup qualifier,in Azerbaijan,9,-9,1404,1646,3,-1,108,48,1395,1655,draw
2522,September 7,2012,Brazil,South Africa,1,0,Friendly,in Brazil,1,-1,2060,1574,0,2,2,67,2059,1575,T1
2523,September 7,2012,Bulgaria,Italy,2,2,World Cup qualifier,in Bulgaria,9,-9,1652,1901,4,-2,46,11,1643,1910,draw
2524,September 7,2012,Canada,Panama,1,0,World Cup qualifier,in Canada,21,-21,1622,1691,6,-7,56,40,1601,1712,T1
2525,September 7,2012,Colombia,Uruguay,4,0,World Cup qualifier,in Colombia,46,-46,1841,1929,4,-2,16,8,1795,1975,T1
2526,September 7,2012,Costa Rica,Mexico,0,2,World Cup qualifier,in Costa Rica,-20,20,1642,1906,-3,1,49,10,1662,1886,T2
2527,September 7,2012,Croatia,Macedonia,1,0,World Cup qualifier,in Croatia,3,-3,1868,1499,0,-2,13,88,1865,1502,T1
2528,September 7,2012,Cuba,Honduras,0,3,World Cup qualifier,in Cuba,-21,21,1347,1642,-4,7,119,49,1368,1621,T2
2529,September 7,2012,Ecuador,Bolivia,1,0,World Cup qualifier,in Ecuador,5,-5,1815,1572,-2,-2,18,69,1810,1577,T1
2530,September 7,2012,El Salvador,Guyana,2,2,World Cup qualifier,in El Salvador,-15,15,1547,1358,-4,6,75,115,1562,1343,draw
2531,September 7,2012,Estonia,Romania,0,2,World Cup qualifier,in Estonia,-23,23,1511,1743,-8,3,86,29,1534,1720,T2
2532,September 7,2012,Finland,France,0,1,World Cup qualifier,in Finland,-13,13,1612,1868,-5,1,59,13,1625,1855,T2
2533,September 7,2012,Georgia,Belarus,1,0,World Cup qualifier,in Georgia,20,-20,1520,1573,5,-4,82,68,1500,1593,T1
2534,September 7,2012,Germany,Faroe Islands,3,0,World Cup qualifier,in Germany,0,0,2038,1219,0,0,3,154,2038,1219,T1
2535,September 7,2012,Guatemala,Antigua and Barbuda,3,1,World Cup qualifier,in Guatemala,8,-8,1530,1290,1,-2,79,138,1522,1298,T1
2536,September 7,2012,Haiti,Saint Martin,7,0,CONCACAF Champ &amp; Carib Champ qual,in Haiti,2,-2,1419,885,0,0,105,205,1417,887,T1
2537,September 7,2012,Iceland,Norway,2,0,World Cup qualifier,in Iceland,46,-46,1485,1702,10,-10,92,39,1439,1748,T1
2538,September 7,2012,Jamaica,United States,2,1,World Cup qualifier,in Jamaica,21,-21,1666,1741,4,-4,45,30,1645,1762,T1
2539,September 7,2012,Kazakhstan,Ireland,1,2,World Cup qualifier,in Kazakhstan,-6,6,1339,1745,-1,3,121,27,1345,1739,T2
2540,September 7,2012,Latvia,Greece,1,2,World Cup qualifier,in Latvia,-12,12,1526,1803,-3,3,80,19,1538,1791,T2
2541,September 7,2012,Liechtenstein,Bosnia and Herzegovina,1,8,World Cup qualifier,in Liechtenstein,-10,10,1220,1709,-2,3,153,37,1230,1699,T2
2542,September 7,2012,Lithuania,Slovakia,1,1,World Cup qualifier,in Lithuania,3,-3,1473,1611,-1,-2,94,60,1470,1614,draw
2543,September 7,2012,Luxembourg,Portugal,1,2,World Cup qualifier,in Luxembourg,-1,1,1145,1947,0,0,168,7,1146,1946,T2
2544,September 7,2012,Malta,Armenia,0,1,World Cup qualifier,in Malta,-10,10,1232,1541,0,1,149,78,1242,1531,T2
2545,September 7,2012,Martinique,Montserrat,5,0,CONCACAF Champ &amp; Carib Champ qual,in Martinique,0,0,1350,511,0,0,117,233,1350,511,T1
2546,September 7,2012,Moldova,England,0,5,World Cup qualifier,in Moldova,-5,5,1400,1992,-2,0,110,4,1405,1987,T2
2547,September 7,2012,Montenegro,Poland,2,2,World Cup qualifier,in Montenegro,-4,4,1649,1688,1,2,47,41,1653,1684,draw
2548,September 7,2012,Netherlands,Turkey,2,0,World Cup qualifier,in the Netherlands,10,-10,1954,1745,2,1,6,27,1944,1755,T1
2549,September 7,2012,New Caledonia,New Zealand,0,2,World Cup qualifier,in New Caledonia,-23,23,1314,1544,-7,6,129,76,1337,1521,T2
2550,September 7,2012,Peru,Venezuela,2,1,World Cup qualifier,in Peru,14,-14,1720,1685,5,-3,33,43,1706,1699,T1
2551,September 7,2012,Puerto Rico,Bermuda,2,1,CONCACAF Champ &amp; Carib Champ qual,in Haiti,27,-27,1103,1182,1,-4,181,159,1076,1209,T1
2552,September 7,2012,Russia,Northern Ireland,2,0,World Cup qualifier,in Russia,3,-3,1846,1448,0,0,15,98,1843,1451,T1
2553,September 7,2012,Singapore,Philippines,0,2,Friendly,in Singapore,-24,24,1224,1145,-3,6,150,168,1248,1121,T2
2554,September 7,2012,Slovenia,Switzerland,0,2,World Cup qualifier,in Slovenia,-28,28,1637,1816,-8,7,53,17,1665,1788,T2
2555,September 7,2012,Solomon Islands,Tahiti,2,0,World Cup qualifier,in the Solomon Islands,28,-28,1278,1298,2,-7,143,135,1250,1326,T1
2556,September 7,2012,Spain,Saudi Arabia,5,0,Friendly,in Spain,1,-1,2156,1497,0,-1,1,89,2155,1498,T1
2557,September 7,2012,Suriname,British Virgin Islands,4,0,CONCACAF Champ &amp; Carib Champ qual,in Martinique,6,-6,1200,758,2,0,156,213,1194,764,T1
2558,September 7,2012,Uzbekistan,Kuwait,3,0,Friendly,in Uzbekistan,10,-10,1602,1512,3,-5,62,85,1592,1522,T1
2559,September 7,2012,Wales,Belgium,0,2,World Cup qualifier,in Wales,-31,31,1582,1735,-5,8,65,31,1613,1704,T2
2560,September 8,2012,Cape Verde,Cameroon,2,0,African Nations Cup qualifier,in Cape Verde,42,-42,1439,1598,9,-11,102,62,1397,1640,T1
2561,September 8,2012,Central African Republic,Burkina Faso,1,0,African Nations Cup qualifier,in Central African Republic,22,-22,1326,1418,8,-4,125,106,1304,1440,T1
2562,September 8,2012,Denmark,Czechia,0,0,World Cup qualifier,in Denmark,-6,6,1790,1796,-2,2,24,22,1796,1790,draw
2563,September 8,2012,Gabon,Togo,1,1,African Nations Cup qualifier,in Gabon,-15,15,1553,1361,-1,5,71,115,1568,1346,draw
2564,September 8,2012,Ghana,Malawi,2,0,African Nations Cup qualifier,in Ghana,6,-6,1688,1400,3,-3,41,110,1682,1406,T1
2565,September 8,2012,Ivory Coast,Senegal,4,2,African Nations Cup qualifier,in Ivory Coast,7,-7,1809,1542,2,-2,19,76,1802,1549,T1
2566,September 8,2012,Liberia,Nigeria,2,2,African Nations Cup qualifier,in Liberia,13,-13,1293,1626,4,-1,137,53,1280,1639,draw
2567,September 8,2012,Mali,Botswana,3,0,African Nations Cup qualifier,in Mali,8,-8,1585,1322,1,-1,65,126,1577,1330,T1
2568,September 8,2012,Scotland,Serbia,0,0,World Cup qualifier,in Scotland,-5,5,1704,1716,-1,1,38,34,1709,1711,draw
2569,September 8,2012,Sierra Leone,Tunisia,2,2,African Nations Cup qualifier,in Sierra Leone,10,-10,1344,1604,1,-2,121,60,1334,1614,draw
2570,September 8,2012,Saint Barthélemy,Guadeloupe,1,8,Friendly,in Saint Barthélemy,-1,1,694,1444,0,0,218,100,695,1443,T2
2571,September 8,2012,Sudan,Ethiopia,5,3,African Nations Cup qualifier,in Sudan,12,-12,1480,1320,2,-4,93,127,1468,1332,T1
2572,September 8,2012,Zambia,Uganda,1,0,African Nations Cup qualifier,in Zambia,10,-10,1619,1505,5,-2,56,86,1609,1515,T1
2573,September 9,2012,Algeria,Libya,1,0,African Nations Cup qualifier,in Morocco,25,-25,1546,1593,6,-5,75,62,1521,1618,T1
2574,September 9,2012,Democratic Republic of Congo,Equatorial Guinea,4,0,African Nations Cup qualifier,in the Democratic Republic of the Congo,13,-13,1475,1272,2,-3,94,143,1462,1285,T1
2575,September 9,2012,Guinea,Niger,1,0,African Nations Cup qualifier,in Guinea,5,-5,1561,1295,1,-1,69,135,1556,1300,T1
2576,September 9,2012,Haiti,Bermuda,3,1,CONCACAF Champ &amp; Carib Champ qual,in Haiti,8,-8,1427,1174,2,0,103,159,1419,1182,T1
2577,September 9,2012,Martinique,Suriname,2,2,CONCACAF Champ &amp; Carib Champ qual,in Martinique,-12,12,1338,1212,-5,1,123,155,1350,1200,draw
2578,September 9,2012,Montserrat,British Virgin Islands,7,0,CONCACAF Champ &amp; Carib Champ qual,in Martinique,73,-73,584,685,5,-6,228,219,511,758,T1
2579,September 9,2012,Mozambique,Morocco,2,0,African Nations Cup qualifier,in Mozambique,45,-45,1350,1551,14,-10,119,73,1305,1596,T1
2580,September 9,2012,Puerto Rico,Saint Martin,9,0,CONCACAF Champ &amp; Carib Champ qual,in Haiti,22,-22,1125,863,7,-1,174,206,1103,885,T1
2581,September 9,2012,Zimbabwe,Angola,3,1,African Nations Cup qualifier,in Zimbabwe,34,-34,1382,1463,6,-7,113,96,1348,1497,T1
2582,September 10,2012,Brazil,China,8,0,Friendly,in Brazil,2,-2,2062,1631,0,0,2,52,2060,1633,T1
2583,September 10,2012,Indonesia,North Korea,0,2,Friendly,in Indonesia,-8,8,1256,1550,-1,3,145,74,1264,1542,T2
2584,September 10,2012,Laos,Philippines,2,1,Friendly,in Laos,15,-15,857,1130,1,-3,207,171,842,1145,T1
2585,September 11,2012,Antigua and Barbuda,Guatemala,0,1,World Cup qualifier,in Antigua and Barbuda,-12,12,1278,1542,-1,2,140,78,1290,1530,T2
2586,September 11,2012,Austria,Germany,1,2,World Cup qualifier,in Austria,-6,6,1617,2044,-2,0,56,3,1623,2038,T2
2587,September 11,2012,Belgium,Croatia,1,1,World Cup qualifier,in Belgium,2,-2,1737,1866,0,-2,31,15,1735,1868,draw
2588,September 11,2012,Bermuda,Saint Martin,8,0,CONCACAF Champ &amp; Carib Champ qual,in Haiti,14,-14,1188,849,0,-2,159,208,1174,863,T1
2589,September 11,2012,Bosnia and Herzegovina,Latvia,4,1,World Cup qualifier,in Bosnia and Herzegovina,11,-11,1720,1515,2,-1,35,82,1709,1526,T1
2590,September 11,2012,Bulgaria,Armenia,1,0,World Cup qualifier,in Bulgaria,9,-9,1661,1532,1,-1,45,80,1652,1541,T1
2591,September 11,2012,Chile,Colombia,1,3,World Cup qualifier,in Chile,-43,43,1866,1884,-6,5,15,11,1909,1841,T2
2592,September 11,2012,Cyprus,Iceland,1,0,World Cup qualifier,in Cyprus,17,-17,1463,1468,3,-3,96,94,1446,1485,T1
2593,September 11,2012,Czechia,Finland,0,1,Friendly,in Czechia,-17,17,1779,1629,-2,6,24,51,1796,1612,T2
2594,September 11,2012,England,Ukraine,1,1,World Cup qualifier,in England,-16,16,1976,1743,-1,2,5,30,1992,1727,draw
2595,September 11,2012,France,Belarus,3,1,World Cup qualifier,in France,6,-6,1874,1567,0,-1,13,68,1868,1573,T1
2596,September 11,2012,Gabon,Saudi Arabia,1,0,Friendly,in France,8,-8,1561,1489,-1,-1,71,90,1553,1497,T1
2597,September 11,2012,Georgia,Spain,0,1,World Cup qualifier,in Georgia,-2,2,1518,2158,1,0,81,1,1520,2156,T2
2598,September 11,2012,Greece,Lithuania,2,0,World Cup qualifier,in Greece,5,-5,1808,1468,0,1,20,94,1803,1473,T1
2599,September 11,2012,Guyana,El Salvador,2,3,World Cup qualifier,in Guyana,-15,15,1343,1562,-4,5,121,70,1358,1547,T2
2600,September 11,2012,Haiti,Puerto Rico,2,1,CONCACAF Champ &amp; Carib Champ qual,in Haiti,4,-4,1431,1121,-1,-1,104,175,1427,1125,T1
2601,September 11,2012,Honduras,Cuba,1,0,World Cup qualifier,in Honduras,4,-4,1646,1343,1,-1,48,121,1642,1347,T1
2602,September 11,2012,Hungary,Netherlands,1,4,World Cup qualifier,in Hungary,-19,19,1669,1973,-2,0,43,6,1688,1954,T2
2603,September 11,2012,Ireland,Oman,4,1,Friendly,in England,9,-9,1754,1544,1,-7,26,77,1745,1553,T1
2604,September 11,2012,Israel,Russia,0,4,World Cup qualifier,in Israel,-27,27,1619,1873,-6,1,54,14,1646,1846,T2
2605,September 11,2012,Italy,Malta,2,0,World Cup qualifier,in Italy,1,-1,1902,1231,1,0,10,149,1901,1232,T1
2606,September 11,2012,Japan,Iraq,1,0,World Cup qualifier,in Japan,6,-6,1801,1586,2,0,21,63,1795,1592,T1
2607,September 11,2012,Jordan,Australia,2,1,World Cup qualifier,in Jordan,27,-27,1579,1759,7,0,65,25,1552,1786,T1
2608,September 11,2012,Lebanon,Iran,1,0,World Cup qualifier,in Lebanon,35,-35,1316,1677,8,-7,132,42,1281,1712,T1
2609,September 11,2012,Liberia,Ghana,2,0,Friendly,in Liberia,25,-25,1318,1663,6,-3,131,44,1293,1688,T1
2610,September 11,2012,Malaysia,Vietnam,0,2,Friendly,in Malaysia,-16,16,1206,1308,-4,3,155,135,1222,1292,T2
2611,September 11,2012,Mexico,Costa Rica,1,0,World Cup qualifier,in Mexico,4,-4,1910,1638,1,0,9,49,1906,1642,T1
2612,September 11,2012,Myanmar,Singapore,1,1,Friendly,in Myanmar,3,-3,1016,1221,0,-1,186,151,1013,1224,draw
2613,September 11,2012,New Zealand,Solomon Islands,6,1,World Cup qualifier,in New Zealand,9,-9,1553,1269,4,0,73,142,1544,1278,T1
2614,September 11,2012,Norway,Slovenia,2,1,World Cup qualifier,in Norway,11,-11,1713,1626,3,-1,36,52,1702,1637,T1
2615,September 11,2012,Northern Ireland,Luxembourg,1,1,World Cup qualifier,in Northern Ireland,-16,16,1432,1161,-5,2,103,166,1448,1145,draw
2616,September 11,2012,Panama,Canada,2,0,World Cup qualifier,in Panama,16,-16,1707,1606,1,-4,39,59,1691,1622,T1
2617,September 11,2012,Paraguay,Venezuela,0,2,World Cup qualifier,in Paraguay,-43,43,1708,1728,-12,10,38,34,1751,1685,T2
2618,September 11,2012,Peru,Argentina,1,1,World Cup qualifier,in Peru,9,-9,1729,1978,0,1,33,4,1720,1987,draw
2619,September 11,2012,Poland,Moldova,2,0,World Cup qualifier,in Poland,6,-6,1694,1394,1,-1,40,111,1688,1400,T1
2620,September 11,2012,Portugal,Azerbaijan,3,0,World Cup qualifier,in Portugal,2,-2,1949,1402,0,-1,7,109,1947,1404,T1
2621,September 11,2012,Romania,Andorra,4,0,World Cup qualifier,in Romania,1,-1,1744,999,0,0,29,188,1743,1000,T1
2622,September 11,2012,San Marino,Montenegro,0,6,World Cup qualifier,in San Marino,-2,2,889,1651,0,0,204,47,891,1649,T2
2623,September 11,2012,Scotland,Macedonia,1,1,World Cup qualifier,in Scotland,-14,14,1690,1513,-3,5,41,83,1704,1499,draw
2624,September 11,2012,Serbia,Wales,6,1,World Cup qualifier,in Serbia,17,-17,1733,1565,2,-4,32,69,1716,1582,T1
2625,September 11,2012,Slovakia,Liechtenstein,2,0,World Cup qualifier,in Slovakia,3,-3,1614,1217,1,0,57,153,1611,1220,T1
2626,September 11,2012,South Africa,Mozambique,2,0,Friendly,in South Africa,4,-4,1578,1346,0,0,66,119,1574,1350,T1
2627,September 11,2012,Sweden,Kazakhstan,2,0,World Cup qualifier,in Sweden,1,-1,1878,1338,0,-1,12,123,1877,1339,T1
2628,September 11,2012,Switzerland,Albania,2,0,World Cup qualifier,in Switzerland,5,-5,1821,1512,-1,-1,18,84,1816,1517,T1
2629,September 11,2012,Tahiti,New Caledonia,0,4,World Cup qualifier,in Tahiti,-46,46,1252,1360,-11,14,145,117,1298,1314,T2
2630,September 11,2012,Turkey,Estonia,3,0,World Cup qualifier,in Turkey,9,-9,1754,1502,1,-2,26,87,1745,1511,T1
2631,September 11,2012,United Arab Emirates,Kuwait,3,0,Friendly,in the United Arab Emirates,17,-17,1437,1495,3,-4,102,88,1420,1512,T1
2632,September 11,2012,Uruguay,Ecuador,1,1,World Cup qualifier,in Uruguay,-11,11,1918,1826,0,1,8,17,1929,1815,draw
2633,September 11,2012,United States,Jamaica,1,0,World Cup qualifier,in the United States,11,-11,1752,1655,2,-1,28,46,1741,1666,T1
2634,September 11,2012,Uzbekistan,South Korea,2,2,World Cup qualifier,in Uzbekistan,6,-6,1608,1797,2,-2,58,22,1602,1803,draw
2635,September 12,2012,Thailand,Laos,2,1,Friendly,in Thailand,1,-1,1377,856,0,0,115,206,1376,857,T1
2636,September 15,2012,Indonesia,Vietnam,0,0,Friendly,in Indonesia,-1,1,1255,1309,0,0,144,135,1256,1308,draw
2637,September 15,2012,Mauritius,Réunion,1,1,Friendly,in Mauritius,5,-5,1027,1326,0,-1,184,126,1022,1331,draw
2638,September 16,2012,French Guiana,Haiti,1,2,Friendly,in French Guiana,-6,6,1193,1437,0,2,157,102,1199,1431,T2
2639,September 19,2012,Brazil,Argentina,2,1,Friendly tournament,in Brazil,8,-8,2070,1970,0,-2,2,6,2062,1978,T1
2640,September 20,2012,Malaysia,Cambodia,3,0,Friendly,in Malaysia,2,-2,1208,781,0,0,155,211,1206,783,T1
2641,September 20,2012,Nepal,Bangladesh,1,1,Friendly,in Nepal,-2,2,920,950,0,0,198,194,922,948,draw
2642,September 22,2012,Guadeloupe,Saint Pierre and Miquelon,13,0,French Territory Cup,in France,1,-1,1445,687,0,0,99,218,1444,688,T1
2643,September 22,2012,Martinique,New Caledonia,2,0,French Territory Cup,in France,24,-24,1362,1336,7,-8,116,125,1338,1360,T1
2644,September 22,2012,Mayotte,Tahiti,3,1,French Territory Cup,in France,28,-28,1193,1224,5,-4,157,149,1165,1252,T1
2645,September 22,2012,Réunion,French Guiana,2,0,French Territory Cup,in France,14,-14,1340,1179,3,-3,123,160,1326,1193,T1
2646,September 23,2012,Aruba,Dominican Republic,2,2,CONCACAF Champ &amp; Carib Champ qual,in Barbados,7,-7,1006,1122,0,-1,188,174,999,1129,draw
2647,September 23,2012,Barbados,Dominica,1,0,CONCACAF Champ &amp; Carib Champ qual,in Barbados,9,-9,1154,1012,1,-1,168,186,1145,1021,T1
2648,September 24,2012,Guadeloupe,French Guiana,4,2,French Territory Cup,in France,8,-8,1453,1171,0,-1,99,161,1445,1179,T1
2649,September 24,2012,Mayotte,New Caledonia,2,0,French Territory Cup,in France,31,-31,1224,1305,7,-11,150,136,1193,1336,T1
2650,September 24,2012,Réunion,Saint Pierre and Miquelon,10,0,French Territory Cup,in France,2,-2,1342,685,1,0,122,218,1340,687,T1
2651,September 24,2012,Tahiti,Martinique,3,2,French Territory Cup,in France,21,-21,1245,1341,2,-7,147,123,1224,1362,T1
2652,September 25,2012,Barbados,Dominican Republic,0,1,CONCACAF Champ &amp; Carib Champ qual,in Barbados,-27,27,1127,1149,-5,5,173,169,1154,1122,T2
2653,September 25,2012,Dominica,Aruba,3,2,CONCACAF Champ &amp; Carib Champ qual,in Barbados,20,-20,1032,986,2,-2,184,190,1012,1006,T1
2654,September 25,2012,Macao,Taiwan,2,2,Friendly tournament,in the Philippines,9,-9,659,892,1,-2,223,203,650,901,draw
2655,September 25,2012,Philippines,Guam,1,0,Friendly tournament,in the Philippines,1,-1,1131,656,0,-1,171,224,1130,657,T1
2656,September 26,2012,Brunei,Indonesia,0,5,Friendly,in Brunei,-2,2,648,1257,0,-1,225,145,650,1255,T2
2657,September 26,2012,French Guiana,Saint Pierre and Miquelon,11,1,French Territory Cup,in France,5,-5,1176,680,1,-3,160,221,1171,685,T1
2658,September 26,2012,Martinique,Mayotte,3,0,French Territory Cup,in France,18,-18,1359,1206,5,-6,118,156,1341,1224,T1
2659,September 26,2012,Réunion,Guadeloupe,2,1,French Territory Cup,in France,20,-20,1362,1433,6,-4,116,103,1342,1453,T1
2660,September 26,2012,Tahiti,New Caledonia,1,0,French Territory Cup,in France,18,-18,1263,1287,4,-2,143,138,1245,1305,T1
2661,September 27,2012,Barbados,Aruba,2,1,CONCACAF Champ &amp; Carib Champ qual,in Barbados,8,-8,1135,978,2,-1,171,191,1127,986,T1
2662,September 27,2012,Dominican Republic,Dominica,2,1,CONCACAF Champ &amp; Carib Champ qual,in Barbados,14,-14,1163,1018,3,-1,166,185,1149,1032,T1
2663,September 27,2012,Philippines,Macao,5,0,Friendly tournament,in the Philippines,2,-2,1133,657,-1,0,172,223,1131,659,T1
2664,September 27,2012,Taiwan,Guam,2,0,Friendly tournament,in the Philippines,9,-9,901,647,2,-1,201,225,892,656,T1
2665,September 28,2012,French Guiana,Tahiti,2,1,French Territory Cup,in France,19,-19,1195,1244,2,-4,158,147,1176,1263,T1
2666,September 28,2012,New Caledonia,Saint Pierre and Miquelon,16,1,French Territory Cup,in France,3,-3,1290,677,0,0,138,221,1287,680,T1
2667,September 28,2012,Oman,Yemen,2,1,Friendly,in Oman,3,-3,1547,1312,1,0,76,132,1544,1315,T1
2668,September 29,2012,Guadeloupe,Mayotte,1,0,French Territory Cup,in France,6,-6,1439,1200,3,-1,100,157,1433,1206,T1
2669,September 29,2012,Guam,Macao,3,0,Friendly tournament,in the Philippines,27,-27,674,630,2,-3,223,226,647,657,T1
2670,September 29,2012,Martinique,Réunion,2,2,French Territory Cup,in France,0,0,1359,1362,0,0,118,116,1359,1362,draw
2671,September 29,2012,Philippines,Taiwan,3,1,Friendly tournament,in the Philippines,6,-6,1139,895,1,0,171,201,1133,901,T1
2672,October 5,2012,East Timor,Cambodia,5,1,Southeast Asian Championship qualifier,in Myanmar,61,-61,586,720,5,-2,228,213,525,781,T1
2673,October 5,2012,Myanmar,Brunei,1,0,Southeast Asian Championship qualifier,in Myanmar,3,-3,1019,645,1,0,185,224,1016,648,T1
2674,October 7,2012,Laos,Cambodia,1,0,Southeast Asian Championship qualifier,in Myanmar,13,-13,869,707,1,0,205,213,856,720,T1
2675,October 7,2012,Myanmar,East Timor,2,1,Southeast Asian Championship qualifier,in Myanmar,2,-2,1021,584,0,0,185,228,1019,586,T1
2676,October 8,2012,Qatar,Jordan,1,1,Friendly,in Qatar,0,0,1491,1579,0,0,89,65,1491,1579,draw
2677,October 9,2012,Brunei,Cambodia,3,2,Southeast Asian Championship qualifier,in Myanmar,24,-24,669,683,0,-6,224,219,645,707,T1
2678,October 9,2012,East Timor,Laos,3,1,Southeast Asian Championship qualifier,in Myanmar,50,-50,634,819,3,-4,225,209,584,869,T1
2679,October 9,2012,Niger,Liberia,4,3,Friendly,in Niger,8,-8,1303,1310,0,-3,136,133,1295,1318,T1
2680,October 9,2012,Qatar,Oman,1,1,Friendly,in Qatar,-1,1,1490,1548,0,0,89,76,1491,1547,draw
2681,October 10,2012,Saint Kitts and Nevis,Anguilla,2,0,CONCACAF Champ &amp; Carib Champ qual,in Saint Kitts and Nevis,1,-1,1206,565,0,0,156,230,1205,566,T1
2682,October 10,2012,Trinidad and Tobago,French Guiana,4,1,CONCACAF Champ &amp; Carib Champ qual,in Saint Kitts and Nevis,11,-11,1491,1184,2,-2,89,160,1480,1195,T1
2683,October 11,2012,Brazil,Iraq,6,0,Friendly,in Sweden,2,-2,2072,1584,0,-1,2,64,2070,1586,T1
2684,October 11,2012,Kuwait,Syria,1,1,Friendly,in Kuwait,-3,3,1492,1507,0,1,88,85,1495,1504,draw
2685,October 11,2012,Laos,Brunei,3,1,Southeast Asian Championship qualifier,in Myanmar,18,-18,837,651,1,0,208,224,819,669,T1
2686,October 11,2012,Myanmar,Cambodia,3,0,Southeast Asian Championship qualifier,in Myanmar,5,-5,1026,678,0,-1,185,220,1021,683,T1
2687,October 12,2012,Albania,Iceland,1,2,World Cup qualifier,in Albania,-28,28,1484,1496,-9,7,93,87,1512,1468,T2
2688,October 12,2012,Antigua and Barbuda,United States,1,2,World Cup qualifier,in Antigua and Barbuda,-4,4,1274,1756,0,0,140,28,1278,1752,T2
2689,October 12,2012,Argentina,Uruguay,3,0,World Cup qualifier,in Argentina,21,-21,1991,1897,2,-2,4,10,1970,1918,T1
2690,October 12,2012,Armenia,Italy,1,3,World Cup qualifier,in Armenia,-10,10,1522,1912,-1,1,81,9,1532,1902,T2
2691,October 12,2012,Bahrain,Philippines,0,0,Friendly,in Bahrain,-8,8,1435,1147,-4,1,103,170,1443,1139,draw
2692,October 12,2012,Belarus,Spain,0,4,World Cup qualifier,in Belarus,-4,4,1563,2162,-2,0,70,1,1567,2158,T2
2693,October 12,2012,Bolivia,Peru,1,1,World Cup qualifier,in Bolivia,3,-3,1575,1726,0,-1,67,34,1572,1729,draw
2694,October 12,2012,Bulgaria,Denmark,1,1,World Cup qualifier,in Bulgaria,2,-2,1663,1788,1,0,44,23,1661,1790,draw
2695,October 12,2012,Canada,Cuba,3,0,World Cup qualifier,in Canada,8,-8,1614,1335,2,-3,57,125,1606,1343,T1
2696,October 12,2012,Colombia,Paraguay,2,0,World Cup qualifier,in Colombia,10,-10,1894,1698,0,1,11,37,1884,1708,T1
2697,October 12,2012,Czechia,Malta,3,1,World Cup qualifier,in Czechia,1,-1,1780,1230,-1,2,25,147,1779,1231,T1
2698,October 12,2012,Ecuador,Chile,3,1,World Cup qualifier,in Ecuador,25,-25,1851,1841,1,-2,16,17,1826,1866,T1
2699,October 12,2012,Egypt,Congo,3,0,Friendly,in the United Arab Emirates,5,-5,1715,1389,1,-1,36,112,1710,1394,T1
2700,October 12,2012,El Salvador,Costa Rica,0,1,World Cup qualifier,in El Salvador,-21,21,1541,1659,-9,3,79,46,1562,1638,T2
2701,October 12,2012,England,San Marino,5,0,World Cup qualifier,in England,0,0,1976,889,-1,0,5,204,1976,889,T1
2702,October 12,2012,Estonia,Hungary,0,1,World Cup qualifier,in Estonia,-16,16,1486,1685,-4,2,91,41,1502,1669,T2
2703,October 12,2012,Faroe Islands,Sweden,1,2,World Cup qualifier,in the Faroe Islands,-2,2,1217,1880,0,-1,152,13,1219,1878,T2
2704,October 12,2012,Finland,Georgia,1,1,World Cup qualifier,in Finland,-11,11,1618,1529,-5,1,56,80,1629,1518,draw
2705,October 12,2012,France,Japan,0,1,Friendly,in France,-15,15,1859,1816,-2,3,15,18,1874,1801,T2
2706,October 12,2012,French Guiana,Anguilla,4,1,CONCACAF Champ &amp; Carib Champ qual,in Saint Kitts and Nevis,2,-2,1186,563,0,-1,160,231,1184,565,T1
2707,October 12,2012,Greece,Bosnia and Herzegovina,0,0,World Cup qualifier,in Greece,-10,10,1798,1730,-1,4,21,31,1808,1720,draw
2708,October 12,2012,Guatemala,Jamaica,2,1,World Cup qualifier,in Guatemala,21,-21,1563,1634,8,-3,70,49,1542,1655,T1
2709,October 12,2012,Ireland,Germany,1,6,World Cup qualifier,in Ireland,-20,20,1734,2064,-3,0,29,3,1754,2044,T2
2710,October 12,2012,Kazakhstan,Austria,0,0,World Cup qualifier,in Kazakhstan,9,-9,1347,1608,4,-2,120,58,1338,1617,draw
2711,October 12,2012,Lesotho,Swaziland,2,1,Friendly,in Lesotho,6,-6,1158,1098,1,-1,168,181,1152,1104,T1
2712,October 12,2012,Liechtenstein,Lithuania,0,2,World Cup qualifier,in Liechtenstein,-18,18,1199,1486,-3,3,156,91,1217,1468,T2
2713,October 12,2012,Luxembourg,Israel,0,6,World Cup qualifier,in Luxembourg,-10,10,1151,1629,-2,2,169,52,1161,1619,T2
2714,October 12,2012,Macedonia,Croatia,1,2,World Cup qualifier,in Macedonia,-8,8,1505,1874,0,1,83,14,1513,1866,T2
2715,October 12,2012,Mexico,Guyana,5,0,World Cup qualifier,in the United States,3,-3,1913,1340,1,-1,8,123,1910,1343,T1
2716,October 12,2012,Moldova,Ukraine,0,0,World Cup qualifier,in Moldova,12,-12,1406,1731,3,0,108,30,1394,1743,draw
2717,October 12,2012,Netherlands,Andorra,3,0,World Cup qualifier,in the Netherlands,0,0,1973,999,-1,0,6,188,1973,999,T1
2718,October 12,2012,Panama,Honduras,0,0,World Cup qualifier,in Panama,-9,9,1698,1655,2,1,37,47,1707,1646,draw
2719,October 12,2012,Poland,South Africa,1,0,Friendly,in Poland,4,-4,1698,1574,3,-2,37,68,1694,1578,T1
2720,October 12,2012,Russia,Portugal,1,0,World Cup qualifier,in Russia,19,-19,1892,1930,2,0,12,7,1873,1949,T1
2721,October 12,2012,Serbia,Belgium,0,3,World Cup qualifier,in Serbia,-44,44,1689,1781,-8,7,40,24,1733,1737,T2
2722,October 12,2012,Slovakia,Latvia,2,1,World Cup qualifier,in Slovakia,10,-10,1624,1505,3,-1,54,83,1614,1515,T1
2723,October 12,2012,Slovenia,Cyprus,2,1,World Cup qualifier,in Slovenia,7,-7,1633,1456,2,-1,50,97,1626,1463,T1
2724,October 12,2012,Solomon Islands,New Caledonia,2,6,World Cup qualifier,in the Solomon Islands,-46,46,1223,1336,-7,14,149,124,1269,1290,T2
2725,October 12,2012,Saint Kitts and Nevis,Trinidad and Tobago,0,1,CONCACAF Champ &amp; Carib Champ qual,in Saint Kitts and Nevis,-10,10,1196,1501,-1,3,157,86,1206,1491,T2
2726,October 12,2012,Switzerland,Norway,1,1,World Cup qualifier,in Switzerland,-11,11,1810,1724,-1,1,19,35,1821,1713,draw
2727,October 12,2012,Tahiti,New Zealand,0,2,World Cup qualifier,in Tahiti,-14,14,1230,1567,0,4,147,69,1244,1553,T2
2728,October 12,2012,Turkey,Romania,0,1,World Cup qualifier,in Turkey,-26,26,1728,1770,-6,3,32,26,1754,1744,T2
2729,October 12,2012,United Arab Emirates,Uzbekistan,2,2,Friendly,in the United Arab Emirates,2,-2,1439,1606,3,-1,99,59,1437,1608,draw
2730,October 12,2012,Wales,Scotland,2,1,World Cup qualifier,in Wales,21,-21,1586,1669,6,-2,63,43,1565,1690,T1
2731,October 13,2012,Botswana,Mali,1,4,African Nations Cup qualifier,in Botswana,-20,20,1302,1605,-9,5,137,59,1322,1585,T2
2732,October 13,2012,Brunei,East Timor,2,1,Southeast Asian Championship qualifier,in Myanmar,19,-19,670,615,0,-2,224,227,651,634,T1
2733,October 13,2012,Malawi,Ghana,0,1,African Nations Cup qualifier,in Malawi,-11,11,1389,1674,0,1,111,43,1400,1663,T2
2734,October 13,2012,Morocco,Mozambique,4,0,African Nations Cup qualifier,in Morocco,11,-11,1562,1335,2,-3,72,124,1551,1346,T1
2735,October 13,2012,Myanmar,Laos,0,0,Southeast Asian Championship qualifier,in Myanmar,-14,14,1012,851,-1,1,186,207,1026,837,draw
2736,October 13,2012,Namibia,Rwanda,0,0,Friendly,in Namibia,0,0,1312,1403,1,0,131,109,1312,1403,draw
2737,October 13,2012,Nigeria,Liberia,6,1,African Nations Cup qualifier,in Nigeria,7,-7,1633,1303,3,-1,50,135,1626,1310,T1
2738,October 13,2012,Senegal,Ivory Coast,0,2,African Nations Cup qualifier,in Senegal,-17,17,1525,1826,-3,2,81,18,1542,1809,T2
2739,October 13,2012,Tunisia,Sierra Leone,0,0,African Nations Cup qualifier,in Tunisia,-16,16,1588,1360,-3,4,63,118,1604,1344,draw
2740,October 13,2012,Uganda,Zambia,1,0,African Nations Cup qualifier,in Uganda,21,-21,1526,1598,3,-5,80,60,1505,1619,T1
2741,October 14,2012,Algeria,Libya,2,0,African Nations Cup qualifier,in Algeria,25,-25,1571,1568,9,-7,68,69,1546,1593,T1
2742,October 14,2012,Angola,Zimbabwe,2,0,African Nations Cup qualifier,in Angola,16,-16,1479,1366,2,-3,94,116,1463,1382,T1
2743,October 14,2012,Burkina Faso,Central African Republic,3,1,African Nations Cup qualifier,in Burkina Faso,15,-15,1433,1311,3,-6,103,133,1418,1326,T1
2744,October 14,2012,Cameroon,Cape Verde,2,1,African Nations Cup qualifier,in Cameroon,7,-7,1605,1432,1,-5,59,104,1598,1439,T1
2745,October 14,2012,Equatorial Guinea,Democratic Republic of Congo,2,1,African Nations Cup qualifier,in Equatorial Guinea,26,-26,1298,1449,3,-2,138,97,1272,1475,T1
2746,October 14,2012,Ethiopia,Sudan,2,0,African Nations Cup qualifier,in Ethiopia,35,-35,1355,1445,8,-4,120,98,1320,1480,T1
2747,October 14,2012,Lesotho,Swaziland,0,1,Friendly,in Lesotho,-14,14,1144,1112,-2,3,170,178,1158,1098,T2
2748,October 14,2012,Niger,Guinea,2,0,African Nations Cup qualifier,in Niger,43,-43,1346,1518,12,-9,123,82,1303,1561,T1
2749,October 14,2012,Saudi Arabia,Congo,3,2,Friendly,in Saudi Arabia,5,-5,1494,1384,2,-2,88,113,1489,1389,T1
2750,October 14,2012,Saint Kitts and Nevis,French Guiana,0,3,CONCACAF Champ &amp; Carib Champ qual,in Saint Kitts and Nevis,-46,46,1150,1232,-11,13,168,147,1196,1186,T2
2751,October 14,2012,Togo,Gabon,2,1,African Nations Cup qualifier,in Togo,26,-26,1387,1535,5,-4,112,77,1361,1561,T1
2752,October 14,2012,Trinidad and Tobago,Anguilla,10,0,CONCACAF Champ &amp; Carib Champ qual,in Saint Kitts and Nevis,0,0,1501,563,0,0,86,231,1501,563,T1
2753,October 16,2012,Albania,Slovenia,1,0,World Cup qualifier,in Albania,23,-23,1507,1610,8,-7,85,57,1484,1633,T1
2754,October 16,2012,Andorra,Estonia,0,1,World Cup qualifier,in Andorra,-4,4,995,1490,-1,1,189,90,999,1486,T2
2755,October 16,2012,Australia,Iraq,2,1,World Cup qualifier,in Qatar,11,-11,1770,1573,2,-3,25,67,1759,1584,T1
2756,October 16,2012,Austria,Kazakhstan,4,0,World Cup qualifier,in Austria,8,-8,1616,1339,1,-3,56,125,1608,1347,T1
2757,October 16,2012,Belarus,Georgia,2,0,World Cup qualifier,in Belarus,19,-19,1582,1510,7,-5,64,83,1563,1529,T1
2758,October 16,2012,Belgium,Scotland,2,0,World Cup qualifier,in Belgium,14,-14,1795,1655,2,-4,22,48,1781,1669,T1
2759,October 16,2012,Bolivia,Uruguay,4,1,World Cup qualifier,in Bolivia,55,-55,1630,1842,13,-6,53,16,1575,1897,T1
2760,October 16,2012,Bosnia and Herzegovina,Lithuania,3,0,World Cup qualifier,in Bosnia and Herzegovina,8,-8,1738,1478,0,-2,31,93,1730,1486,T1
2761,October 16,2012,Brazil,Japan,4,0,Friendly,in Poland,7,-7,2079,1809,0,-2,2,21,2072,1816,T1
2762,October 16,2012,Chile,Argentina,1,2,World Cup qualifier,in Chile,-17,17,1824,2008,-1,0,18,4,1841,1991,T2
2763,October 16,2012,Colombia,Cameroon,3,0,Friendly,in Colombia,3,-3,1897,1602,1,-1,10,60,1894,1605,T1
2764,October 16,2012,Costa Rica,Guyana,7,0,World Cup qualifier,in Costa Rica,7,-7,1666,1333,0,-3,46,127,1659,1340,T1
2765,October 16,2012,Croatia,Wales,2,0,World Cup qualifier,in Croatia,6,-6,1880,1580,1,-2,13,65,1874,1586,T1
2766,October 16,2012,Cuba,Panama,1,1,World Cup qualifier,in Cuba,13,-13,1348,1685,3,-4,123,41,1335,1698,draw
2767,October 16,2012,Cyprus,Norway,1,3,World Cup qualifier,in Cyprus,-17,17,1439,1741,-5,6,100,29,1456,1724,T2
2768,October 16,2012,Czechia,Bulgaria,0,0,World Cup qualifier,in Czechia,-11,11,1769,1674,-1,1,26,44,1780,1663,draw
2769,October 16,2012,Faroe Islands,Ireland,1,4,World Cup qualifier,in the Faroe Islands,-6,6,1211,1740,-1,-1,154,30,1217,1734,T2
2770,October 16,2012,Germany,Sweden,4,4,World Cup qualifier,in Germany,-13,13,2051,1893,0,2,3,11,2064,1880,draw
2771,October 16,2012,Honduras,Canada,8,1,World Cup qualifier,in Honduras,28,-28,1683,1586,5,-7,42,63,1655,1614,T1
2772,October 16,2012,Hong Kong,Malaysia,0,3,Friendly,in Hong Kong,-22,22,1169,1230,-2,7,160,148,1191,1208,T2
2773,October 16,2012,Hungary,Turkey,3,1,World Cup qualifier,in Hungary,25,-25,1710,1703,7,-4,34,36,1685,1728,T1
2774,October 16,2012,Iceland,Switzerland,0,2,World Cup qualifier,in Iceland,-14,14,1482,1824,-4,2,91,18,1496,1810,T2
2775,October 16,2012,Iran,South Korea,1,0,World Cup qualifier,in Iran,21,-21,1698,1776,3,-1,39,23,1677,1797,T1
2776,October 16,2012,Israel,Luxembourg,3,0,World Cup qualifier,in Israel,2,-2,1631,1149,2,-1,51,168,1629,1151,T1
2777,October 16,2012,Italy,Denmark,3,1,World Cup qualifier,in Italy,13,-13,1925,1775,2,-1,7,24,1912,1788,T1
2778,October 16,2012,Jamaica,Antigua and Barbuda,4,1,World Cup qualifier,in Jamaica,5,-5,1639,1269,0,0,49,141,1634,1274,T1
2779,October 16,2012,Kenya,South Africa,1,2,Friendly,in Kenya,-6,6,1313,1580,-1,2,130,65,1319,1574,T2
2780,October 16,2012,Kuwait,Philippines,2,1,Friendly,in Kuwait,1,-1,1493,1146,0,0,89,169,1492,1147,T1
2781,October 16,2012,Latvia,Liechtenstein,2,0,World Cup qualifier,in Latvia,5,-5,1510,1194,1,0,83,157,1505,1199,T1
2782,October 16,2012,Lebanon,Yemen,2,1,Friendly,in Lebanon,7,-7,1323,1305,1,-3,129,134,1316,1312,T1
2783,October 16,2012,Macedonia,Serbia,1,0,World Cup qualifier,in Macedonia,25,-25,1530,1664,6,-7,78,47,1505,1689,T1
2784,October 16,2012,Mexico,El Salvador,2,0,World Cup qualifier,in Mexico,4,-4,1917,1537,0,0,8,76,1913,1541,T1
2785,October 16,2012,New Caledonia,Solomon Islands,5,0,World Cup qualifier,in New Caledonia,18,-18,1354,1205,4,-5,121,155,1336,1223,T1
2786,October 16,2012,New Zealand,Tahiti,3,0,World Cup qualifier,in New Zealand,5,-5,1572,1225,2,-3,68,151,1567,1230,T1
2787,October 16,2012,Oman,Jordan,2,1,World Cup qualifier,in Oman,16,-16,1564,1563,4,-7,71,72,1548,1579,T1
2788,October 16,2012,Paraguay,Peru,1,0,World Cup qualifier,in Paraguay,16,-16,1714,1710,4,0,33,34,1698,1726,T1
2789,October 16,2012,Portugal,Northern Ireland,1,1,World Cup qualifier,in Portugal,-19,19,1911,1451,-2,7,9,97,1930,1432,draw
2790,October 16,2012,Qatar,Uzbekistan,0,1,World Cup qualifier,in Qatar,-19,19,1471,1625,-4,4,94,54,1490,1606,T2
2791,October 16,2012,Romania,Netherlands,1,4,World Cup qualifier,in Romania,-25,25,1745,1998,-2,1,28,5,1770,1973,T2
2792,October 16,2012,Russia,Azerbaijan,1,0,World Cup qualifier,in Russia,1,-1,1893,1401,1,0,11,110,1892,1402,T1
2793,October 16,2012,San Marino,Moldova,0,2,World Cup qualifier,in San Marino,-5,5,884,1411,0,1,204,107,889,1406,T2
2794,October 16,2012,Singapore,India,2,0,Friendly,in Singapore,9,-9,1230,1155,4,-3,148,166,1221,1164,T1
2795,October 16,2012,Slovakia,Greece,0,1,World Cup qualifier,in Slovakia,-16,16,1608,1814,-4,1,58,20,1624,1798,T2
2796,October 16,2012,Spain,France,1,1,World Cup qualifier,in Spain,-16,16,2146,1875,0,1,1,14,2162,1859,draw
2797,October 16,2012,Tunisia,Egypt,1,0,Friendly,in the United Arab Emirates,14,-14,1602,1701,2,-1,60,37,1588,1715,T1
2798,October 16,2012,United Arab Emirates,Bahrain,6,2,Friendly,in the United Arab Emirates,13,-13,1452,1422,3,-4,96,106,1439,1435,T1
2799,October 16,2012,Ukraine,Montenegro,0,1,World Cup qualifier,in Ukraine,-30,30,1701,1681,-7,5,37,43,1731,1651,T2
2800,October 16,2012,United States,Guatemala,3,1,World Cup qualifier,in the United States,9,-9,1765,1554,1,-3,27,74,1756,1563,T1
2801,October 16,2012,Venezuela,Ecuador,1,1,World Cup qualifier,in Venezuela,1,-1,1729,1850,0,1,32,15,1728,1851,draw
2802,October 16,2012,Vietnam,Indonesia,0,0,Friendly,in Vietnam,-4,4,1305,1261,0,1,134,142,1309,1257,draw
2803,October 17,2012,Poland,England,1,1,World Cup qualifier,in Poland,9,-9,1707,1967,3,0,36,6,1698,1976,draw
2804,October 21,2012,Saint Lucia,Curaçao,5,1,CONCACAF Champ &amp; Carib Champ qual,in Saint Lucia,37,-37,1020,1041,5,-1,185,183,983,1078,T1
2805,October 21,2012,Saint Vincent and the Grenadines,Guyana,2,1,CONCACAF Champ &amp; Carib Champ qual,in Saint Lucia,29,-29,1194,1304,5,-8,157,135,1165,1333,T1
2806,October 23,2012,Guadeloupe,Dominican Republic,0,2,CONCACAF Champ &amp; Carib Champ qual,in Guadeloupe,-54,54,1385,1217,-12,11,112,153,1439,1163,T2
2807,October 23,2012,Guyana,Curaçao,2,1,CONCACAF Champ &amp; Carib Champ qual,in Saint Lucia,7,-7,1311,1034,4,-1,131,184,1304,1041,T1
2808,October 23,2012,Martinique,Puerto Rico,2,1,CONCACAF Champ &amp; Carib Champ qual,in Guadeloupe,8,-8,1367,1113,3,-2,116,177,1359,1121,T1
2809,October 23,2012,Saint Lucia,Saint Vincent and the Grenadines,1,0,CONCACAF Champ &amp; Carib Champ qual,in Saint Lucia,24,-24,1044,1170,2,-4,183,161,1020,1194,T1
2810,October 24,2012,Vietnam,Turkmenistan,0,1,Friendly tournament,in Vietnam,-17,17,1288,1368,-5,6,139,116,1305,1351,T2
2811,October 25,2012,Dominican Republic,Martinique,1,1,CONCACAF Champ &amp; Carib Champ qual,in Guadeloupe,8,-8,1225,1359,2,-3,151,120,1217,1367,draw
2812,October 25,2012,Guadeloupe,Puerto Rico,4,1,CONCACAF Champ &amp; Carib Champ qual,in Guadeloupe,7,-7,1392,1106,2,-3,110,180,1385,1113,T1
2813,October 25,2012,Saint Lucia,Guyana,0,3,CONCACAF Champ &amp; Carib Champ qual,in Saint Lucia,-19,19,1025,1330,-1,4,184,127,1044,1311,T2
2814,October 25,2012,Saint Vincent and the Grenadines,Curaçao,4,0,CONCACAF Champ &amp; Carib Champ qual,in Saint Lucia,24,-24,1194,1010,3,-3,158,187,1170,1034,T1
2815,October 26,2012,Vietnam,Laos,4,0,Friendly tournament,in Vietnam,2,-2,1290,849,0,0,139,207,1288,851,T1
2816,October 27,2012,Dominican Republic,Puerto Rico,3,1,CONCACAF Champ &amp; Carib Champ qual,in Guadeloupe,20,-20,1245,1086,5,-1,146,181,1225,1106,T1
2817,October 27,2012,Guadeloupe,Martinique,3,3,CONCACAF Champ &amp; Carib Champ qual,in Guadeloupe,-7,7,1385,1366,-2,3,112,117,1392,1359,draw
2818,October 28,2012,Turkmenistan,Laos,4,2,Friendly tournament,in Vietnam,2,-2,1370,847,0,-1,116,208,1368,849,T1
2819,November 3,2012,Vietnam,Malaysia,1,0,Friendly,in Vietnam,6,-6,1296,1224,1,-3,138,152,1290,1230,T1
2820,November 6,2012,Iran,Tajikistan,6,1,Friendly,in Iran,2,-2,1700,1245,0,0,40,145,1698,1247,T1
2821,November 7,2012,Qatar,Iraq,2,1,Friendly,in Qatar,10,-10,1481,1563,2,-4,92,71,1471,1573,T1
2822,November 7,2012,Thailand,Malaysia,2,0,Friendly,in Thailand,6,-6,1383,1218,1,-1,114,153,1377,1224,T1
2823,November 8,2012,Bahrain,Jordan,3,0,Friendly,in Bahrain,20,-20,1442,1543,5,-4,100,75,1422,1563,T1
2824,November 8,2012,Oman,Estonia,1,2,Friendly,in Oman,-15,15,1549,1505,-4,3,74,87,1564,1490,T2
2825,November 11,2012,Swaziland,Lesotho,0,0,Friendly,in Swaziland,-2,2,1110,1146,0,1,177,169,1112,1144,draw
2826,November 14,2012,Albania,Cameroon,0,0,Friendly,in Switzerland,3,-3,1510,1599,1,-1,84,61,1507,1602,draw
2827,November 14,2012,Algeria,Bosnia and Herzegovina,0,1,Friendly,in Algeria,-8,8,1563,1746,-2,1,70,30,1571,1738,T2
2828,November 14,2012,Andorra,Iceland,0,2,Friendly,in Andorra,-3,3,992,1485,0,0,190,91,995,1482,T2
2829,November 14,2012,Angola,Congo,1,1,Friendly,in Portugal,-3,3,1476,1387,0,1,93,112,1479,1384,draw
2830,November 14,2012,Armenia,Lithuania,4,2,Friendly,in Armenia,9,-9,1531,1469,3,0,78,94,1522,1478,T1
2831,November 14,2012,Austria,Ivory Coast,0,3,Friendly,in Austria,-12,12,1604,1838,-2,0,58,17,1616,1826,T2
2832,November 14,2012,Bolivia,Costa Rica,1,1,Friendly,in Bolivia,-2,2,1628,1668,0,0,53,46,1630,1666,draw
2833,November 14,2012,Brazil,Colombia,1,1,Friendly,in the United States,-5,5,2074,1902,0,-1,2,11,2079,1897,draw
2834,November 14,2012,Bulgaria,Ukraine,0,1,Friendly,in Bulgaria,-12,12,1662,1713,-3,5,47,33,1674,1701,T2
2835,November 14,2012,Burkina Faso,Democratic Republic of Congo,1,0,Friendly,in Morocco,10,-10,1443,1439,3,-4,100,102,1433,1449,T1
2836,November 14,2012,China,New Zealand,1,1,Friendly,in China,-4,4,1627,1576,-3,0,54,67,1631,1572,draw
2837,November 14,2012,Cuba,Suriname,5,0,CONCACAF Champ &amp; Carib Champ qual,in Trinidad and Tobago,25,-25,1373,1187,7,-5,116,159,1348,1212,T1
2838,November 14,2012,Cyprus,Finland,0,3,Friendly,in Cyprus,-14,14,1425,1632,-3,3,104,52,1439,1618,T2
2839,November 14,2012,Czechia,Slovakia,3,0,Friendly,in Czechia,6,-6,1775,1602,1,-1,25,59,1769,1608,T1
2840,November 14,2012,Gabon,Portugal,2,2,Friendly,in Gabon,7,-7,1542,1904,3,-1,74,10,1535,1911,draw
2841,November 14,2012,Georgia,Egypt,0,0,Friendly,in Georgia,3,-3,1513,1698,0,1,83,37,1510,1701,draw
2842,November 14,2012,Ghana,Cape Verde,1,0,Friendly,in Portugal,4,-4,1678,1428,0,1,44,103,1674,1432,T1
2843,November 14,2012,Grenada,French Guiana,1,1,CONCACAF Champ &amp; Carib Champ qual,in Grenada,-2,2,1165,1234,0,0,163,148,1167,1232,draw
2844,November 14,2012,Haiti,Guyana,1,0,CONCACAF Champ &amp; Carib Champ qual,in Grenada,14,-14,1451,1316,5,-2,97,129,1437,1330,T1
2845,November 14,2012,Honduras,Peru,0,0,Friendly,in the United States,1,-1,1684,1709,1,-1,41,35,1683,1710,draw
2846,November 14,2012,Hungary,Norway,0,2,Friendly,in Hungary,-18,18,1692,1759,-5,1,39,28,1710,1741,T2
2847,November 14,2012,Indonesia,East Timor,1,0,Friendly,in Indonesia,0,0,1261,615,0,0,142,227,1261,615,T1
2848,November 14,2012,Iran,Uzbekistan,0,1,World Cup qualifier,in Iran,-29,29,1671,1654,-5,5,45,49,1700,1625,T2
2849,November 14,2012,Iraq,Jordan,1,0,World Cup qualifier,in Qatar,19,-19,1582,1524,5,-5,65,80,1563,1543,T1
2850,November 14,2012,Ireland,Greece,0,1,Friendly,in Ireland,-11,11,1729,1825,-1,1,31,19,1740,1814,T2
2851,November 14,2012,Israel,Belarus,1,2,Friendly,in Israel,-14,14,1617,1596,-4,2,55,62,1631,1582,T2
2852,November 14,2012,Italy,France,1,2,Friendly,in Italy,-14,14,1911,1889,-1,2,8,12,1925,1875,T2
2853,November 14,2012,Kuwait,Bahrain,1,1,Friendly,in Kuwait,-4,4,1489,1446,1,2,89,98,1493,1442,draw
2854,November 14,2012,Liechtenstein,Malta,0,1,Friendly,in Liechtenstein,-12,12,1182,1242,-2,2,160,147,1194,1230,T2
2855,November 14,2012,Luxembourg,Scotland,1,2,Friendly,in Luxembourg,-2,2,1147,1657,0,0,168,48,1149,1655,T2
2856,November 14,2012,Macedonia,Slovenia,3,2,Friendly,in Macedonia,9,-9,1539,1601,3,-3,75,60,1530,1610,T1
2857,November 14,2012,Malaysia,Hong Kong,1,1,Friendly,in Malaysia,-4,4,1214,1173,0,0,153,162,1218,1169,draw
2858,November 14,2012,Montenegro,San Marino,3,0,World Cup qualifier,in Montenegro,0,0,1681,884,1,0,42,204,1681,884,T1
2859,November 14,2012,Morocco,Togo,0,1,Friendly,in Morocco,-17,17,1545,1404,-2,2,73,109,1562,1387,T2
2860,November 14,2012,Netherlands,Germany,0,0,Friendly,in the Netherlands,-1,1,1997,2052,0,0,5,3,1998,2051,draw
2861,November 14,2012,Niger,Senegal,1,1,Friendly,in Niger,2,-2,1348,1523,0,-1,124,81,1346,1525,draw
2862,November 14,2012,Nigeria,Venezuela,3,1,Friendly,in the United States,19,-19,1652,1710,0,-2,50,34,1633,1729,T1
2863,November 14,2012,Northern Ireland,Azerbaijan,1,1,World Cup qualifier,in Northern Ireland,-8,8,1443,1409,-3,2,100,107,1451,1401,draw
2864,November 14,2012,Oman,Japan,1,2,World Cup qualifier,in Oman,-11,11,1538,1820,-2,1,76,20,1549,1809,T2
2865,November 14,2012,Panama,Spain,1,5,Friendly,in Panama,-4,4,1681,2150,-1,0,42,1,1685,2146,T2
2866,November 14,2012,Paraguay,Guatemala,3,1,Friendly,in Paraguay,5,-5,1719,1549,1,0,32,72,1714,1554,T1
2867,November 14,2012,Poland,Uruguay,1,3,Friendly,in Poland,-13,13,1694,1855,-2,1,38,15,1707,1842,T2
2868,November 14,2012,Qatar,Lebanon,1,0,World Cup qualifier,in Qatar,7,-7,1488,1316,2,0,90,129,1481,1323,T1
2869,November 14,2012,Romania,Belgium,2,1,Friendly,in Romania,9,-9,1754,1786,-1,0,29,22,1745,1795,T1
2870,November 14,2012,Russia,United States,2,2,Friendly,in Russia,-6,6,1887,1771,-2,1,13,26,1893,1765,draw
2871,November 14,2012,Rwanda,Namibia,2,2,Friendly,in Rwanda,-5,5,1398,1317,-2,3,110,128,1403,1312,draw
2872,November 14,2012,Saudi Arabia,Argentina,0,0,Friendly,in Saudi Arabia,8,-8,1502,2000,2,0,87,4,1494,2008,draw
2873,November 14,2012,Serbia,Chile,3,1,Friendly,in Switzerland,21,-21,1685,1803,7,-3,40,21,1664,1824,T1
2874,November 14,2012,South Africa,Zambia,0,1,Friendly,in South Africa,-12,12,1568,1610,-3,6,68,56,1580,1598,T2
2875,November 14,2012,South Korea,Australia,1,2,Friendly,in South Korea,-13,13,1763,1783,-4,2,27,23,1776,1770,T2
2876,November 14,2012,Sweden,England,4,2,Friendly,in Sweden,14,-14,1907,1953,2,0,9,6,1893,1967,T1
2877,November 14,2012,Tanzania,Kenya,1,0,Friendly,in Tanzania,8,-8,1302,1305,3,-3,136,133,1294,1313,T1
2878,November 14,2012,Thailand,Bhutan,5,0,Friendly,in Thailand,0,0,1383,544,0,0,114,233,1383,544,T1
2879,November 14,2012,Trinidad and Tobago,Saint Vincent and the Grenadines,1,1,CONCACAF Champ &amp; Carib Champ qual,in Trinidad and Tobago,-16,16,1485,1210,-3,3,91,155,1501,1194,draw
2880,November 14,2012,Tunisia,Switzerland,1,2,Friendly,in Tunisia,-7,7,1595,1831,-3,0,63,18,1602,1824,T2
2881,November 14,2012,Turkey,Denmark,1,1,Friendly,in Turkey,-1,1,1702,1776,1,0,36,24,1703,1775,draw
2882,November 14,2012,United Arab Emirates,Estonia,2,1,Friendly,in the United Arab Emirates,9,-9,1461,1496,1,-1,95,88,1452,1505,T1
2883,November 15,2012,Philippines,Singapore,1,0,Friendly,in the Philippines,10,-10,1156,1220,3,-2,166,152,1146,1230,T1
2884,November 16,2012,Cuba,Saint Vincent and the Grenadines,1,1,CONCACAF Champ &amp; Carib Champ qual,in Trinidad and Tobago,-9,9,1364,1219,-3,2,119,153,1373,1210,draw
2885,November 16,2012,French Guiana,Haiti,1,0,CONCACAF Champ &amp; Carib Champ qual,in Grenada,31,-31,1265,1420,6,-8,142,105,1234,1451,T1
2886,November 16,2012,Grenada,Guyana,2,1,CONCACAF Champ &amp; Carib Champ qual,in Grenada,23,-23,1188,1293,5,-10,158,139,1165,1316,T1
2887,November 16,2012,Trinidad and Tobago,Suriname,3,0,CONCACAF Champ &amp; Carib Champ qual,in Trinidad and Tobago,6,-6,1491,1181,2,-2,89,161,1485,1187,T1
2888,November 17,2012,Palestine,Syria,1,1,Friendly,in Jordan,6,-6,1255,1501,0,-1,145,87,1249,1507,draw
2889,November 17,2012,Thailand,Bangladesh,5,0,Friendly,in Thailand,2,-2,1385,948,1,0,113,194,1383,950,T1
2890,November 18,2012,Grenada,Haiti,0,2,CONCACAF Champ &amp; Carib Champ qual,in Grenada,-19,19,1169,1439,-5,4,163,101,1188,1420,T2
2891,November 18,2012,Guyana,French Guiana,4,3,CONCACAF Champ &amp; Carib Champ qual,in Grenada,18,-18,1311,1247,9,-3,130,145,1293,1265,T1
2892,November 18,2012,Suriname,Saint Vincent and the Grenadines,1,0,CONCACAF Champ &amp; Carib Champ qual,in Trinidad and Tobago,22,-22,1203,1197,5,-5,156,158,1181,1219,T1
2893,November 18,2012,Trinidad and Tobago,Cuba,1,0,CONCACAF Champ &amp; Carib Champ qual,in Trinidad and Tobago,9,-9,1500,1355,1,-2,88,121,1491,1364,T1
2894,November 19,2012,Singapore,Pakistan,4,0,Friendly,in Singapore,3,-3,1223,905,1,0,151,200,1220,908,T1
2895,November 20,2012,Malaysia,Bangladesh,1,1,Friendly,in Malaysia,-8,8,1206,956,-1,0,154,194,1214,948,draw
2896,November 20,2012,Palestine,Syria,2,1,Friendly,in Jordan,16,-16,1271,1485,3,-4,141,91,1255,1501,T1
2897,November 21,2012,Argentina,Brazil,2,1,Friendly tournament,in Argentina,14,-14,2014,2060,0,0,4,2,2000,2074,T1
2898,November 24,2012,Ethiopia,South Sudan,1,0,CECAFA Cup,in Uganda,8,-8,1363,1099,2,-2,119,180,1355,1107,T1
2899,November 24,2012,Guam,Northern Mariana Islands,8,0,Friendly,in Guam,7,-7,681,458,3,0,220,234,674,465,T1
2900,November 24,2012,Myanmar,Vietnam,1,1,Southeast Asian Championship,in Thailand,13,-13,1025,1283,2,0,184,139,1012,1296,draw
2901,November 24,2012,Thailand,Philippines,2,1,Southeast Asian Championship,in Thailand,5,-5,1390,1151,2,-1,111,167,1385,1156,T1
2902,November 24,2012,Uganda,Kenya,1,0,CECAFA Cup,in Uganda,5,-5,1531,1300,1,-4,78,137,1526,1305,T1
2903,November 25,2012,Burundi,Somalia,5,1,CECAFA Cup,in Uganda,8,-8,1267,885,1,0,143,203,1259,893,T1
2904,November 25,2012,Indonesia,Laos,2,2,Southeast Asian Championship,in Malaysia,-17,17,1244,864,-5,2,148,206,1261,847,draw
2905,November 25,2012,Malaysia,Singapore,0,3,Southeast Asian Championship,in Malaysia,-43,43,1163,1266,-10,7,164,144,1206,1223,T2
2906,November 25,2012,Tanzania,Sudan,2,0,CECAFA Cup,in Uganda,42,-42,1344,1403,10,-11,125,109,1302,1445,T1
2907,November 26,2012,Eritrea,Zanzibar,0,0,CECAFA Cup,in Uganda,8,-8,1168,1298,2,-4,163,137,1160,1306,draw
2908,November 26,2012,Rwanda,Malawi,2,0,CECAFA Cup,in Uganda,29,-29,1427,1360,7,-8,103,120,1398,1389,T1
2909,November 27,2012,Kenya,South Sudan,2,0,CECAFA Cup,in Uganda,14,-14,1314,1085,5,-1,131,181,1300,1099,T1
2910,November 27,2012,Philippines,Vietnam,1,0,Southeast Asian Championship,in Thailand,27,-27,1178,1256,7,-5,160,144,1151,1283,T1
2911,November 27,2012,Thailand,Myanmar,4,0,Southeast Asian Championship,in Thailand,5,-5,1395,1020,0,-1,111,185,1390,1025,T1
2912,November 27,2012,Uganda,Ethiopia,1,0,CECAFA Cup,in Uganda,7,-7,1538,1356,2,-3,76,121,1531,1363,T1
2913,November 28,2012,Burundi,Tanzania,1,0,CECAFA Cup,in Uganda,24,-24,1291,1320,3,-3,139,128,1267,1344,T1
2914,November 28,2012,Indonesia,Singapore,1,0,Southeast Asian Championship,in Malaysia,21,-21,1265,1245,5,-3,143,146,1244,1266,T1
2915,November 28,2012,Malaysia,Laos,4,1,Southeast Asian Championship,in Malaysia,6,-6,1169,858,3,0,163,206,1163,864,T1
2916,November 28,2012,Sudan,Somalia,1,0,CECAFA Cup,in Uganda,2,-2,1405,883,1,-1,109,204,1403,885,T1
2917,November 29,2012,Bahrain,Palestine,2,0,Friendly,in Qatar,8,-8,1454,1263,0,-2,97,143,1446,1271,T1
2918,November 29,2012,Malawi,Eritrea,3,2,CECAFA Cup,in Uganda,10,-10,1370,1158,4,-1,115,166,1360,1168,T1
2919,November 29,2012,Zanzibar,Rwanda,2,1,CECAFA Cup,in Uganda,27,-27,1325,1400,9,-7,128,110,1298,1427,T1
2920,November 30,2012,Kenya,Ethiopia,3,1,CECAFA Cup,in Uganda,34,-34,1348,1322,9,-8,123,129,1314,1356,T1
2921,November 30,2012,Philippines,Myanmar,2,0,Southeast Asian Championship,in Thailand,17,-17,1195,1003,2,-3,158,188,1178,1020,T1
2922,November 30,2012,Thailand,Vietnam,3,1,Southeast Asian Championship,in Thailand,12,-12,1407,1244,4,-4,107,148,1395,1256,T1
2923,November 30,2012,Uganda,South Sudan,4,0,CECAFA Cup,in Uganda,3,-3,1541,1082,1,0,75,181,1538,1085,T1
2924,December 1,2012,Burundi,Sudan,1,0,CECAFA Cup,in Uganda,26,-26,1317,1379,9,-5,130,114,1291,1405,T1
2925,December 1,2012,Hong Kong,Guam,2,1,East Asian Cup qualifier,in Hong Kong,1,-1,1174,680,0,0,162,220,1173,681,T1
2926,December 1,2012,Malawi,Zanzibar,2,0,CECAFA Cup,in Uganda,26,-26,1396,1299,4,-10,111,138,1370,1325,T1
2927,December 1,2012,Malaysia,Indonesia,2,0,Southeast Asian Championship,in Malaysia,30,-30,1199,1235,6,-7,157,149,1169,1265,T1
2928,December 1,2012,North Korea,Taiwan,6,1,East Asian Cup qualifier,in Hong Kong,2,-2,1552,893,0,-1,71,202,1550,895,T1
2929,December 1,2012,Rwanda,Eritrea,2,0,CECAFA Cup,in Uganda,12,-12,1412,1146,6,-3,105,169,1400,1158,T1
2930,December 1,2012,Singapore,Laos,4,3,Southeast Asian Championship,in Malaysia,4,-4,1249,854,2,-1,143,207,1245,858,T1
2931,December 1,2012,Tanzania,Somalia,7,0,CECAFA Cup,in Uganda,7,-7,1327,876,2,0,128,204,1320,883,T1
2932,December 3,2012,Bahrain,Iraq,0,0,Friendly,in Qatar,4,-4,1458,1578,1,-1,96,66,1454,1582,draw
2933,December 3,2012,Burundi,Zanzibar,0,0,CECAFA Cup,in Uganda,-1,1,1316,1300,-1,0,131,138,1317,1299,draw
2934,December 3,2012,Hong Kong,Australia,0,1,East Asian Cup qualifier,in Hong Kong,-2,2,1172,1785,-1,0,163,23,1174,1783,T2
2935,December 3,2012,North Korea,Guam,5,0,East Asian Cup qualifier,in Hong Kong,1,-1,1553,679,0,0,71,220,1552,680,T1
2936,December 3,2012,Tanzania,Rwanda,2,0,CECAFA Cup,in Uganda,37,-37,1364,1375,9,-10,119,115,1327,1412,T1
2937,December 4,2012,Kenya,Malawi,1,0,CECAFA Cup,in Uganda,23,-23,1371,1373,8,-5,116,115,1348,1396,T1
2938,December 4,2012,Uganda,Ethiopia,2,0,CECAFA Cup,in Uganda,8,-8,1549,1314,3,-3,72,132,1541,1322,T1
2939,December 5,2012,Australia,North Korea,1,1,East Asian Cup qualifier,in Hong Kong,-12,12,1773,1565,-2,1,25,70,1785,1553,draw
2940,December 5,2012,Guam,Taiwan,1,1,East Asian Cup qualifier,in Hong Kong,11,-11,690,882,3,-1,217,203,679,893,draw
2941,December 5,2012,Saudi Arabia,Zambia,2,1,Friendly,in Saudi Arabia,10,-10,1512,1600,2,-4,84,60,1502,1610,T1
2942,December 6,2012,Kenya,Zanzibar,2,2,CECAFA Cup,in Uganda,-4,4,1367,1304,-1,2,117,136,1371,1300,draw
2943,December 6,2012,Uganda,Tanzania,3,0,CECAFA Cup,in Uganda,11,-11,1560,1353,0,-4,72,124,1549,1364,T1
2944,December 7,2012,Antigua and Barbuda,Dominican Republic,1,2,CONCACAF Champ qual &amp; Carib Champ,in Antigua and Barbuda,-27,27,1242,1272,-6,4,147,141,1269,1245,T2
2945,December 7,2012,Australia,Guam,9,0,East Asian Cup qualifier,in Hong Kong,0,0,1773,690,0,0,25,217,1773,690,T1
2946,December 7,2012,Haiti,Trinidad and Tobago,0,0,CONCACAF Champ qual &amp; Carib Champ,in Antigua and Barbuda,3,-3,1442,1497,0,0,100,87,1439,1500,draw
2947,December 7,2012,Hong Kong,Taiwan,2,0,East Asian Cup qualifier,in Hong Kong,6,-6,1178,876,1,0,162,203,1172,882,T1
2948,December 8,2012,French Guiana,Jamaica,2,1,CONCACAF Champ qual &amp; Carib Champ,in Antigua and Barbuda,36,-36,1283,1603,4,-6,140,57,1247,1639,T1
2949,December 8,2012,Kuwait,Palestine,2,1,West Asian Championship,in Kuwait,5,-5,1494,1258,0,-1,89,143,1489,1263,T1
2950,December 8,2012,Lebanon,Oman,1,0,West Asian Championship,in Kuwait,31,-31,1347,1507,5,-9,125,86,1316,1538,T1
2951,December 8,2012,Martinique,Cuba,1,0,CONCACAF Champ qual &amp; Carib Champ,in Antigua and Barbuda,19,-19,1385,1336,7,-5,111,127,1366,1355,T1
2952,December 8,2012,Philippines,Singapore,0,0,Southeast Asian Championship,in the Philippines,-3,3,1192,1252,0,-1,159,144,1195,1249,draw
2953,December 8,2012,Tanzania,Zanzibar,1,1,CECAFA Cup,in Uganda,-3,3,1350,1307,1,1,123,135,1353,1304,draw
2954,December 8,2012,Uganda,Kenya,2,1,CECAFA Cup,in Uganda,6,-6,1566,1361,2,-3,70,120,1560,1367,T1
2955,December 9,2012,Antigua and Barbuda,Trinidad and Tobago,2,0,CONCACAF Champ qual &amp; Carib Champ,in Antigua and Barbuda,43,-43,1285,1454,7,-10,140,97,1242,1497,T1
2956,December 9,2012,Australia,Taiwan,8,0,East Asian Cup qualifier,in Hong Kong,1,-1,1774,875,0,-1,25,204,1773,876,T1
2957,December 9,2012,Bahrain,Yemen,1,0,West Asian Championship,in Kuwait,12,-12,1470,1293,3,-3,93,139,1458,1305,T1
2958,December 9,2012,Haiti,Dominican Republic,2,1,CONCACAF Champ qual &amp; Carib Champ,in Antigua and Barbuda,11,-11,1453,1261,2,-1,98,143,1442,1272,T1
2959,December 9,2012,Hong Kong,North Korea,0,4,East Asian Cup qualifier,in Hong Kong,-12,12,1166,1577,-2,4,164,67,1178,1565,T2
2960,December 9,2012,Iran,Saudi Arabia,0,0,West Asian Championship,in Kuwait,-9,9,1662,1521,-1,2,46,81,1671,1512,draw
2961,December 9,2012,Malaysia,Thailand,1,1,Southeast Asian Championship,in Malaysia,6,-6,1205,1401,3,-2,154,109,1199,1407,draw
2962,December 10,2012,Cuba,French Guiana,2,1,CONCACAF Champ qual &amp; Carib Champ,in Antigua and Barbuda,17,-17,1353,1266,4,-1,123,142,1336,1283,T1
2963,December 10,2012,Iraq,Jordan,1,0,West Asian Championship,in Kuwait,17,-17,1595,1507,4,-6,62,85,1578,1524,T1
2964,December 10,2012,Jamaica,Martinique,0,0,CONCACAF Champ qual &amp; Carib Champ,in Antigua and Barbuda,-11,11,1592,1396,-7,1,64,110,1603,1385,draw
2965,December 11,2012,Antigua and Barbuda,Haiti,0,1,CONCACAF Champ qual &amp; Carib Champ,in Antigua and Barbuda,-16,16,1269,1469,-2,5,142,93,1285,1453,T2
2966,December 11,2012,Kuwait,Oman,0,2,West Asian Championship,in Kuwait,-37,37,1457,1544,-9,10,97,75,1494,1507,T2
2967,December 11,2012,Palestine,Lebanon,1,0,West Asian Championship,in Kuwait,25,-25,1283,1322,4,-3,140,129,1258,1347,T1
2968,December 11,2012,Trinidad and Tobago,Dominican Republic,2,1,CONCACAF Champ qual &amp; Carib Champ,in Antigua and Barbuda,10,-10,1464,1251,2,-2,95,145,1454,1261,T1
2969,December 12,2012,Bahrain,Iran,0,0,West Asian Championship,in Kuwait,10,-10,1480,1652,1,-3,91,49,1470,1662,draw
2970,December 12,2012,Cuba,Jamaica,1,0,CONCACAF Champ qual &amp; Carib Champ,in Antigua and Barbuda,32,-32,1385,1560,11,-8,112,72,1353,1592,T1
2971,December 12,2012,Martinique,French Guiana,3,1,CONCACAF Champ qual &amp; Carib Champ,in Antigua and Barbuda,19,-19,1415,1247,5,-2,105,145,1396,1266,T1
2972,December 12,2012,Saudi Arabia,Yemen,1,0,West Asian Championship,in Kuwait,8,-8,1529,1285,1,0,80,139,1521,1293,T1
2973,December 12,2012,Singapore,Philippines,1,0,Southeast Asian Championship,in Singapore,11,-11,1263,1181,1,-2,143,161,1252,1192,T1
2974,December 13,2012,Iraq,Syria,1,1,West Asian Championship,in Kuwait,-6,6,1589,1491,-1,1,63,88,1595,1485,draw
2975,December 13,2012,Thailand,Malaysia,2,0,Southeast Asian Championship,in Thailand,9,-9,1410,1196,3,-4,107,158,1401,1205,T1
2976,December 14,2012,Cuba,Haiti,1,0,Caribbean Championship,in Antigua and Barbuda,25,-25,1410,1444,5,-5,107,98,1385,1469,T1
2977,December 14,2012,Kuwait,Lebanon,2,1,West Asian Championship,in Kuwait,8,-8,1465,1314,3,-2,94,131,1457,1322,T1
2978,December 14,2012,Martinique,Trinidad and Tobago,1,1,Caribbean Championship,in Antigua and Barbuda,3,-3,1418,1461,0,0,105,95,1415,1464,draw
2979,December 14,2012,Oman,Palestine,2,1,West Asian Championship,in Kuwait,7,-7,1551,1276,2,-1,73,141,1544,1283,T1
2980,December 14,2012,Poland,Macedonia,4,1,Friendly,in Turkey,10,-10,1704,1529,2,-2,36,79,1694,1539,T1
2981,December 15,2012,Angola,Gambia,1,1,Friendly,in Angola,-6,6,1470,1335,0,1,92,127,1476,1329,draw
2982,December 15,2012,Bahrain,Saudi Arabia,1,0,West Asian Championship,in Kuwait,23,-23,1503,1506,4,-7,87,86,1480,1529,T1
2983,December 15,2012,Iran,Yemen,2,1,West Asian Championship,in Kuwait,4,-4,1656,1281,1,0,48,139,1652,1285,T1
2984,December 16,2012,Cuba,Trinidad and Tobago,1,0,Caribbean Championship,in Antigua and Barbuda,23,-23,1433,1438,5,-6,102,101,1410,1461,T1
2985,December 16,2012,Haiti,Martinique,1,0,Caribbean Championship,in Antigua and Barbuda,19,-19,1463,1399,3,-6,95,111,1444,1418,T1
2986,December 16,2012,Syria,Jordan,2,1,West Asian Championship,in Kuwait,21,-21,1512,1486,6,-5,83,90,1491,1507,T1
2987,December 18,2012,Bahrain,Syria,1,1,West Asian Championship,in Kuwait,1,-1,1504,1511,0,0,87,83,1503,1512,draw
2988,December 18,2012,Iraq,Oman,2,0,West Asian Championship,in Kuwait,27,-27,1616,1524,8,-6,55,79,1589,1551,T1
2989,December 19,2012,Oman,Benin,2,0,Friendly,in Oman,7,-7,1531,1400,2,0,77,109,1524,1407,T1
2990,December 19,2012,Singapore,Thailand,3,1,Southeast Asian Championship,in Singapore,34,-34,1297,1376,4,-8,139,115,1263,1410,T1
2991,December 20,2012,Oman,Bahrain,1,0,West Asian Championship,in Kuwait,18,-18,1549,1486,4,-2,73,89,1531,1504,T1
2992,December 20,2012,Syria,Iraq,1,0,West Asian Championship,in Kuwait,26,-26,1537,1590,6,-8,77,63,1511,1616,T1
2993,December 22,2012,Angola,Rwanda,1,0,Friendly,in Angola,5,-5,1475,1370,0,0,92,116,1470,1375,T1
2994,December 22,2012,South Africa,Malawi,3,1,Friendly,in South Africa,5,-5,1573,1368,0,-1,68,118,1568,1373,T1
2995,December 22,2012,Tanzania,Zambia,1,0,Friendly,in Tanzania,14,-14,1364,1586,4,-4,120,63,1350,1600,T1
2996,December 22,2012,Thailand,Singapore,1,0,Southeast Asian Championship,in Thailand,11,-11,1387,1286,4,0,111,139,1376,1297,T1
2997,December 25,2012,United Arab Emirates,Yemen,2,0,Friendly,in Qatar,8,-8,1469,1273,3,-2,93,142,1461,1281,T1
2998,December 26,2012,Bahrain,Burkina Faso,0,0,Friendly,in Bahrain,-4,4,1482,1447,-2,0,91,98,1486,1443,draw
2999,December 28,2012,Qatar,Egypt,0,2,Friendly,in Qatar,-10,10,1478,1708,-3,2,91,36,1488,1698,T2
3000,December 29,2012,Bahrain,Guinea,3,0,Friendly,in Bahrain,14,-14,1496,1504,3,-4,87,86,1482,1518,T1
3001,December 29,2012,Oman,Togo,0,1,Friendly,in Oman,-16,16,1533,1420,-5,2,78,106,1549,1404,T2
3002,December 29,2012,United Arab Emirates,Yemen,3,1,Friendly,in Qatar,7,-7,1476,1266,1,-1,92,143,1469,1273,T1
3003,December 30,2012,Ethiopia,Niger,1,0,Friendly,in Ethiopia,8,-8,1322,1340,2,0,129,125,1314,1348,T1
3004,January 5,2013,Angola,Zambia,2,0,Friendly,in South Africa,20,-20,1495,1566,4,-7,89,69,1475,1586,T1
3005,January 5,2013,Bahrain,Oman,0,0,Gulf Cup,in Bahrain,-4,4,1492,1537,-3,2,90,76,1496,1533,draw
3006,January 5,2013,Niger,Togo,3,1,Friendly,in Niger,14,-14,1354,1406,1,-2,124,108,1340,1420,T1
3007,January 5,2013,United Arab Emirates,Qatar,3,1,Gulf Cup,in Bahrain,30,-30,1506,1448,7,-6,85,97,1476,1478,T1
3008,January 6,2013,Iraq,Saudi Arabia,2,0,Gulf Cup,in Bahrain,24,-24,1604,1482,6,-7,57,92,1580,1506,T1
3009,January 6,2013,Kuwait,Yemen,2,0,Gulf Cup,in Bahrain,14,-14,1479,1252,1,0,93,143,1465,1266,T1
3010,January 7,2013,Ethiopia,Tunisia,1,1,Friendly,in Qatar,7,-7,1329,1598,0,-6,129,61,1322,1605,draw
3011,January 8,2013,Bahrain,United Arab Emirates,1,2,Gulf Cup,in Bahrain,-25,25,1467,1531,-6,7,95,78,1492,1506,T2
3012,January 8,2013,Morocco,Zambia,0,0,Friendly,in South Africa,1,-1,1546,1565,0,0,74,69,1545,1566,draw
3013,January 8,2013,Qatar,Oman,2,1,Gulf Cup,in Bahrain,25,-25,1473,1512,4,-7,93,83,1448,1537,T1
3014,January 8,2013,South Africa,Norway,0,1,Friendly,in South Africa,-8,8,1565,1767,-2,1,69,27,1573,1759,T2
3015,January 9,2013,Cape Verde,Nigeria,0,0,Friendly,in Portugal,6,-6,1434,1646,1,0,102,50,1428,1652,draw
3016,January 9,2013,Iraq,Kuwait,1,0,Gulf Cup,in Bahrain,13,-13,1617,1466,2,-3,54,95,1604,1479,T1
3017,January 9,2013,Saudi Arabia,Yemen,2,0,Gulf Cup,in Bahrain,13,-13,1495,1239,3,-5,88,148,1482,1252,T1
3018,January 10,2013,Burkina Faso,Niger,0,0,Friendly,in South Africa,-3,3,1444,1357,0,0,98,124,1447,1354,draw
3019,January 10,2013,Gabon,Tunisia,1,1,Friendly,in the United Arab Emirates,2,-2,1544,1596,1,0,74,61,1542,1598,draw
3020,January 10,2013,Ghana,Egypt,3,0,Friendly,in the United Arab Emirates,19,-19,1697,1689,6,-4,38,40,1678,1708,T1
3021,January 10,2013,Panama,Guatemala,3,0,Friendly,in Panama,7,-7,1688,1542,1,-2,41,75,1681,1549,T1
3022,January 11,2013,Bahrain,Qatar,1,0,Gulf Cup,in Bahrain,15,-15,1482,1458,2,-4,92,96,1467,1473,T1
3023,January 11,2013,Ethiopia,Tanzania,2,1,Friendly,in Ethiopia,8,-8,1337,1356,2,-4,127,124,1329,1364,T1
3024,January 11,2013,United Arab Emirates,Oman,2,0,Gulf Cup,in Bahrain,28,-28,1559,1484,5,-8,73,91,1531,1512,T1
3025,January 12,2013,Iraq,Yemen,2,0,Gulf Cup,in Bahrain,6,-6,1623,1233,0,-1,54,149,1617,1239,T1
3026,January 12,2013,Kuwait,Saudi Arabia,1,0,Gulf Cup,in Bahrain,22,-22,1488,1473,6,-6,88,93,1466,1495,T1
3027,January 12,2013,Morocco,Namibia,2,1,Friendly,in South Africa,4,-4,1550,1313,0,-2,74,132,1546,1317,T1
3028,January 12,2013,South Africa,Algeria,0,0,Friendly,in South Africa,-3,3,1562,1566,-2,2,71,69,1565,1563,draw
3029,January 12,2013,Zambia,Norway,0,0,Friendly,in Zambia,3,-3,1568,1764,2,0,67,27,1565,1767,draw
3030,January 13,2013,Angola,Botswana,2,0,Friendly,in South Africa,7,-7,1502,1295,1,-1,86,138,1495,1302,T1
3031,January 13,2013,Ghana,Tunisia,4,2,Friendly,in the United Arab Emirates,11,-11,1708,1585,2,-2,36,63,1697,1596,T1
3032,January 13,2013,Panama,Guatemala,2,0,Friendly,in Panama,6,-6,1694,1536,2,-2,39,78,1688,1542,T1
3033,January 13,2013,Togo,Niger,2,1,Friendly,in Togo,6,-6,1412,1351,2,-2,106,125,1406,1357,T1
3034,January 14,2013,Ivory Coast,Egypt,4,2,Friendly,in the United Arab Emirates,9,-9,1847,1680,0,-3,17,44,1838,1689,T1
3035,January 15,2013,Bahrain,Iraq,1,1,Gulf Cup,in Bahrain,2,-2,1484,1621,2,0,90,54,1482,1623,draw
3036,January 15,2013,Lebanon,Gabon,0,0,Friendly,in Lebanon,4,-4,1318,1540,1,0,130,75,1314,1544,draw
3037,January 15,2013,United Arab Emirates,Kuwait,1,0,Gulf Cup,in Bahrain,16,-16,1575,1472,6,-5,67,93,1559,1488,T1
3038,January 17,2013,Burkina Faso,Swaziland,3,0,Friendly,in South Africa,4,-4,1448,1106,0,-1,98,178,1444,1110,T1
3039,January 18,2013,Bahrain,Kuwait,1,6,Gulf Cup,in Bahrain,-52,52,1432,1524,-13,13,103,80,1484,1472,T2
3040,January 18,2013,Costa Rica,Belize,1,0,CONCACAF Champ q &amp; Central Am Cup,in Costa Rica,1,-1,1669,1129,0,-1,45,174,1668,1130,T1
3041,January 18,2013,El Salvador,Honduras,1,1,CONCACAF Champ q &amp; Central Am Cup,in Costa Rica,8,-8,1545,1676,1,-2,75,44,1537,1684,draw
3042,January 18,2013,Guatemala,Nicaragua,1,1,CONCACAF Champ q &amp; Central Am Cup,in Costa Rica,-17,17,1519,1138,-4,3,82,172,1536,1121,draw
3043,January 18,2013,United Arab Emirates,Iraq,2,1,Gulf Cup,in Bahrain,23,-23,1598,1598,7,-6,60,60,1575,1621,T1
3044,January 19,2013,Angola,Morocco,0,0,African Nations Cup,in South Africa,3,-3,1505,1547,1,0,86,74,1502,1550,draw
3045,January 19,2013,Chile,Haiti,3,0,Friendly,in Chile,3,-3,1806,1460,0,0,21,94,1803,1463,T1
3046,January 19,2013,South Africa,Cape Verde,0,0,African Nations Cup,in South Africa,-14,14,1548,1448,-1,4,73,97,1562,1434,draw
3047,January 20,2013,Belize,Guatemala,0,0,CONCACAF Champ q &amp; Central Am Cup,in Costa Rica,16,-16,1145,1503,3,-5,171,87,1129,1519,draw
3048,January 20,2013,Costa Rica,Nicaragua,2,0,CONCACAF Champ q &amp; Central Am Cup,in Costa Rica,2,-2,1671,1136,0,-1,45,173,1669,1138,T1
3049,January 20,2013,Democratic Republic of Congo,Ghana,2,2,African Nations Cup,in South Africa,16,-16,1455,1692,4,-2,96,38,1439,1708,draw
3050,January 20,2013,El Salvador,Panama,0,0,CONCACAF Champ q &amp; Central Am Cup,in Costa Rica,8,-8,1553,1686,2,-1,73,40,1545,1694,draw
3051,January 20,2013,Mali,Niger,1,0,African Nations Cup,in South Africa,9,-9,1614,1342,0,0,55,125,1605,1351,T1
3052,January 21,2013,Burkina Faso,Nigeria,1,1,African Nations Cup,in South Africa,13,-13,1461,1633,4,0,94,50,1448,1646,draw
3053,January 21,2013,Ethiopia,Zambia,1,1,African Nations Cup,in South Africa,15,-15,1352,1553,2,-4,125,72,1337,1568,draw
3054,January 22,2013,Belize,Nicaragua,2,1,CONCACAF Champ q &amp; Central Am Cup,in Costa Rica,19,-19,1164,1117,6,-3,165,176,1145,1136,T1
3055,January 22,2013,Costa Rica,Guatemala,1,1,CONCACAF Champ q &amp; Central Am Cup,in Costa Rica,-13,13,1658,1516,-1,5,46,82,1671,1503,draw
3056,January 22,2013,Honduras,Panama,1,1,CONCACAF Champ q &amp; Central Am Cup,in Costa Rica,1,-1,1677,1685,0,0,44,40,1676,1686,draw
3057,January 22,2013,Ivory Coast,Togo,2,1,African Nations Cup,in South Africa,4,-4,1851,1408,1,-2,16,108,1847,1412,T1
3058,January 22,2013,Tunisia,Algeria,1,0,African Nations Cup,in South Africa,24,-24,1609,1542,8,-6,56,75,1585,1566,T1
3059,January 23,2013,Cape Verde,Morocco,1,1,African Nations Cup,in South Africa,7,-7,1455,1540,2,-1,97,75,1448,1547,draw
3060,January 23,2013,North Korea,Sweden,1,1,King's Cup,in Thailand,11,-11,1588,1896,2,-2,64,11,1577,1907,draw
3061,January 23,2013,South Africa,Angola,2,0,African Nations Cup,in South Africa,23,-23,1571,1482,5,-5,68,91,1548,1505,T1
3062,January 23,2013,Thailand,Finland,1,3,King's Cup,in Thailand,-14,14,1373,1646,-4,1,115,50,1387,1632,T2
3063,January 24,2013,Democratic Republic of Congo,Niger,0,0,African Nations Cup,in South Africa,-8,8,1447,1350,-2,0,99,126,1455,1342,draw
3064,January 24,2013,Ghana,Mali,1,0,African Nations Cup,in South Africa,19,-19,1711,1595,4,-8,34,63,1692,1614,T1
3065,January 25,2013,Burkina Faso,Ethiopia,4,0,African Nations Cup,in South Africa,33,-33,1494,1319,6,-4,88,129,1461,1352,T1
3066,January 25,2013,Costa Rica,El Salvador,1,0,Central American Cup,in Costa Rica,9,-9,1667,1544,1,-1,45,73,1658,1553,T1
3067,January 25,2013,Honduras,Belize,1,0,Central American Cup,in Costa Rica,2,-2,1679,1162,0,-1,44,166,1677,1164,T1
3068,January 25,2013,Nigeria,Zambia,1,1,African Nations Cup,in South Africa,-6,6,1627,1559,-1,0,52,72,1633,1553,draw
3069,January 25,2013,Panama,Guatemala,3,1,CONCACAF Champ q &amp; Central Am Cup,in Costa Rica,16,-16,1701,1500,1,-4,39,86,1685,1516,T1
3070,January 26,2013,Ivory Coast,Tunisia,3,0,African Nations Cup,in South Africa,17,-17,1868,1592,1,-8,15,63,1851,1609,T1
3071,January 26,2013,Sweden,Finland,3,0,King's Cup,in Thailand,10,-10,1906,1636,2,0,9,50,1896,1646,T1
3072,January 26,2013,Thailand,North Korea,2,2,King's Cup,in Thailand,5,-5,1378,1583,0,-1,115,65,1373,1588,draw
3073,January 26,2013,Togo,Algeria,2,0,African Nations Cup,in South Africa,51,-51,1459,1491,12,-14,96,88,1408,1542,T1
3074,January 27,2013,Cape Verde,Angola,2,1,African Nations Cup,in South Africa,27,-27,1482,1455,6,-6,92,98,1455,1482,T1
3075,January 27,2013,Costa Rica,Honduras,1,0,Central American Cup,in Costa Rica,15,-15,1682,1664,3,-1,42,45,1667,1679,T1
3076,January 27,2013,El Salvador,Belize,1,0,Central American Cup,in Costa Rica,4,-4,1548,1158,-1,0,74,166,1544,1162,T1
3077,January 27,2013,South Africa,Morocco,2,2,African Nations Cup,in South Africa,-9,9,1562,1549,-2,1,70,73,1571,1540,draw
3078,January 28,2013,Democratic Republic of Congo,Mali,1,1,African Nations Cup,in South Africa,10,-10,1457,1585,2,-2,98,64,1447,1595,draw
3079,January 28,2013,Ghana,Niger,3,0,African Nations Cup,in South Africa,10,-10,1721,1340,2,0,32,125,1711,1350,T1
3080,January 29,2013,Burkina Faso,Zambia,0,0,African Nations Cup,in South Africa,5,-5,1499,1554,1,0,86,72,1494,1559,draw
3081,January 29,2013,Nigeria,Ethiopia,2,0,African Nations Cup,in South Africa,11,-11,1638,1308,2,-5,50,134,1627,1319,T1
3082,January 29,2013,United States,Canada,0,0,Friendly,in the United States,-7,7,1764,1593,0,1,26,62,1771,1586,draw
3083,January 30,2013,Algeria,Ivory Coast,2,2,African Nations Cup,in South Africa,20,-20,1511,1848,6,-2,82,17,1491,1868,draw
3084,January 30,2013,Oman,China,1,0,Friendly,in Oman,11,-11,1495,1616,2,-1,89,54,1484,1627,T1
3085,January 30,2013,Togo,Tunisia,1,1,African Nations Cup,in South Africa,9,-9,1468,1583,1,-1,95,64,1459,1592,draw
3086,January 31,2013,Jordan,Indonesia,5,0,Friendly,in Jordan,5,-5,1491,1230,0,-2,90,150,1486,1235,T1
3087,January 31,2013,North Korea,United Arab Emirates,1,0,Friendly,in China,10,-10,1593,1588,3,-4,61,63,1583,1598,T1
3088,January 31,2013,Qatar,Lebanon,1,0,Friendly,in Qatar,4,-4,1462,1314,1,-1,96,130,1458,1318,T1
3089,February 1,2013,Azerbaijan,Uzbekistan,0,0,Friendly,in the United Arab Emirates,6,-6,1415,1648,1,0,107,49,1409,1654,draw
3090,February 1,2013,Bahrain,Singapore,3,1,Friendly,in Bahrain,6,-6,1438,1280,2,0,102,139,1432,1286,T1
3091,February 1,2013,Iraq,Malaysia,3,0,Friendly,in the United Arab Emirates,3,-3,1601,1193,2,0,57,158,1598,1196,T1
3092,February 2,2013,Ghana,Cape Verde,2,0,African Nations Cup,in South Africa,15,-15,1736,1467,1,-3,31,95,1721,1482,T1
3093,February 2,2013,South Africa,Mali,1,1,African Nations Cup,in South Africa,-5,5,1557,1590,-1,1,71,63,1562,1585,draw
3094,February 3,2013,Burkina Faso,Togo,1,0,African Nations Cup,in South Africa,23,-23,1522,1445,6,-6,81,100,1499,1468,T1
3095,February 3,2013,Nigeria,Ivory Coast,2,1,African Nations Cup,in South Africa,39,-39,1677,1809,5,-3,45,20,1638,1848,T1
3096,February 5,2013,Armenia,Luxembourg,1,1,Friendly,in France,-8,8,1523,1155,-2,2,79,167,1531,1147,draw
3097,February 5,2013,Guinea,Senegal,1,1,Friendly,in France,1,-1,1505,1522,0,0,86,80,1504,1523,draw
3098,February 6,2013,Albania,Georgia,1,2,Friendly,in Albania,-13,13,1497,1526,-4,3,88,79,1510,1513,T2
3099,February 6,2013,Azerbaijan,Liechtenstein,1,0,Friendly,in the United Arab Emirates,4,-4,1419,1178,1,-2,106,162,1415,1182,T1
3100,February 6,2013,Bahrain,Yemen,2,0,Asian Cup qualifier,in the United Arab Emirates,14,-14,1452,1219,2,-4,100,152,1438,1233,T1
3101,February 6,2013,Belarus,Hungary,1,1,Friendly,in Turkey,3,-3,1599,1689,5,-1,55,41,1596,1692,draw
3102,February 6,2013,Belgium,Slovakia,2,1,Friendly,in Belgium,3,-3,1789,1599,-1,1,23,55,1786,1602,T1
3103,February 6,2013,Bolivia,Haiti,2,1,Friendly,in Bolivia,4,-4,1632,1456,2,-1,50,97,1628,1460,T1
3104,February 6,2013,Burkina Faso,Ghana,1,1,African Nations Cup,in South Africa,14,-14,1536,1722,2,-3,78,34,1522,1736,draw
3105,February 6,2013,Chile,Egypt,2,1,Friendly,in Spain,7,-7,1813,1673,1,-2,20,46,1806,1680,T1
3106,February 6,2013,Colombia,Guatemala,4,1,Friendly,in the United States,3,-3,1905,1497,3,-1,8,88,1902,1500,T1
3107,February 6,2013,Croatia,South Korea,4,0,Friendly,in England,13,-13,1893,1750,3,0,11,28,1880,1763,T1
3108,February 6,2013,Cyprus,Serbia,1,3,Friendly,in Cyprus,-9,9,1416,1694,-2,3,107,38,1425,1685,T2
3109,February 6,2013,England,Brazil,2,1,Friendly,in England,10,-10,1963,2050,0,-1,6,3,1953,2060,T1
3110,February 6,2013,France,Germany,1,2,Friendly,in France,-8,8,1881,2060,-2,1,14,2,1889,2052,T2
3111,February 6,2013,Greece,Switzerland,0,0,Friendly,in Greece,-3,3,1822,1834,-1,0,19,17,1825,1831,draw
3112,February 6,2013,Honduras,United States,2,1,World Cup qualifier,in Honduras,20,-20,1684,1744,2,-4,44,30,1664,1764,T1
3113,February 6,2013,India,Palestine,2,4,Friendly,in India,-14,14,1141,1290,-5,3,172,138,1155,1276,T2
3114,February 6,2013,Iran,Lebanon,5,0,Asian Cup qualifier,in Iran,6,-6,1662,1308,2,-3,47,133,1656,1314,T1
3115,February 6,2013,Iraq,Indonesia,1,0,Asian Cup qualifier,in the United Arab Emirates,4,-4,1605,1226,3,1,54,149,1601,1230,T1
3116,February 6,2013,Ireland,Poland,2,0,Friendly,in Ireland,10,-10,1739,1694,1,-1,31,38,1729,1704,T1
3117,February 6,2013,Israel,Finland,2,1,Friendly,in Israel,8,-8,1625,1628,0,-1,53,52,1617,1636,T1
3118,February 6,2013,Japan,Latvia,3,0,Friendly,in Japan,3,-3,1823,1507,1,-1,18,85,1820,1510,T1
3119,February 6,2013,Jordan,Singapore,4,0,Asian Cup qualifier,in Jordan,11,-11,1502,1269,3,-2,87,141,1491,1280,T1
3120,February 6,2013,Kazakhstan,Moldova,3,1,Friendly,in Turkey,18,-18,1357,1393,3,-2,123,110,1339,1411,T1
3121,February 6,2013,Kenya,Libya,3,0,Friendly,in Tunisia,27,-27,1388,1541,10,-8,111,76,1361,1568,T1
3122,February 6,2013,Macedonia,Denmark,3,0,Friendly,in Macedonia,24,-24,1553,1752,5,-4,72,27,1529,1776,T1
3123,February 6,2013,Malta,Northern Ireland,0,0,Friendly,in Malta,3,-3,1245,1440,2,-1,145,102,1242,1443,draw
3124,February 6,2013,Mexico,Jamaica,0,0,World Cup qualifier,in Mexico,-17,17,1900,1577,-2,4,9,66,1917,1560,draw
3125,February 6,2013,Myanmar,Philippines,0,1,Friendly,in Myanmar,-8,8,995,1189,-1,3,189,158,1003,1181,T2
3126,February 6,2013,Nepal,Pakistan,0,1,Friendly,in Nepal,-13,13,907,918,-2,2,200,198,920,905,T2
3127,February 6,2013,Netherlands,Italy,1,1,Friendly,in the Netherlands,-5,5,1992,1916,0,1,5,7,1997,1911,draw
3128,February 6,2013,Nigeria,Mali,4,1,African Nations Cup,in South Africa,33,-33,1710,1557,9,-6,36,69,1677,1590,T1
3129,February 6,2013,North Korea,Laos,1,0,Friendly,in China,0,0,1593,854,1,0,60,207,1593,854,T1
3130,February 6,2013,Oman,Syria,1,0,Asian Cup qualifier,in Oman,17,-17,1512,1520,6,-6,83,82,1495,1537,T1
3131,February 6,2013,Panama,Costa Rica,2,2,World Cup qualifier,in Panama,-7,7,1694,1689,1,1,38,41,1701,1682,draw
3132,February 6,2013,Paraguay,El Salvador,3,0,Friendly,in Paraguay,6,-6,1725,1542,0,-1,33,75,1719,1548,T1
3133,February 6,2013,Portugal,Ecuador,2,3,Friendly,in Portugal,-14,14,1890,1864,-2,1,12,15,1904,1850,T2
3134,February 6,2013,Qatar,Malaysia,2,0,Asian Cup qualifier,in Qatar,6,-6,1468,1187,1,-2,94,160,1462,1193,T1
3135,February 6,2013,Romania,Australia,3,2,Friendly,in Spain,11,-11,1765,1763,5,0,24,25,1754,1774,T1
3136,February 6,2013,Russia,Iceland,2,0,Friendly,in Spain,3,-3,1890,1482,1,-1,12,92,1887,1485,T1
3137,February 6,2013,Rwanda,Uganda,2,2,Friendly,in Rwanda,3,-3,1373,1563,0,1,116,68,1370,1566,draw
3138,February 6,2013,Saudi Arabia,China,2,1,Asian Cup qualifier,in Saudi Arabia,22,-22,1495,1594,2,-5,90,59,1473,1616,T1
3139,February 6,2013,Scotland,Estonia,1,0,Friendly,in Scotland,4,-4,1661,1492,-1,-3,49,91,1657,1496,T1
3140,February 6,2013,Slovenia,Bosnia and Herzegovina,0,3,Friendly,in Slovenia,-15,15,1586,1761,-6,4,63,26,1601,1746,T2
3141,February 6,2013,Spain,Uruguay,3,1,Friendly,in Qatar,5,-5,2155,1850,0,-1,1,16,2150,1855,T1
3142,February 6,2013,Sweden,Argentina,2,3,Friendly,in Sweden,-10,10,1896,2024,-1,0,10,4,1906,2014,T2
3143,February 6,2013,Tanzania,Cameroon,1,0,Friendly,in Tanzania,14,-14,1370,1585,5,-5,118,64,1356,1599,T1
3144,February 6,2013,Thailand,Kuwait,1,3,Asian Cup qualifier,in Thailand,-26,26,1352,1550,-10,5,125,73,1378,1524,T2
3145,February 6,2013,Trinidad and Tobago,Peru,0,2,Friendly,in Trinidad and Tobago,-8,8,1430,1717,-2,1,104,35,1438,1709,T2
3146,February 6,2013,Turkey,Czechia,0,2,Friendly,in Turkey,-16,16,1686,1791,-5,2,43,22,1702,1775,T2
3147,February 6,2013,Ukraine,Norway,2,0,Friendly,in Spain,17,-17,1730,1747,2,-3,32,29,1713,1764,T1
3148,February 6,2013,Uzbekistan,Hong Kong,0,0,Asian Cup qualifier,in Uzbekistan,-19,19,1629,1185,-1,3,51,161,1648,1166,draw
3149,February 6,2013,Vietnam,United Arab Emirates,1,2,Asian Cup qualifier,in Vietnam,-8,8,1236,1596,-1,7,147,57,1244,1588,T2
3150,February 6,2013,Wales,Austria,2,1,Friendly,in Wales,8,-8,1588,1596,4,-2,62,57,1580,1604,T1
3151,February 6,2013,Zimbabwe,Botswana,2,1,Friendly,in Zimbabwe,5,-5,1371,1290,2,0,117,138,1366,1295,T1
3152,February 9,2013,Mali,Ghana,3,1,African Nations Cup,in South Africa,54,-54,1611,1668,15,-12,54,46,1557,1722,T1
3153,February 9,2013,Nepal,Pakistan,0,1,Friendly,in Nepal,-13,13,894,931,-1,1,201,197,907,918,T2
3154,February 10,2013,Nigeria,Burkina Faso,1,0,African Nations Cup,in South Africa,13,-13,1723,1523,1,-1,34,79,1710,1536,T1
3155,February 12,2013,Maldives,Pakistan,1,1,Friendly,in the Maldives,-7,7,1100,938,-2,2,179,195,1107,931,draw
3156,February 14,2013,Maldives,Pakistan,3,0,Friendly,in the Maldives,6,-6,1106,932,2,-1,177,196,1100,938,T1
3157,February 27,2013,Gambia,Mauritania,0,2,Friendly,in The Gambia,-26,26,1309,1144,-5,4,132,171,1335,1118,T2
3158,March 2,2013,Afghanistan,Sri Lanka,1,0,Asian Cup &amp; Asian Challenge Cup qual,in Laos,16,-16,934,840,3,-2,196,208,918,856,T1
3159,March 2,2013,Gambia,Mauritania,0,0,Friendly,in The Gambia,-6,6,1303,1150,-3,3,135,168,1309,1144,draw
3160,March 2,2013,India,Taiwan,2,1,Asian Cup &amp; Asian Challenge Cup qual,in Myanmar,7,-7,1148,868,3,-1,170,205,1141,875,T1
3161,March 2,2013,Laos,Mongolia,1,1,Asian Cup &amp; Asian Challenge Cup qual,in Laos,-7,7,847,829,0,0,207,209,854,822,draw
3162,March 2,2013,Myanmar,Guam,5,0,Asian Cup &amp; Asian Challenge Cup qual,in Myanmar,7,-7,1002,683,1,-2,188,219,995,690,T1
3163,March 2,2013,Nepal,Northern Mariana Islands,6,0,Asian Cup &amp; Asian Challenge Cup qual,in Nepal,4,-4,898,454,1,0,200,234,894,458,T1
3164,March 2,2013,Palestine,Bangladesh,1,0,Asian Cup &amp; Asian Challenge Cup qual,in Nepal,5,-5,1295,951,0,0,138,194,1290,956,T1
3165,March 4,2013,Afghanistan,Mongolia,1,0,Asian Cup &amp; Asian Challenge Cup qual,in Laos,14,-14,948,815,1,0,195,209,934,829,T1
3166,March 4,2013,India,Guam,4,0,Asian Cup &amp; Asian Challenge Cup qual,in Myanmar,5,-5,1153,678,2,-1,168,220,1148,683,T1
3167,March 4,2013,Laos,Sri Lanka,4,2,Asian Cup &amp; Asian Challenge Cup qual,in Laos,21,-21,868,819,2,0,205,208,847,840,T1
3168,March 4,2013,Myanmar,Taiwan,1,1,Asian Cup &amp; Asian Challenge Cup qual,in Myanmar,-12,12,990,880,-2,3,190,202,1002,868,draw
3169,March 4,2013,Nepal,Bangladesh,0,2,Asian Cup &amp; Asian Challenge Cup qual,in Nepal,-34,34,864,985,-6,3,206,191,898,951,T2
3170,March 4,2013,Palestine,Northern Mariana Islands,9,0,Asian Cup &amp; Asian Challenge Cup qual,in Nepal,1,-1,1296,453,0,0,138,234,1295,454,T1
3171,March 6,2013,Bangladesh,Northern Mariana Islands,4,0,Asian Cup &amp; Asian Challenge Cup qual,in Nepal,3,-3,988,450,0,0,191,234,985,453,T1
3172,March 6,2013,Guam,Taiwan,3,0,Asian Cup &amp; Asian Challenge Cup qual,in Myanmar,53,-53,731,827,8,-6,212,208,678,880,T1
3173,March 6,2013,Laos,Afghanistan,1,1,Asian Cup &amp; Asian Challenge Cup qual,in Laos,-1,1,867,949,0,0,205,195,868,948,draw
3174,March 6,2013,Myanmar,India,1,0,Asian Cup &amp; Asian Challenge Cup qual,in Myanmar,24,-24,1014,1129,4,-6,186,174,990,1153,T1
3175,March 6,2013,Nepal,Palestine,0,0,Asian Cup &amp; Asian Challenge Cup qual,in Nepal,15,-15,879,1281,4,-1,202,139,864,1296,draw
3176,March 6,2013,Sri Lanka,Mongolia,3,0,Asian Cup &amp; Asian Challenge Cup qual,in Laos,35,-35,854,780,2,-1,206,210,819,815,T1
3177,March 7,2013,Qatar,Egypt,3,1,Friendly,in Qatar,19,-19,1487,1654,2,-4,92,49,1468,1673,T1
3178,March 13,2013,Mozambique,Swaziland,0,0,Friendly,in Mozambique,-7,7,1328,1113,0,0,127,177,1335,1106,draw
3179,March 17,2013,Bahrain,Lebanon,0,0,Friendly,in Bahrain,-6,6,1446,1314,0,3,100,129,1452,1308,draw
3180,March 17,2013,Kyrgyzstan,Macao,1,0,Asian Cup &amp; Asian Challenge Cup qual,in Kyrgyzstan,1,-1,1124,629,0,0,175,226,1123,630,T1
3181,March 17,2013,Malaysia,Saudi Arabia,1,4,Friendly,in Malaysia,-8,8,1179,1503,-1,3,161,87,1187,1495,T2
3182,March 17,2013,Qatar,Thailand,1,0,Friendly,in Qatar,4,-4,1491,1348,0,0,92,125,1487,1352,T1
3183,March 17,2013,Tajikistan,Pakistan,1,0,Asian Cup &amp; Asian Challenge Cup qual,in Kyrgyzstan,6,-6,1251,926,2,-2,143,199,1245,932,T1
3184,March 19,2013,Botswana,Malawi,1,0,Friendly,in Botswana,9,-9,1299,1359,1,-2,137,122,1290,1368,T1
3185,March 19,2013,Kyrgyzstan,Pakistan,1,0,Asian Cup &amp; Asian Challenge Cup qual,in Kyrgyzstan,6,-6,1130,920,1,0,174,199,1124,926,T1
3186,March 19,2013,Tajikistan,Macao,3,0,Asian Cup &amp; Asian Challenge Cup qual,in Kyrgyzstan,2,-2,1253,627,0,0,143,226,1251,629,T1
3187,March 20,2013,Niger,Gambia,1,3,Friendly,in Niger,-21,21,1319,1324,-2,8,128,127,1340,1303,T2
3188,March 20,2013,Oman,Haiti,3,0,Friendly,in Oman,10,-10,1522,1446,2,-2,81,99,1512,1456,T1
3189,March 20,2013,Rwanda,Libya,0,1,Friendly,in Rwanda,-8,8,1365,1549,-3,2,119,74,1373,1541,T2
3190,March 21,2013,Brazil,Italy,2,2,Friendly,in Switzerland,-4,4,2046,1920,0,0,3,7,2050,1916,draw
3191,March 21,2013,Ecuador,El Salvador,5,0,Friendly,in Ecuador,3,-3,1867,1539,0,-1,15,77,1864,1542,T1
3192,March 21,2013,Jordan,Belarus,1,0,Friendly,in Jordan,10,-10,1512,1589,4,-6,84,62,1502,1599,T1
3193,March 21,2013,Kuwait,Palestine,2,1,Friendly,in Kuwait,2,-2,1552,1279,0,-1,73,140,1550,1281,T1
3194,March 21,2013,Kyrgyzstan,Tajikistan,1,0,Asian Cup &amp; Asian Challenge Cup qual,in Kyrgyzstan,21,-21,1151,1232,6,-5,168,148,1130,1253,T1
3195,March 21,2013,Pakistan,Macao,2,0,Asian Cup &amp; Asian Challenge Cup qual,in Kyrgyzstan,9,-9,929,618,0,0,199,226,920,627,T1
3196,March 22,2013,Andorra,Turkey,0,2,World Cup qualifier,in Andorra,-2,2,990,1688,0,2,190,40,992,1686,T2
3197,March 22,2013,Argentina,Venezuela,3,0,World Cup qualifier,in Argentina,6,-6,2030,1704,0,0,4,36,2024,1710,T1
3198,March 22,2013,Austria,Faroe Islands,6,0,World Cup qualifier,in Austria,5,-5,1601,1206,-1,1,58,152,1596,1211,T1
3199,March 22,2013,Bahrain,Qatar,1,0,Asian Cup qualifier,in Bahrain,17,-17,1463,1474,3,-2,96,94,1446,1491,T1
3200,March 22,2013,Bosnia and Herzegovina,Greece,3,1,World Cup qualifier,in Bosnia and Herzegovina,27,-27,1788,1795,2,-3,24,22,1761,1822,T1
3201,March 22,2013,Bulgaria,Malta,6,0,World Cup qualifier,in Bulgaria,4,-4,1666,1241,1,-1,45,146,1662,1245,T1
3202,March 22,2013,China,Iraq,1,0,Asian Cup qualifier,in China,15,-15,1609,1590,2,-5,57,60,1594,1605,T1
3203,March 22,2013,Colombia,Bolivia,5,0,World Cup qualifier,in Colombia,8,-8,1913,1624,0,-2,8,52,1905,1632,T1
3204,March 22,2013,Croatia,Serbia,2,0,World Cup qualifier,in Croatia,9,-9,1902,1685,2,-5,9,42,1893,1694,T1
3205,March 22,2013,Czechia,Denmark,0,3,World Cup qualifier,in Czechia,-48,48,1743,1800,-9,6,31,21,1791,1752,T2
3206,March 22,2013,Egypt,Swaziland,10,0,Friendly,in Egypt,1,-1,1655,1112,1,0,48,177,1654,1113,T1
3207,March 22,2013,France,Georgia,3,1,World Cup qualifier,in France,4,-4,1885,1522,2,-3,12,81,1881,1526,T1
3208,March 22,2013,Honduras,Mexico,2,2,World Cup qualifier,in Honduras,6,-6,1690,1894,4,-1,39,10,1684,1900,draw
3209,March 22,2013,Hong Kong,Vietnam,1,0,Asian Cup qualifier,in Hong Kong,17,-17,1202,1219,6,-5,154,151,1185,1236,T1
3210,March 22,2013,Hungary,Romania,2,2,World Cup qualifier,in Hungary,-1,1,1688,1766,0,-1,40,25,1689,1765,draw
3211,March 22,2013,Israel,Portugal,3,3,World Cup qualifier,in Israel,9,-9,1634,1881,3,-2,50,14,1625,1890,draw
3212,March 22,2013,Jamaica,Panama,1,1,World Cup qualifier,in Jamaica,1,-1,1578,1693,0,0,67,37,1577,1694,draw
3213,March 22,2013,Japan,Canada,2,1,Friendly,in Qatar,4,-4,1827,1589,0,-1,18,61,1823,1593,T1
3214,March 22,2013,Lebanon,Thailand,5,2,Asian Cup qualifier,in Lebanon,28,-28,1342,1320,5,-3,125,128,1314,1348,T1
3215,March 22,2013,Liechtenstein,Latvia,1,1,World Cup qualifier,in Liechtenstein,12,-12,1190,1495,3,-5,159,91,1178,1507,draw
3216,March 22,2013,Luxembourg,Azerbaijan,0,0,World Cup qualifier,in Luxembourg,9,-9,1164,1410,2,-1,165,107,1155,1419,draw
3217,March 22,2013,Macedonia,Belgium,0,2,World Cup qualifier,in Macedonia,-19,19,1534,1808,-5,3,77,20,1553,1789,T2
3218,March 22,2013,Malaysia,Yemen,2,1,Asian Cup qualifier,in Malaysia,17,-17,1196,1202,3,-2,158,154,1179,1219,T1
3219,March 22,2013,Moldova,Montenegro,0,1,World Cup qualifier,in Moldova,-10,10,1383,1691,-3,6,113,38,1393,1681,T2
3220,March 22,2013,Netherlands,Estonia,3,0,World Cup qualifier,in the Netherlands,2,-2,1994,1490,0,-1,5,92,1992,1492,T1
3221,March 22,2013,New Zealand,New Caledonia,2,1,World Cup qualifier,in New Zealand,5,-5,1581,1349,2,0,66,124,1576,1354,T1
3222,March 22,2013,Norway,Albania,0,1,World Cup qualifier,in Norway,-35,35,1712,1532,-6,11,35,78,1747,1497,T2
3223,March 22,2013,Peru,Chile,1,0,World Cup qualifier,in Peru,20,-20,1737,1793,3,-3,32,23,1717,1813,T1
3224,March 22,2013,Poland,Ukraine,1,3,World Cup qualifier,in Poland,-35,35,1659,1765,-10,6,47,26,1694,1730,T2
3225,March 22,2013,San Marino,England,0,8,World Cup qualifier,in San Marino,0,0,884,1963,0,0,201,6,884,1963,T2
3226,March 22,2013,Scotland,Wales,1,2,World Cup qualifier,in Scotland,-29,29,1632,1617,-3,10,51,53,1661,1588,T2
3227,March 22,2013,Slovakia,Lithuania,1,1,World Cup qualifier,in Slovakia,-12,12,1587,1481,-7,1,63,93,1599,1469,draw
3228,March 22,2013,Slovenia,Iceland,1,2,World Cup qualifier,in Slovenia,-31,31,1555,1513,-6,8,70,85,1586,1482,T2
3229,March 22,2013,Spain,Finland,1,1,World Cup qualifier,in Spain,-19,19,2136,1647,0,3,1,49,2155,1628,draw
3230,March 22,2013,Sweden,Ireland,0,0,World Cup qualifier,in Sweden,-13,13,1883,1752,-3,2,13,29,1896,1739,draw
3231,March 22,2013,Tahiti,Solomon Islands,2,0,World Cup qualifier,in Tahiti,20,-20,1245,1185,5,-8,145,162,1225,1205,T1
3232,March 22,2013,Turkmenistan,Cambodia,7,0,Asian Cup &amp; Asian Challenge Cup qual,in the Philippines,2,-2,1372,676,1,-1,116,222,1370,678,T1
3233,March 22,2013,United Arab Emirates,Uzbekistan,2,1,Asian Cup qualifier,in the United Arab Emirates,16,-16,1612,1613,2,-3,55,54,1596,1629,T1
3234,March 22,2013,Uruguay,Paraguay,1,1,World Cup qualifier,in Uruguay,-11,11,1839,1736,0,0,16,33,1850,1725,draw
3235,March 22,2013,United States,Costa Rica,1,0,World Cup qualifier,in the United States,12,-12,1756,1677,2,-3,28,43,1744,1689,T1
3236,March 23,2013,Angola,Senegal,1,1,World Cup qualifier,in Guinea,4,-4,1459,1518,1,-2,97,83,1455,1522,draw
3237,March 23,2013,Belize,Trinidad and Tobago,0,0,Friendly,in Belize,5,-5,1163,1425,0,-1,167,105,1158,1430,draw
3238,March 23,2013,Burkina Faso,Niger,4,0,World Cup qualifier,in Burkina Faso,11,-11,1534,1308,3,-2,76,131,1523,1319,T1
3239,March 23,2013,Cameroon,Togo,2,1,World Cup qualifier,in Cameroon,8,-8,1593,1437,5,-1,59,102,1585,1445,T1
3240,March 23,2013,Congo,Gabon,1,0,World Cup qualifier,in Congo,23,-23,1410,1517,4,-9,107,84,1387,1540,T1
3241,March 23,2013,Cyprus,Switzerland,0,0,World Cup qualifier,in Cyprus,14,-14,1430,1820,2,-1,104,18,1416,1834,draw
3242,March 23,2013,Indonesia,Saudi Arabia,1,2,Asian Cup qualifier,in Indonesia,-11,11,1215,1514,-2,4,151,85,1226,1503,T2
3243,March 23,2013,Ivory Coast,Gambia,3,0,World Cup qualifier,in Ivory Coast,2,-2,1811,1322,0,0,19,127,1809,1324,T1
3244,March 23,2013,Kazakhstan,Germany,0,3,World Cup qualifier,in Kazakhstan,-2,2,1355,2062,1,0,122,2,1357,2060,T2
3245,March 23,2013,Namibia,Malawi,0,1,World Cup qualifier,in Namibia,-23,23,1290,1382,-7,8,138,114,1313,1359,T2
3246,March 23,2013,Nigeria,Kenya,1,1,World Cup qualifier,in Nigeria,-17,17,1706,1405,-1,1,35,109,1723,1388,draw
3247,March 23,2013,South Africa,Central African Republic,2,0,World Cup qualifier,in South Africa,7,-7,1564,1304,1,-2,68,134,1557,1311,T1
3248,March 23,2013,Tunisia,Sierra Leone,2,1,World Cup qualifier,in Tunisia,5,-5,1588,1355,1,-1,64,122,1583,1360,T1
3249,March 24,2013,Dominican Republic,Haiti,3,1,Friendly,in the Dominican Republic,19,-19,1270,1427,2,-4,141,104,1251,1446,T1
3250,March 24,2013,Democratic Republic of Congo,Libya,0,0,World Cup qualifier,in the Democratic Republic of the Congo,0,0,1457,1549,1,2,97,71,1457,1549,draw
3251,March 24,2013,Equatorial Guinea,Cape Verde,4,3,World Cup qualifier,in Equatorial Guinea,24,-24,1322,1443,9,-4,128,99,1298,1467,T1
3252,March 24,2013,Ethiopia,Botswana,1,0,World Cup qualifier,in Ethiopia,14,-14,1322,1285,3,-2,128,138,1308,1299,T1
3253,March 24,2013,Ghana,Sudan,4,0,World Cup qualifier,in Ghana,7,-7,1675,1372,0,-2,44,117,1668,1379,T1
3254,March 24,2013,Lesotho,Zambia,1,1,World Cup qualifier,in Lesotho,14,-14,1160,1540,3,-1,168,72,1146,1554,draw
3255,March 24,2013,Liberia,Uganda,2,0,World Cup qualifier,in Liberia,43,-43,1346,1520,10,-11,125,80,1303,1563,T1
3256,March 24,2013,Mozambique,Guinea,0,0,World Cup qualifier,in Mozambique,4,-4,1332,1501,-1,0,127,89,1328,1505,draw
3257,March 24,2013,Philippines,Cambodia,8,0,Asian Cup &amp; Asian Challenge Cup qual,in the Philippines,3,-3,1192,673,1,-1,159,223,1189,676,T1
3258,March 24,2013,Rwanda,Mali,1,2,World Cup qualifier,in Rwanda,-12,12,1353,1623,-3,3,123,53,1365,1611,T2
3259,March 24,2013,Tanzania,Morocco,3,1,World Cup qualifier,in Tanzania,37,-37,1407,1512,10,-13,109,86,1370,1549,T1
3260,March 25,2013,Belarus,Canada,2,0,Friendly,in Qatar,15,-15,1604,1574,4,-5,58,67,1589,1589,T1
3261,March 25,2013,Brazil,Russia,1,1,Friendly,in England,-4,4,2042,1894,0,1,3,10,2046,1890,draw
3262,March 26,2013,Albania,Lithuania,4,1,Friendly,in Albania,10,-10,1542,1471,3,0,73,93,1532,1481,T1
3263,March 26,2013,Algeria,Benin,3,1,World Cup qualifier,in Algeria,14,-14,1525,1386,9,-1,79,112,1511,1400,T1
3264,March 26,2013,Armenia,Czechia,0,3,World Cup qualifier,in Armenia,-23,23,1500,1766,-12,4,89,27,1523,1743,T2
3265,March 26,2013,Australia,Oman,2,2,World Cup qualifier,in Australia,-15,15,1748,1537,-3,2,30,76,1763,1522,draw
3266,March 26,2013,Azerbaijan,Portugal,0,2,World Cup qualifier,in Azerbaijan,-6,6,1404,1887,-3,4,110,10,1410,1881,T2
3267,March 26,2013,Belgium,Macedonia,1,0,World Cup qualifier,in Belgium,4,-4,1812,1530,1,-4,19,78,1808,1534,T1
3268,March 26,2013,Bolivia,Argentina,1,1,World Cup qualifier,in Bolivia,14,-14,1638,2016,1,0,51,4,1624,2030,draw
3269,March 26,2013,Chile,Uruguay,2,0,World Cup qualifier,in Chile,25,-25,1818,1814,6,-2,17,18,1793,1839,T1
3270,March 26,2013,Costa Rica,Jamaica,2,0,World Cup qualifier,in Costa Rica,14,-14,1691,1564,2,-1,41,67,1677,1578,T1
3271,March 26,2013,Denmark,Bulgaria,1,1,World Cup qualifier,in Denmark,-12,12,1788,1678,-2,2,23,43,1800,1666,draw
3272,March 26,2013,Ecuador,Paraguay,4,1,World Cup qualifier,in Ecuador,15,-15,1882,1721,3,-1,12,34,1867,1736,T1
3273,March 26,2013,Egypt,Zimbabwe,2,1,World Cup qualifier,in Egypt,4,-4,1659,1367,0,1,48,118,1655,1371,T1
3274,March 26,2013,Estonia,Andorra,2,0,World Cup qualifier,in Estonia,2,-2,1492,988,0,0,92,190,1490,990,T1
3275,March 26,2013,France,Spain,0,1,World Cup qualifier,in France,-12,12,1873,2148,-3,0,15,1,1885,2136,T2
3276,March 26,2013,Germany,Kazakhstan,4,1,World Cup qualifier,in Germany,1,-1,2063,1354,0,-1,2,122,2062,1355,T1
3277,March 26,2013,Iraq,Syria,2,1,Friendly,in Iraq,5,-5,1595,1515,2,-4,60,84,1590,1520,T1
3278,March 26,2013,Ireland,Austria,2,2,World Cup qualifier,in Ireland,-12,12,1740,1613,-2,4,31,55,1752,1601,draw
3279,March 26,2013,Jordan,Japan,2,1,World Cup qualifier,in Jordan,31,-31,1543,1796,14,-4,72,21,1512,1827,T1
3280,March 26,2013,Kuwait,Iran,1,1,Asian Cup qualifier,in Kuwait,1,-1,1553,1661,0,0,70,46,1552,1662,draw
3281,March 26,2013,Luxembourg,Finland,0,3,Friendly,in Luxembourg,-3,3,1161,1650,-2,-1,167,50,1164,1647,T2
3282,March 26,2013,Malaysia,Palestine,0,2,Friendly,in Malaysia,-16,16,1180,1295,-3,3,161,137,1196,1279,T2
3283,March 26,2013,Malta,Italy,0,2,World Cup qualifier,in Malta,-2,2,1239,1922,1,0,145,7,1241,1920,T2
3284,March 26,2013,Mexico,United States,0,0,World Cup qualifier,in Mexico,-12,12,1882,1768,-2,3,12,25,1894,1756,draw
3285,March 26,2013,Montenegro,England,1,1,World Cup qualifier,in Montenegro,9,-9,1700,1954,-1,0,39,6,1691,1963,draw
3286,March 26,2013,Netherlands,Romania,4,0,World Cup qualifier,in the Netherlands,10,-10,2004,1756,0,-3,5,28,1994,1766,T1
3287,March 26,2013,New Caledonia,Tahiti,1,0,World Cup qualifier,in New Caledonia,9,-9,1358,1236,4,-1,120,146,1349,1245,T1
3288,March 26,2013,Northern Ireland,Israel,0,2,World Cup qualifier,in Northern Ireland,-22,22,1418,1656,-6,1,106,49,1440,1634,T2
3289,March 26,2013,Panama,Honduras,2,0,World Cup qualifier,in Panama,21,-21,1714,1669,2,-6,35,45,1693,1690,T1
3290,March 26,2013,Peru,Trinidad and Tobago,3,0,Friendly,in Peru,3,-3,1740,1422,1,0,31,105,1737,1425,T1
3291,March 26,2013,Philippines,Turkmenistan,1,0,Asian Cup &amp; Asian Challenge Cup qual,in the Philippines,25,-25,1217,1347,8,-7,151,124,1192,1372,T1
3292,March 26,2013,Poland,San Marino,5,0,World Cup qualifier,in Poland,1,-1,1660,883,0,0,47,201,1659,884,T1
3293,March 26,2013,Serbia,Scotland,2,0,World Cup qualifier,in Serbia,18,-18,1703,1614,4,-3,38,54,1685,1632,T1
3294,March 26,2013,Slovakia,Sweden,0,0,Friendly,in Slovakia,5,-5,1592,1878,1,-1,63,14,1587,1883,draw
3295,March 26,2013,Solomon Islands,New Zealand,0,2,World Cup qualifier,in the Solomon Islands,-9,9,1176,1590,0,1,162,64,1185,1581,T2
3296,March 26,2013,South Korea,Qatar,2,1,World Cup qualifier,in South Korea,4,-4,1754,1470,1,0,29,94,1750,1474,T1
3297,March 26,2013,Turkey,Hungary,1,1,World Cup qualifier,in Turkey,-6,6,1682,1694,-2,0,42,40,1688,1688,draw
3298,March 26,2013,Ukraine,Moldova,2,1,World Cup qualifier,in Ukraine,2,-2,1767,1381,0,-1,26,115,1765,1383,T1
3299,March 26,2013,Uzbekistan,Lebanon,1,0,World Cup qualifier,in Uzbekistan,4,-4,1617,1338,2,0,53,126,1613,1342,T1
3300,March 26,2013,Venezuela,Colombia,1,0,World Cup qualifier,in Venezuela,26,-26,1730,1887,3,-2,33,10,1704,1913,T1
3301,March 26,2013,Wales,Croatia,1,2,World Cup qualifier,in Wales,-10,10,1607,1912,-4,1,58,8,1617,1902,T2
3302,April 6,2013,Bolivia,Brazil,0,4,Friendly,in Bolivia,-6,6,1632,2048,0,0,51,3,1638,2042,T2
3303,April 17,2013,Mexico,Peru,0,0,Friendly,in the United States,-4,4,1878,1744,-1,0,13,31,1882,1740,draw
3304,April 17,2013,Qatar,Palestine,2,0,Friendly,in Qatar,5,-5,1475,1290,1,0,93,137,1470,1295,T1
3305,April 21,2013,Saint Vincent and the Grenadines,Saint Lucia,0,2,Windward Islands Championship,in Saint Vincent and the Grenadines,-37,37,1160,1062,-9,1,167,183,1197,1025,T2
3306,April 23,2013,Grenada,Saint Lucia,2,1,Windward Islands Championship,in Saint Vincent and the Grenadines,11,-11,1180,1051,3,0,160,183,1169,1062,T1
3307,April 24,2013,Brazil,Chile,2,2,Friendly,in Brazil,-7,7,2041,1825,0,1,3,16,2048,1818,draw
3308,April 25,2013,Saint Vincent and the Grenadines,Grenada,0,1,Windward Islands Championship,in Saint Vincent and the Grenadines,-18,18,1142,1198,-6,2,173,158,1160,1180,T2
3309,April 28,2013,Zambia,Zimbabwe,2,0,Friendly,in Zambia,5,-5,1545,1362,2,0,72,118,1540,1367,T1
3310,May 13,2013,Libya,Mauritania,2,0,Friendly,in Libya,2,-2,1551,1148,0,-1,71,170,1549,1150,T1
3311,May 22,2013,Oman,Iran,3,1,Friendly,in Oman,16,-16,1553,1645,6,-4,70,50,1537,1661,T1
3312,May 22,2013,Venezuela,El Salvador,2,1,Friendly,in Venezuela,3,-3,1733,1536,0,-1,33,76,1730,1539,T1
3313,May 24,2013,Qatar,Latvia,3,1,Friendly,in Qatar,12,-12,1487,1483,1,-2,92,93,1475,1495,T1
3314,May 25,2013,Algeria,Mauritania,1,0,Friendly,in Algeria,1,-1,1526,1147,0,0,79,170,1525,1148,T1
3315,May 25,2013,Ethiopia,Sudan,2,0,Friendly,in Ethiopia,13,-13,1335,1359,1,-2,127,119,1322,1372,T1
3316,May 25,2013,Malawi,Zimbabwe,1,1,Friendly,in Malawi,-3,3,1379,1365,-1,1,115,117,1382,1362,draw
3317,May 25,2013,Namibia,Zambia,0,0,Friendly,in Namibia,4,-4,1294,1541,0,-2,137,75,1290,1545,draw
3318,May 27,2013,Iraq,Liberia,0,1,Friendly,in Iraq,-18,18,1577,1364,-5,7,65,118,1595,1346,T2
3319,May 27,2013,Jordan,Libya,1,0,Friendly,in Jordan,7,-7,1550,1544,1,-1,72,73,1543,1551,T1
3320,May 28,2013,Canada,Costa Rica,0,1,Friendly,in Canada,-10,10,1564,1701,0,2,66,39,1574,1691,T2
3321,May 28,2013,Latvia,Turkey,3,3,Friendly,in Germany,5,-5,1488,1677,1,-1,92,43,1483,1682,draw
3322,May 29,2013,England,Ireland,1,1,Friendly,in England,-7,7,1947,1747,0,1,6,31,1954,1740,draw
3323,May 29,2013,Germany,Ecuador,4,2,Friendly,in the United States,8,-8,2071,1874,0,-2,2,14,2063,1882,T1
3324,May 29,2013,Lebanon,Oman,1,1,Friendly,in Qatar,6,-6,1344,1547,0,-2,126,72,1338,1553,draw
3325,May 29,2013,Qatar,Azerbaijan,1,1,Friendly,in Qatar,-5,5,1482,1409,0,2,93,108,1487,1404,draw
3326,May 29,2013,United States,Belgium,2,4,Friendly,in the United States,-17,17,1751,1829,-4,3,29,16,1768,1812,T2
3327,May 30,2013,Japan,Bulgaria,0,2,Friendly,in Japan,-23,23,1773,1701,-3,3,24,39,1796,1678,T2
3328,May 31,2013,Italy,San Marino,4,0,Friendly,in Italy,0,0,1922,883,0,0,7,201,1922,883,T1
3329,May 31,2013,Mexico,Nigeria,2,2,Friendly,in the United States,-5,5,1873,1711,-2,0,14,37,1878,1706,draw
3330,May 31,2013,Slovenia,Turkey,2,0,Friendly,in Germany,20,-20,1575,1657,3,-4,66,47,1555,1677,T1
3331,June 1,2013,Libya,Uganda,3,0,Friendly,in Libya,12,-12,1556,1508,3,-6,70,87,1544,1520,T1
3332,June 1,2013,Panama,Peru,1,2,Friendly,in Panama,-12,12,1702,1756,-3,5,38,27,1714,1744,T2
3333,June 2,2013,Algeria,Burkina Faso,2,0,Friendly,in Algeria,11,-11,1537,1523,3,-2,76,79,1526,1534,T1
3334,June 2,2013,Brazil,England,2,2,Friendly,in Brazil,-5,5,2036,1952,0,0,3,6,2041,1947,draw
3335,June 2,2013,Ireland,Georgia,4,0,Friendly,in Ireland,5,-5,1752,1517,1,-1,31,81,1747,1522,T1
3336,June 2,2013,Israel,Honduras,2,0,Friendly,in the United States,16,-16,1672,1653,4,-4,44,48,1656,1669,T1
3337,June 2,2013,Lesotho,South Africa,0,2,Friendly,in Lesotho,-4,4,1156,1568,0,0,167,67,1160,1564,T2
3338,June 2,2013,Sudan,Tanzania,0,0,Friendly,in Ethiopia,1,-1,1360,1406,0,0,120,109,1359,1407,draw
3339,June 2,2013,Ukraine,Cameroon,0,0,Friendly,in Ukraine,-7,7,1760,1600,-2,0,27,60,1767,1593,draw
3340,June 2,2013,United States,Germany,4,3,Friendly,in the United States,16,-16,1767,2055,5,0,25,2,1751,2071,T1
3341,June 3,2013,Estonia,Belarus,0,2,Friendly,in Estonia,-14,14,1478,1618,-2,6,93,53,1492,1604,T2
3342,June 3,2013,Sweden,Macedonia,1,0,Friendly,in Sweden,1,-1,1879,1529,0,0,12,78,1878,1530,T1
3343,June 4,2013,Egypt,Botswana,1,1,Friendly,in Egypt,-9,9,1650,1294,-3,2,49,137,1659,1285,draw
3344,June 4,2013,Hong Kong,Philippines,0,1,Friendly,in Hong Kong,-12,12,1190,1229,-3,2,158,149,1202,1217,T2
3345,June 4,2013,Jamaica,Mexico,0,1,World Cup qualifier,in Jamaica,-9,9,1555,1882,-3,2,71,12,1564,1873,T2
3346,June 4,2013,Japan,Australia,1,1,World Cup qualifier,in Japan,-7,7,1766,1755,-1,2,25,30,1773,1748,draw
3347,June 4,2013,Kazakhstan,Bulgaria,1,2,Friendly,in Kazakhstan,-4,4,1350,1705,-2,2,125,37,1354,1701,T2
3348,June 4,2013,Lebanon,South Korea,1,1,World Cup qualifier,in Lebanon,14,-14,1358,1740,5,-2,121,32,1344,1754,draw
3349,June 4,2013,Myanmar,Singapore,0,2,Friendly,in Myanmar,-9,9,1005,1278,-2,1,188,141,1014,1269,T2
3350,June 4,2013,Oman,Iraq,1,0,World Cup qualifier,in Oman,16,-16,1563,1561,5,-4,68,69,1547,1577,T1
3351,June 4,2013,Poland,Liechtenstein,2,0,Friendly,in Poland,1,-1,1661,1189,0,0,45,159,1660,1190,T1
3352,June 4,2013,Qatar,Iran,0,1,World Cup qualifier,in Qatar,-16,16,1466,1661,-2,5,94,45,1482,1645,T2
3353,June 4,2013,Romania,Trinidad and Tobago,4,0,Friendly,in Romania,3,-3,1759,1419,0,0,28,105,1756,1422,T1
3354,June 4,2013,Tajikistan,Afghanistan,3,2,Friendly,in Tajikistan,2,-2,1234,947,1,0,147,195,1232,949,T1
3355,June 5,2013,Denmark,Georgia,2,1,Friendly,in Denmark,2,-2,1790,1515,0,-1,22,82,1788,1517,T1
3356,June 5,2013,Equatorial Guinea,Togo,0,1,Friendly,in Equatorial Guinea,-10,10,1312,1447,-3,1,132,99,1322,1437,T2
3357,June 5,2013,Kenya,Nigeria,0,1,World Cup qualifier,in Kenya,-9,9,1396,1720,-1,1,111,35,1405,1711,T2
3358,June 5,2013,Malawi,Namibia,0,0,World Cup qualifier,in Malawi,-10,10,1369,1304,-1,1,116,136,1379,1294,draw
3359,June 5,2013,Uruguay,France,1,0,Friendly,in Uruguay,9,-9,1823,1864,1,0,18,15,1814,1873,T1
3360,June 6,2013,China,Uzbekistan,1,2,Friendly,in China,-13,13,1596,1630,-2,2,60,52,1609,1617,T2
3361,June 6,2013,Hungary,Kuwait,1,0,Friendly,in Hungary,4,-4,1698,1549,0,-1,42,73,1694,1553,T1
3362,June 7,2013,Albania,Norway,1,1,World Cup qualifier,in Albania,4,-4,1546,1708,2,0,72,36,1542,1712,draw
3363,June 7,2013,Argentina,Colombia,0,0,World Cup qualifier,in Argentina,-12,12,2004,1899,-1,1,5,9,2016,1887,draw
3364,June 7,2013,Armenia,Malta,0,1,World Cup qualifier,in Armenia,-36,36,1464,1275,-5,3,94,142,1500,1239,T2
3365,June 7,2013,Austria,Sweden,2,1,World Cup qualifier,in Austria,29,-29,1642,1850,5,-2,51,15,1613,1879,T1
3366,June 7,2013,Azerbaijan,Luxembourg,1,1,World Cup qualifier,in Azerbaijan,-15,15,1394,1176,-3,4,111,162,1409,1161,draw
3367,June 7,2013,Belgium,Serbia,2,1,World Cup qualifier,in Belgium,9,-9,1838,1694,-1,-3,17,41,1829,1703,T1
3368,June 7,2013,Bolivia,Venezuela,1,1,World Cup qualifier,in Bolivia,0,0,1632,1733,-2,0,53,33,1632,1733,draw
3369,June 7,2013,Costa Rica,Honduras,1,0,World Cup qualifier,in Costa Rica,12,-12,1713,1641,5,-4,35,52,1701,1653,T1
3370,June 7,2013,Croatia,Scotland,0,1,World Cup qualifier,in Croatia,-36,36,1876,1650,-4,6,12,49,1912,1614,T2
3371,June 7,2013,Czechia,Italy,0,0,World Cup qualifier,in Czechia,3,-3,1769,1919,-2,0,27,7,1766,1922,draw
3372,June 7,2013,Estonia,Trinidad and Tobago,1,0,Friendly,in Estonia,6,-6,1484,1413,3,-1,89,106,1478,1419,T1
3373,June 7,2013,Finland,Belarus,1,0,World Cup qualifier,in Finland,13,-13,1663,1605,5,-5,44,59,1650,1618,T1
3374,June 7,2013,Iceland,Slovenia,2,4,World Cup qualifier,in Iceland,-33,33,1480,1608,-5,8,90,57,1513,1575,T2
3375,June 7,2013,Indonesia,Netherlands,0,3,Friendly,in Indonesia,-1,1,1214,2005,0,1,152,4,1215,2004,T2
3376,June 7,2013,Ireland,Faroe Islands,3,0,World Cup qualifier,in Ireland,2,-2,1754,1204,0,0,31,153,1752,1206,T1
3377,June 7,2013,Jamaica,United States,1,2,World Cup qualifier,in Jamaica,-14,14,1541,1781,-3,-1,74,25,1555,1767,T2
3378,June 7,2013,Laos,Singapore,2,5,Friendly,in Laos,-5,5,862,1283,0,1,205,140,867,1278,T2
3379,June 7,2013,Latvia,Bosnia and Herzegovina,0,5,World Cup qualifier,in Latvia,-19,19,1469,1807,0,2,91,21,1488,1788,T2
3380,June 7,2013,Libya,Democratic Republic of Congo,0,0,World Cup qualifier,in Libya,-10,10,1546,1467,-2,5,72,92,1556,1457,draw
3381,June 7,2013,Liechtenstein,Slovakia,1,1,World Cup qualifier,in Liechtenstein,14,-14,1203,1578,5,-3,154,65,1189,1592,draw
3382,June 7,2013,Lithuania,Greece,0,1,World Cup qualifier,in Lithuania,-9,9,1462,1804,-3,-1,96,22,1471,1795,T2
3383,June 7,2013,Moldova,Poland,1,1,World Cup qualifier,in Moldova,10,-10,1391,1651,2,-3,112,48,1381,1661,draw
3384,June 7,2013,Montenegro,Ukraine,0,4,World Cup qualifier,in Montenegro,-42,42,1658,1802,-5,4,46,23,1700,1760,T2
3385,June 7,2013,Panama,Mexico,0,0,World Cup qualifier,in Panama,5,-5,1707,1877,2,1,37,11,1702,1882,draw
3386,June 7,2013,Paraguay,Chile,1,2,World Cup qualifier,in Paraguay,-20,20,1701,1845,-5,1,39,16,1721,1825,T2
3387,June 7,2013,Peru,Ecuador,1,0,World Cup qualifier,in Peru,21,-21,1777,1853,3,0,26,14,1756,1874,T1
3388,June 7,2013,Portugal,Russia,1,0,World Cup qualifier,in Portugal,15,-15,1902,1879,2,-1,8,10,1887,1894,T1
3389,June 7,2013,Sudan,Ghana,1,3,World Cup qualifier,in Sudan,-13,13,1347,1688,-5,1,125,42,1360,1675,T2
3390,June 8,2013,Angola,Senegal,1,1,World Cup qualifier,in Angola,-2,2,1457,1520,0,-1,97,81,1459,1518,draw
3391,June 8,2013,Botswana,Ethiopia,1,2,World Cup qualifier,in Botswana,-23,23,1271,1358,-4,7,142,120,1294,1335,T2
3392,June 8,2013,Cape Verde,Equatorial Guinea,2,1,World Cup qualifier,in Cape Verde,8,-8,1451,1304,1,-3,99,135,1443,1312,T1
3393,June 8,2013,Gabon,Congo,0,0,World Cup qualifier,in Gabon,-11,11,1506,1421,-5,2,86,105,1517,1410,draw
3394,June 8,2013,Gambia,Ivory Coast,0,3,World Cup qualifier,in The Gambia,-7,7,1315,1818,-2,0,131,20,1322,1811,T2
3395,June 8,2013,Morocco,Tanzania,2,1,World Cup qualifier,in Morocco,9,-9,1521,1397,5,-1,80,109,1512,1406,T1
3396,June 8,2013,Sierra Leone,Tunisia,2,2,World Cup qualifier,in Sierra Leone,7,-7,1362,1581,4,0,118,64,1355,1588,draw
3397,June 8,2013,South Africa,Central African Republic,3,0,World Cup qualifier,in Cameroon,13,-13,1581,1291,2,-1,64,137,1568,1304,T1
3398,June 8,2013,Spain,Haiti,2,1,Friendly,in the United States,0,0,2148,1427,0,0,1,103,2148,1427,T1
3399,June 8,2013,Switzerland,Cyprus,1,0,World Cup qualifier,in Switzerland,2,-2,1822,1428,0,0,19,102,1820,1430,T1
3400,June 8,2013,Uganda,Liberia,1,0,World Cup qualifier,in Uganda,8,-8,1516,1356,4,-5,82,123,1508,1364,T1
3401,June 8,2013,Zambia,Lesotho,4,0,World Cup qualifier,in Zambia,4,-4,1545,1152,0,0,74,167,1541,1156,T1
3402,June 9,2013,Benin,Algeria,1,3,World Cup qualifier,in Benin,-26,26,1360,1563,-6,8,119,68,1386,1537,T2
3403,June 9,2013,Brazil,France,3,0,Friendly,in Brazil,6,-6,2042,1858,0,0,3,13,2036,1864,T1
3404,June 9,2013,Guinea,Mozambique,6,1,World Cup qualifier,in Guinea,14,-14,1515,1318,4,-1,83,129,1501,1332,T1
3405,June 9,2013,Mali,Rwanda,1,1,World Cup qualifier,in Mali,-16,16,1607,1369,-2,9,57,115,1623,1353,draw
3406,June 9,2013,Niger,Burkina Faso,0,1,World Cup qualifier,in Niger,-14,14,1294,1537,-3,2,136,77,1308,1523,T2
3407,June 9,2013,Togo,Cameroon,2,0,World Cup qualifier,in Togo,35,-35,1482,1565,10,-6,90,66,1447,1600,T1
3408,June 9,2013,Zimbabwe,Egypt,2,4,World Cup qualifier,in Zimbabwe,-15,15,1350,1665,-7,5,124,44,1365,1650,T2
3409,June 10,2013,Portugal,Croatia,1,0,Friendly,in Switzerland,9,-9,1911,1867,0,0,8,12,1902,1876,T1
3410,June 11,2013,Australia,Jordan,4,0,World Cup qualifier,in Australia,11,-11,1766,1539,3,-4,27,75,1755,1550,T1
3411,June 11,2013,Belarus,Finland,1,1,World Cup qualifier,in Belarus,-2,2,1603,1665,0,0,59,45,1605,1663,draw
3412,June 11,2013,Chile,Bolivia,3,1,World Cup qualifier,in Chile,8,-8,1853,1624,1,0,15,53,1845,1632,T1
3413,June 11,2013,China,Netherlands,0,2,Friendly,in China,-4,4,1592,2009,0,0,60,4,1596,2005,T2
3414,June 11,2013,Colombia,Peru,2,0,World Cup qualifier,in Colombia,13,-13,1912,1764,2,-2,7,28,1899,1777,T1
3415,June 11,2013,Denmark,Armenia,0,4,World Cup qualifier,in Denmark,-69,69,1721,1533,-9,17,33,78,1790,1464,T2
3416,June 11,2013,Ecuador,Argentina,1,1,World Cup qualifier,in Ecuador,3,-3,1856,2001,0,0,14,5,1853,2004,draw
3417,June 11,2013,Estonia,Kyrgyzstan,1,1,Friendly,in Estonia,-8,8,1476,1159,-3,1,92,167,1484,1151,draw
3418,June 11,2013,Guatemala,Belize,0,0,Friendly,in Guatemala,-8,8,1489,1171,-1,1,89,165,1497,1163,draw
3419,June 11,2013,Haiti,Italy,2,2,Friendly,in Brazil,9,-9,1436,1910,2,-2,101,9,1427,1919,draw
3420,June 11,2013,Honduras,Jamaica,2,0,World Cup qualifier,in Honduras,14,-14,1655,1527,3,-3,49,79,1641,1541,T1
3421,June 11,2013,Iran,Lebanon,4,0,World Cup qualifier,in Iran,7,-7,1668,1351,2,-3,44,123,1661,1358,T1
3422,June 11,2013,Japan,Iraq,1,0,World Cup qualifier,in Qatar,9,-9,1775,1552,3,0,25,70,1766,1561,T1
3423,June 11,2013,Mexico,Costa Rica,0,0,World Cup qualifier,in Mexico,-13,13,1864,1726,-1,3,12,32,1877,1713,draw
3424,June 11,2013,Norway,Macedonia,2,0,Friendly,in Norway,5,-5,1713,1524,1,-1,35,80,1708,1529,T1
3425,June 11,2013,Qatar,North Korea,0,0,Friendly,in Qatar,1,-1,1467,1592,0,1,94,60,1466,1593,draw
3426,June 11,2013,South Korea,Uzbekistan,1,0,World Cup qualifier,in South Korea,9,-9,1749,1621,1,0,31,54,1740,1630,T1
3427,June 11,2013,Spain,Ireland,2,0,Friendly,in the United States,3,-3,2151,1751,0,1,1,30,2148,1754,T1
3428,June 11,2013,Sweden,Faroe Islands,2,0,World Cup qualifier,in Sweden,1,-1,1851,1203,-1,0,16,153,1850,1204,T1
3429,June 11,2013,United States,Panama,2,0,World Cup qualifier,in the United States,16,-16,1797,1691,1,-4,24,41,1781,1707,T1
3430,June 11,2013,Venezuela,Uruguay,0,1,World Cup qualifier,in Venezuela,-21,21,1712,1844,-3,1,36,17,1733,1823,T2
3431,June 12,2013,Ghana,Ivory Coast,2,1,Friendly,in Ghana,11,-11,1699,1807,3,0,39,20,1688,1818,T1
3432,June 12,2013,Malawi,Kenya,2,2,World Cup qualifier,in Malawi,-4,4,1365,1400,-1,2,116,108,1369,1396,draw
3433,June 12,2013,Namibia,Nigeria,1,1,World Cup qualifier,in Namibia,14,-14,1318,1706,5,-2,129,36,1304,1720,draw
3434,June 14,2013,Ghana,Ivory Coast,1,1,Friendly,in Ghana,0,0,1699,1807,0,0,39,20,1699,1807,draw
3435,June 14,2013,Guatemala,Argentina,0,4,Friendly,in Guatemala,-3,3,1486,2004,0,0,89,5,1489,2001,T2
3436,June 14,2013,Libya,Togo,2,0,World Cup qualifier,in Libya,17,-17,1563,1465,4,-5,68,95,1546,1482,T1
3437,June 14,2013,Moldova,Kyrgyzstan,2,1,Friendly,in Moldova,3,-3,1394,1156,1,0,111,167,1391,1159,T1
3438,June 15,2013,Botswana,Central African Republic,3,2,World Cup qualifier,in Botswana,15,-15,1286,1276,5,-4,137,141,1271,1291,T1
3439,June 15,2013,Brazil,Japan,3,0,Confederations Cup,in Brazil,9,-9,2051,1766,0,-1,3,26,2042,1775,T1
3440,June 15,2013,Cape Verde,Sierra Leone,1,0,World Cup qualifier,in Cape Verde,10,-10,1461,1352,2,-7,98,124,1451,1362,T1
3441,June 15,2013,China,Thailand,1,5,Friendly,in China,-34,34,1558,1354,-10,5,70,123,1592,1320,T2
3442,June 15,2013,Congo,Burkina Faso,0,1,World Cup qualifier,in Congo,-19,19,1402,1556,-2,5,107,71,1421,1537,T2
3443,June 15,2013,Gabon,Niger,4,1,World Cup qualifier,in Gabon,10,-10,1516,1284,4,-2,84,138,1506,1294,T1
3444,June 15,2013,Morocco,Gambia,2,0,World Cup qualifier,in Morocco,9,-9,1530,1306,2,-2,79,134,1521,1315,T1
3445,June 15,2013,Uganda,Angola,2,1,World Cup qualifier,in Uganda,11,-11,1527,1446,3,-2,80,100,1516,1457,T1
3446,June 15,2013,Zambia,Sudan,1,1,World Cup qualifier,in Zambia,-14,14,1531,1361,-4,8,78,118,1545,1347,draw
3447,June 16,2013,Democratic Republic of Congo,Cameroon,0,0,World Cup qualifier,in the Democratic Republic of the Congo,0,0,1467,1565,0,0,93,65,1467,1565,draw
3448,June 16,2013,Equatorial Guinea,Tunisia,1,1,World Cup qualifier,in Equatorial Guinea,9,-9,1313,1572,4,-2,131,64,1304,1581,draw
3449,June 16,2013,Ethiopia,South Africa,2,1,World Cup qualifier,in Ethiopia,27,-27,1385,1554,7,-9,113,71,1358,1581,T1
3450,June 16,2013,Guinea,Zimbabwe,1,0,World Cup qualifier,in Guinea,7,-7,1522,1343,1,-1,84,127,1515,1350,T1
3451,June 16,2013,Italy,Mexico,2,1,Confederations Cup,in Brazil,22,-22,1932,1842,2,-4,7,16,1910,1864,T1
3452,June 16,2013,Lesotho,Ghana,0,2,World Cup qualifier,in Lesotho,-4,4,1148,1703,-1,1,169,38,1152,1699,T2
3453,June 16,2013,Liberia,Senegal,0,2,World Cup qualifier,in Liberia,-25,25,1331,1545,-6,8,128,75,1356,1520,T2
3454,June 16,2013,Mali,Benin,2,2,World Cup qualifier,in Mali,-15,15,1592,1375,-2,3,59,116,1607,1360,draw
3455,June 16,2013,Mozambique,Egypt,0,1,World Cup qualifier,in Mozambique,-8,8,1310,1673,-4,2,133,43,1318,1665,T2
3456,June 16,2013,Rwanda,Algeria,0,1,World Cup qualifier,in Rwanda,-15,15,1354,1578,-6,5,121,62,1369,1563,T2
3457,June 16,2013,Spain,Uruguay,2,1,Confederations Cup,in Brazil,7,-7,2158,1837,0,-1,1,18,2151,1844,T1
3458,June 16,2013,Tanzania,Ivory Coast,2,4,World Cup qualifier,in Tanzania,-9,9,1388,1816,-2,0,112,20,1397,1807,T2
3459,June 17,2013,Nigeria,Tahiti,6,1,Confederations Cup,in Brazil,6,-6,1712,1230,1,-2,35,148,1706,1236,T1
3460,June 18,2013,Australia,Iraq,1,0,World Cup qualifier,in Australia,6,-6,1772,1546,1,-2,25,74,1766,1552,T1
3461,June 18,2013,Costa Rica,Panama,2,0,World Cup qualifier,in Costa Rica,19,-19,1745,1672,1,-2,31,44,1726,1691,T1
3462,June 18,2013,Jordan,Oman,1,0,World Cup qualifier,in Jordan,16,-16,1555,1547,6,-6,70,73,1539,1563,T1
3463,June 18,2013,South Korea,Iran,0,1,World Cup qualifier,in South Korea,-30,30,1719,1698,-2,5,33,40,1749,1668,T2
3464,June 18,2013,United States,Honduras,1,0,World Cup qualifier,in the United States,8,-8,1805,1647,2,-2,22,51,1797,1655,T1
3465,June 18,2013,Uzbekistan,Qatar,5,1,World Cup qualifier,in Uzbekistan,14,-14,1635,1453,1,-6,53,99,1621,1467,T1
3466,June 19,2013,Brazil,Mexico,2,0,Confederations Cup,in Brazil,11,-11,2062,1831,1,-2,2,18,2051,1842,T1
3467,June 19,2013,Italy,Japan,4,3,Confederations Cup,in Brazil,14,-14,1946,1752,0,-2,7,29,1932,1766,T1
3468,June 20,2013,Spain,Tahiti,10,0,Confederations Cup,in Brazil,1,-1,2159,1229,0,0,1,148,2158,1230,T1
3469,June 20,2013,Uruguay,Nigeria,2,1,Confederations Cup,in Brazil,16,-16,1853,1696,3,-6,14,41,1837,1712,T1
3470,June 22,2013,Brazil,Italy,4,2,Confederations Cup,in Brazil,17,-17,2079,1929,0,0,2,7,2062,1946,T1
3471,June 22,2013,Mexico,Japan,2,1,Confederations Cup,in Brazil,19,-19,1850,1733,1,-2,17,31,1831,1752,T1
3472,June 22,2013,Monaco,Vatican,2,0,Friendly,in France,7,-7,902,693,0,-1,200,217,895,700,T1
3473,June 23,2013,Spain,Nigeria,3,0,Confederations Cup,in Brazil,6,-6,2165,1690,0,-1,1,42,2159,1696,T1
3474,June 23,2013,Uruguay,Tahiti,8,0,Confederations Cup,in Brazil,3,-3,1856,1226,1,-1,13,149,1853,1229,T1
3475,June 26,2013,Brazil,Uruguay,2,1,Confederations Cup,in Brazil,7,-7,2086,1849,0,-4,2,17,2079,1856,T1
3476,June 27,2013,Italy,Spain,0,0,Confederations Cup,in Brazil,15,-15,1944,2150,0,0,7,1,1929,2165,draw
3477,June 30,2013,Brazil,Spain,3,0,Confederations Cup,in Brazil,39,-39,2125,2111,1,-1,1,2,2086,2150,T1
3478,June 30,2013,Italy,Uruguay,2,2,Confederations Cup,in Brazil,-7,7,1937,1856,0,4,7,13,1944,1849,draw
3479,July 5,2013,United States,Guatemala,6,0,Friendly,in the United States,3,-3,1808,1483,1,0,21,89,1805,1486,T1
3480,July 6,2013,Malawi,Mozambique,0,1,Friendly,in Malawi,-14,14,1351,1324,-6,4,123,129,1365,1310,T2
3481,July 6,2013,Namibia,Mauritius,2,1,COSAFA Cup,in Zambia,6,-6,1324,1021,0,0,129,184,1318,1027,T1
3482,July 7,2013,Botswana,Swaziland,0,0,COSAFA Cup,in Zambia,-9,9,1277,1121,-3,1,140,176,1286,1112,draw
3483,July 7,2013,Martinique,Canada,1,0,CONCACAF Championship,in the United States,36,-36,1435,1528,7,-14,102,80,1399,1564,T1
3484,July 7,2013,Panama,Mexico,2,1,CONCACAF Championship,in the United States,37,-37,1709,1813,8,-3,36,20,1672,1850,T1
3485,July 8,2013,El Salvador,Trinidad and Tobago,2,2,CONCACAF Championship,in the United States,-8,8,1528,1421,-3,2,79,105,1536,1413,draw
3486,July 8,2013,Honduras,Haiti,2,0,CONCACAF Championship,in the United States,17,-17,1664,1419,4,-5,47,106,1647,1436,T1
3487,July 8,2013,Kenya,Lesotho,2,2,COSAFA Cup,in Zambia,-12,12,1388,1160,-2,2,111,167,1400,1148,draw
3488,July 8,2013,Namibia,Seychelles,4,2,COSAFA Cup,in Zambia,8,-8,1332,1002,1,-2,128,188,1324,1010,T1
3489,July 9,2013,Botswana,Lesotho,3,3,COSAFA Cup,in Zambia,-6,6,1271,1166,-2,1,142,166,1277,1160,draw
3490,July 9,2013,Costa Rica,Cuba,3,0,CONCACAF Championship,in the United States,12,-12,1757,1421,1,-2,29,104,1745,1433,T1
3491,July 9,2013,Kenya,Swaziland,2,0,COSAFA Cup,in Zambia,11,-11,1399,1110,2,-1,109,177,1388,1121,T1
3492,July 9,2013,United States,Belize,6,1,CONCACAF Championship,in the United States,1,-1,1809,1170,0,0,21,165,1808,1171,T1
3493,July 10,2013,Mauritius,Seychelles,4,0,COSAFA Cup,in Zambia,35,-35,1056,967,1,-4,183,192,1021,1002,T1
3494,July 11,2013,Botswana,Kenya,2,1,COSAFA Cup,in Zambia,27,-27,1298,1372,6,-7,136,116,1271,1399,T1
3495,July 11,2013,Lesotho,Swaziland,2,0,COSAFA Cup,in Zambia,25,-25,1191,1085,7,-3,159,180,1166,1110,T1
3496,July 11,2013,Mexico,Canada,2,0,CONCACAF Championship,in the United States,12,-12,1825,1516,2,-5,18,84,1813,1528,T1
3497,July 11,2013,Panama,Martinique,1,0,CONCACAF Championship,in the United States,9,-9,1718,1426,2,-1,34,102,1709,1435,T1
3498,July 12,2013,Haiti,Trinidad and Tobago,2,0,CONCACAF Championship,in the United States,38,-38,1457,1383,8,-9,98,113,1419,1421,T1
3499,July 12,2013,Honduras,El Salvador,1,0,CONCACAF Championship,in the United States,16,-16,1680,1512,3,-9,44,88,1664,1528,T1
3500,July 13,2013,Costa Rica,Belize,1,0,CONCACAF Championship,in the United States,2,-2,1759,1168,1,0,28,166,1757,1170,T1
3501,July 13,2013,Malawi,Zimbabwe,1,1,COSAFA Cup,in Zambia,0,0,1351,1343,0,0,123,127,1351,1343,draw
3502,July 13,2013,South Africa,Namibia,2,1,COSAFA Cup,in Zambia,9,-9,1563,1323,4,-2,66,130,1554,1332,T1
3503,July 13,2013,United States,Cuba,4,1,CONCACAF Championship,in the United States,5,-5,1814,1416,0,-1,21,106,1809,1421,T1
3504,July 14,2013,Angola,Lesotho,1,1,COSAFA Cup,in Zambia,-13,13,1433,1204,0,6,101,153,1446,1191,draw
3505,July 14,2013,Bermuda,Greenland,3,0,Island Games,in Bermuda,9,-9,1197,951,1,0,160,194,1188,960,T1
3506,July 14,2013,Canada,Panama,0,0,CONCACAF Championship,in the United States,13,-13,1529,1705,4,-2,79,36,1516,1718,draw
3507,July 14,2013,Mexico,Martinique,3,1,CONCACAF Championship,in the United States,7,-7,1832,1419,0,-1,18,104,1825,1426,T1
3508,July 14,2013,Zambia,Mozambique,3,1,COSAFA Cup,in Zambia,9,-9,1540,1315,1,-2,76,131,1531,1324,T1
3509,July 15,2013,El Salvador,Haiti,1,0,CONCACAF Championship,in the United States,21,-21,1533,1436,11,-3,77,101,1512,1457,T1
3510,July 15,2013,Trinidad and Tobago,Honduras,2,0,CONCACAF Championship,in the United States,64,-64,1447,1616,13,-10,100,54,1383,1680,T1
3511,July 16,2013,Angola,Malawi,3,2,COSAFA Cup,in Zambia,15,-15,1448,1336,2,-4,100,127,1433,1351,T1
3512,July 16,2013,Cuba,Belize,4,0,CONCACAF Championship,in the United States,18,-18,1434,1150,4,-2,103,168,1416,1168,T1
3513,July 16,2013,Mozambique,Namibia,1,0,COSAFA Cup,in Zambia,20,-20,1335,1303,3,-6,128,135,1315,1323,T1
3514,July 16,2013,United States,Costa Rica,1,0,CONCACAF Championship,in the United States,15,-15,1829,1744,2,-2,19,30,1814,1759,T1
3515,July 17,2013,Zambia,South Africa,0,0,COSAFA Cup,in Zambia,-4,4,1536,1567,0,1,76,65,1540,1563,draw
3516,July 17,2013,Zimbabwe,Lesotho,2,1,COSAFA Cup,in Zambia,12,-12,1355,1192,6,-7,120,160,1343,1204,T1
3517,July 18,2013,Bermuda,Greenland,1,0,Island Games,in Bermuda,5,-5,1202,946,3,-1,156,195,1197,951,T1
3518,July 18,2013,Mozambique,Angola,1,0,COSAFA Cup,in Zambia,26,-26,1361,1422,10,-5,118,105,1335,1448,T1
3519,July 20,2013,Mexico,Trinidad and Tobago,1,0,CONCACAF Championship,in the United States,5,-5,1837,1442,0,0,18,100,1832,1447,T1
3520,July 20,2013,Panama,Cuba,6,1,CONCACAF Championship,in the United States,17,-17,1722,1417,4,-5,32,107,1705,1434,T1
3521,July 20,2013,South Africa,Lesotho,2,1,COSAFA Cup,in Zambia,4,-4,1571,1188,0,-1,65,161,1567,1192,T1
3522,July 20,2013,South Korea,Australia,0,0,East Asian Cup,in South Korea,-3,3,1716,1775,-1,0,34,25,1719,1772,draw
3523,July 20,2013,Zambia,Zimbabwe,2,0,COSAFA Cup,in Zambia,10,-10,1546,1345,3,-6,73,127,1536,1355,T1
3524,July 21,2013,China,Japan,3,3,East Asian Cup,in South Korea,9,-9,1567,1724,2,1,66,30,1558,1733,draw
3525,July 21,2013,Honduras,Costa Rica,1,0,CONCACAF Championship,in the United States,34,-34,1650,1710,4,-6,50,36,1616,1744,T1
3526,July 21,2013,United States,El Salvador,5,1,CONCACAF Championship,in the United States,9,-9,1838,1524,2,-5,17,82,1829,1533,T1
3527,July 24,2013,Panama,Mexico,2,1,CONCACAF Championship,in the United States,33,-33,1755,1804,2,-3,29,22,1722,1837,T1
3528,July 24,2013,South Korea,China,0,0,East Asian Cup,in South Korea,-12,12,1704,1579,-4,4,37,62,1716,1567,draw
3529,July 24,2013,United States,Honduras,3,1,CONCACAF Championship,in the United States,12,-12,1850,1638,0,-2,17,52,1838,1650,T1
3530,July 25,2013,Japan,Australia,3,2,East Asian Cup,in South Korea,23,-23,1747,1752,0,-4,31,29,1724,1775,T1
3531,July 28,2013,China,Australia,4,3,East Asian Cup,in South Korea,29,-29,1608,1723,6,-2,56,31,1579,1752,T1
3532,July 28,2013,South Korea,Japan,1,2,East Asian Cup,in South Korea,-23,23,1681,1770,-6,6,43,25,1704,1747,T2
3533,July 28,2013,United States,Panama,1,0,CONCACAF Championship,in the United States,12,-12,1862,1743,5,-2,12,30,1850,1755,T1
3534,August 6,2013,Jordan,Palestine,4,1,Friendly,in Jordan,4,-4,1559,1286,1,0,69,137,1555,1290,T1
3535,August 9,2013,Jordan,Libya,2,1,Friendly,in Jordan,7,-7,1566,1556,2,-1,67,69,1559,1563,T1
3536,August 14,2013,Albania,Armenia,2,0,Friendly,in Albania,10,-10,1556,1523,2,-5,71,82,1546,1533,T1
3537,August 14,2013,Algeria,Guinea,2,2,Friendly,in Algeria,-4,4,1574,1526,-2,4,65,80,1578,1522,draw
3538,August 14,2013,Austria,Greece,0,2,Friendly,in Austria,-12,12,1630,1816,-2,1,53,21,1642,1804,T2
3539,August 14,2013,Azerbaijan,Malta,3,0,Friendly,in Azerbaijan,8,-8,1402,1267,1,0,108,142,1394,1275,T1
3540,August 14,2013,Belarus,Montenegro,1,1,Friendly,in Belarus,-1,1,1602,1659,1,-1,58,48,1603,1658,draw
3541,August 14,2013,Belgium,France,0,0,Friendly,in Belgium,-2,2,1836,1860,-1,0,19,13,1838,1858,draw
3542,August 14,2013,Bosnia and Herzegovina,United States,3,4,Friendly,in Bosnia and Herzegovina,-11,11,1796,1873,-3,2,24,10,1807,1862,T2
3543,August 14,2013,Cape Verde,Gabon,1,1,Friendly,in Portugal,2,-2,1463,1514,2,-1,95,86,1461,1516,draw
3544,August 14,2013,Chile,Iraq,6,0,Friendly,in Denmark,6,-6,1859,1540,2,-4,14,77,1853,1546,T1
3545,August 14,2013,Colombia,Serbia,1,0,Friendly,in Spain,4,-4,1916,1690,0,0,8,41,1912,1694,T1
3546,August 14,2013,Dominican Republic,Costa Rica,0,4,Friendly,in the Dominican Republic,-5,5,1265,1715,-1,3,144,32,1270,1710,T2
3547,August 14,2013,Ecuador,Spain,0,2,Friendly,in Ecuador,-9,9,1847,2120,-2,1,16,1,1856,2111,T2
3548,August 14,2013,Egypt,Uganda,3,0,Friendly,in Egypt,7,-7,1680,1520,0,-3,44,83,1673,1527,T1
3549,August 14,2013,England,Scotland,3,2,Friendly,in England,2,-2,1954,1648,0,0,6,50,1952,1650,T1
3550,August 14,2013,Estonia,Latvia,1,1,Friendly,in Estonia,-3,3,1473,1472,0,0,91,92,1476,1469,draw
3551,August 14,2013,Finland,Slovenia,2,0,Friendly,in Finland,9,-9,1674,1599,1,-3,45,59,1665,1608,T1
3552,August 14,2013,Germany,Paraguay,3,3,Friendly,in Germany,-9,9,2046,1710,0,4,3,34,2055,1701,draw
3553,August 14,2013,Hungary,Czechia,1,1,Friendly,in Hungary,-1,1,1697,1770,-1,1,40,25,1698,1769,draw
3554,August 14,2013,Iceland,Faroe Islands,1,0,Friendly,in Iceland,2,-2,1482,1201,0,-4,90,157,1480,1203,T1
3555,August 14,2013,Indonesia,Philippines,2,0,Friendly,in Indonesia,11,-11,1225,1218,3,-4,149,152,1214,1229,T1
3556,August 14,2013,Italy,Argentina,1,2,Friendly tournament,in Italy,-16,16,1921,2020,0,1,7,4,1937,2004,T2
3557,August 14,2013,Japan,Uruguay,2,4,Friendly,in Japan,-16,16,1754,1872,-2,3,27,11,1770,1856,T2
3558,August 14,2013,Kazakhstan,Georgia,1,0,Friendly,in Kazakhstan,12,-12,1362,1503,8,-2,117,88,1350,1515,T1
3559,August 14,2013,Libya,Central African Republic,0,0,Friendly,in Libya,-8,8,1548,1284,-4,3,73,138,1556,1276,draw
3560,August 14,2013,Liechtenstein,Croatia,2,3,Friendly,in Liechtenstein,-1,1,1202,1868,-1,-1,154,12,1203,1867,T2
3561,August 14,2013,Luxembourg,Lithuania,2,1,Friendly,in Luxembourg,15,-15,1191,1447,3,-4,160,100,1176,1462,T1
3562,August 14,2013,Macedonia,Bulgaria,2,0,Friendly,in Macedonia,18,-18,1542,1687,6,-6,76,42,1524,1705,T1
3563,August 14,2013,Mexico,Ivory Coast,4,1,Friendly,in the United States,18,-18,1822,1798,2,-3,20,23,1804,1816,T1
3564,August 14,2013,Moldova,Andorra,1,1,Friendly,in Moldova,-9,9,1385,997,-2,1,111,188,1394,988,draw
3565,August 14,2013,Morocco,Burkina Faso,1,2,Friendly,in Morocco,-12,12,1518,1568,-6,3,84,66,1530,1556,T2
3566,August 14,2013,Northern Ireland,Russia,1,0,World Cup qualifier,in Northern Ireland,36,-36,1454,1843,8,-7,98,17,1418,1879,T1
3567,August 14,2013,Poland,Denmark,3,2,Friendly,in Poland,9,-9,1660,1712,2,-1,47,33,1651,1721,T1
3568,August 14,2013,Portugal,Netherlands,1,1,Friendly,in Portugal,0,0,1911,2009,0,-1,9,5,1911,2009,draw
3569,August 14,2013,Romania,Slovakia,1,1,Friendly,in Romania,-7,7,1752,1585,0,0,28,63,1759,1578,draw
3570,August 14,2013,Rwanda,Malawi,0,1,Friendly,in Rwanda,-13,13,1341,1349,-7,3,128,125,1354,1336,T2
3571,August 14,2013,Senegal,Zambia,1,1,Friendly,in France,0,0,1545,1546,1,-1,75,74,1545,1546,draw
3572,August 14,2013,Singapore,Oman,0,2,Asian Cup qualifier,in Singapore,-17,17,1266,1564,-4,3,143,69,1283,1547,T2
3573,August 14,2013,South Africa,Nigeria,0,2,Friendly,in South Africa,-14,14,1557,1704,-4,4,70,38,1571,1690,T2
3574,August 14,2013,South Korea,Peru,0,0,Friendly,in South Korea,0,0,1681,1764,0,1,43,26,1681,1764,draw
3575,August 14,2013,Sweden,Norway,4,2,Friendly,in Sweden,6,-6,1857,1707,2,-2,15,35,1851,1713,T1
3576,August 14,2013,Switzerland,Brazil,1,0,Friendly,in Switzerland,15,-15,1837,2110,1,-1,18,2,1822,2125,T1
3577,August 14,2013,Tajikistan,India,3,0,Friendly,in Tajikistan,8,-8,1242,1121,0,0,146,175,1234,1129,T1
3578,August 14,2013,Tunisia,Congo,3,0,Friendly,in Tunisia,6,-6,1578,1396,1,-1,64,109,1572,1402,T1
3579,August 14,2013,Turkey,Ghana,2,2,Friendly,in Turkey,-2,2,1655,1705,-1,0,49,37,1657,1703,draw
3580,August 14,2013,Ukraine,Israel,2,0,Friendly,in Ukraine,6,-6,1808,1666,2,-1,22,46,1802,1672,T1
3581,August 14,2013,Venezuela,Bolivia,2,2,Friendly,in Venezuela,-5,5,1707,1629,-1,0,35,54,1712,1624,draw
3582,August 14,2013,Wales,Ireland,0,0,Friendly,in Wales,1,-1,1608,1750,2,0,56,29,1607,1751,draw
3583,August 15,2013,Jordan,Syria,1,1,Asian Cup qualifier,in Iran,-3,3,1563,1518,-2,1,69,84,1566,1515,draw
3584,August 17,2013,South Africa,Burkina Faso,2,0,Friendly,in South Africa,11,-11,1568,1557,4,-4,66,70,1557,1568,T1
3585,August 20,2013,Afghanistan,Pakistan,3,0,Friendly,in Afghanistan,12,-12,959,917,0,0,194,199,947,929,T1
3586,August 27,2013,Libya,Mali,1,0,Friendly,in Tunisia,11,-11,1559,1581,3,-3,70,63,1548,1592,T1
3587,August 30,2013,Libya,Ghana,1,0,Friendly,in Tunisia,14,-14,1573,1691,4,-3,66,40,1559,1705,T1
3588,August 31,2013,Botswana,Uganda,1,3,Friendly,in Botswana,-10,10,1288,1530,0,5,136,78,1298,1520,T2
3589,August 31,2013,Nepal,Bangladesh,2,0,South Asian Cup,in Nepal,31,-31,910,957,2,-4,200,194,879,988,T1
3590,September 1,2013,India,Pakistan,1,0,South Asian Cup,in Nepal,9,-9,1130,908,0,-1,175,200,1121,917,T1
3591,September 2,2013,Afghanistan,Bhutan,3,0,South Asian Cup,in Nepal,6,-6,965,538,1,0,192,233,959,544,T1
3592,September 2,2013,Maldives,Sri Lanka,10,0,South Asian Cup,in Nepal,20,-20,1126,834,1,-1,176,207,1106,854,T1
3593,September 3,2013,Bangladesh,India,1,1,South Asian Cup,in Nepal,9,-9,966,1121,2,-1,192,176,957,1130,draw
3594,September 3,2013,Botswana,Malawi,1,0,Friendly,in Botswana,9,-9,1297,1340,0,-3,136,128,1288,1349,T1
3595,September 3,2013,Nepal,Pakistan,1,1,South Asian Cup,in Nepal,-6,6,904,914,-1,1,200,199,910,908,draw
3596,September 4,2013,Afghanistan,Sri Lanka,3,1,South Asian Cup,in Nepal,19,-19,984,815,3,-1,190,208,965,834,T1
3597,September 4,2013,Equatorial Guinea,Libya,1,1,Friendly,in Equatorial Guinea,4,-4,1317,1569,1,0,130,66,1313,1573,draw
3598,September 4,2013,Maldives,Bhutan,8,2,South Asian Cup,in Nepal,3,-3,1129,535,0,0,175,233,1126,538,T1
3599,September 5,2013,Nepal,India,2,1,South Asian Cup,in Nepal,26,-26,930,1095,1,-2,199,178,904,1121,T1
3600,September 5,2013,Pakistan,Bangladesh,2,1,South Asian Cup,in Nepal,23,-23,937,943,3,-2,196,195,914,966,T1
3601,September 5,2013,Qatar,Mauritius,3,0,Friendly,in Qatar,2,-2,1455,1054,2,0,97,183,1453,1056,T1
3602,September 5,2013,Saudi Arabia,New Zealand,0,1,Friendly tournament,in Saudi Arabia,-16,16,1498,1606,-2,4,88,57,1514,1590,T2
3603,September 5,2013,Trinidad and Tobago,United Arab Emirates,3,3,Friendly tournament,in Saudi Arabia,7,-7,1449,1605,1,-3,100,58,1442,1612,draw
3604,September 6,2013,Afghanistan,Maldives,0,0,South Asian Cup,in Nepal,8,-8,992,1121,0,0,190,175,984,1129,draw
3605,September 6,2013,Belarus,Kyrgyzstan,3,1,Friendly,in Belarus,1,-1,1603,1155,-1,0,60,167,1602,1156,T1
3606,September 6,2013,Bosnia and Herzegovina,Slovakia,0,1,World Cup qualifier,in Bosnia and Herzegovina,-34,34,1762,1619,-1,8,25,54,1796,1585,T2
3607,September 6,2013,Chile,Venezuela,3,0,World Cup qualifier,in Chile,13,-13,1872,1694,2,-4,12,39,1859,1707,T1
3608,September 6,2013,China,Singapore,6,1,Friendly,in China,3,-3,1611,1263,0,0,55,143,1608,1266,T1
3609,September 6,2013,Colombia,Ecuador,1,0,World Cup qualifier,in Colombia,11,-11,1927,1836,1,-2,7,18,1916,1847,T1
3610,September 6,2013,Costa Rica,United States,3,1,World Cup qualifier,in Costa Rica,35,-35,1750,1838,5,-7,27,17,1715,1873,T1
3611,September 6,2013,Czechia,Armenia,1,2,World Cup qualifier,in Czechia,-35,35,1735,1558,-4,11,29,72,1770,1523,T2
3612,September 6,2013,England,Moldova,4,0,World Cup qualifier,in England,2,-2,1956,1383,0,-2,6,113,1954,1385,T1
3613,September 6,2013,Estonia,Netherlands,2,2,World Cup qualifier,in Estonia,17,-17,1490,1992,1,0,90,5,1473,2009,draw
3614,September 6,2013,Finland,Spain,0,2,World Cup qualifier,in Finland,-7,7,1667,2127,-1,0,46,1,1674,2120,T2
3615,September 6,2013,Georgia,France,0,0,World Cup qualifier,in Georgia,13,-13,1516,1847,2,-2,85,15,1503,1860,draw
3616,September 6,2013,Germany,Austria,3,0,World Cup qualifier,in Germany,3,-3,2049,1627,0,1,3,52,2046,1630,T1
3617,September 6,2013,Ghana,Zambia,2,1,World Cup qualifier,in Ghana,8,-8,1699,1538,3,-5,37,79,1691,1546,T1
3618,September 6,2013,Ireland,Sweden,1,2,World Cup qualifier,in Ireland,-20,20,1730,1877,-1,4,30,11,1750,1857,T2
3619,September 6,2013,Italy,Bulgaria,1,0,World Cup qualifier,in Italy,5,-5,1926,1682,-1,0,8,42,1921,1687,T1
3620,September 6,2013,Japan,Guatemala,3,0,Friendly,in Japan,4,-4,1758,1479,1,-3,26,92,1754,1483,T1
3621,September 6,2013,Jordan,Uzbekistan,1,1,World Cup qualifier,in Jordan,-2,2,1561,1637,0,1,70,51,1563,1635,draw
3622,September 6,2013,Kazakhstan,Faroe Islands,2,1,World Cup qualifier,in Kazakhstan,7,-7,1369,1194,0,-2,117,159,1362,1201,T1
3623,September 6,2013,Kuwait,North Korea,2,1,Friendly,in Kuwait,8,-8,1557,1584,0,-1,73,62,1549,1592,T1
3624,September 6,2013,Latvia,Lithuania,2,1,World Cup qualifier,in Latvia,13,-13,1485,1434,1,0,91,101,1472,1447,T1
3625,September 6,2013,Lebanon,Syria,2,0,Friendly,in Lebanon,18,-18,1369,1500,7,-3,117,87,1351,1518,T1
3626,September 6,2013,Liechtenstein,Greece,0,1,World Cup qualifier,in Liechtenstein,-2,2,1200,1818,-2,1,156,20,1202,1816,T2
3627,September 6,2013,Macedonia,Wales,2,1,World Cup qualifier,in Macedonia,18,-18,1560,1590,5,-6,71,61,1542,1608,T1
3628,September 6,2013,Malta,Denmark,1,2,World Cup qualifier,in Malta,-5,5,1262,1717,-2,-1,144,34,1267,1712,T2
3629,September 6,2013,Mexico,Honduras,1,2,World Cup qualifier,in Mexico,-33,33,1789,1671,-3,6,23,45,1822,1638,T2
3630,September 6,2013,Myanmar,Hong Kong,0,0,Friendly,in Myanmar,2,-2,1007,1188,0,0,187,161,1005,1190,draw
3631,September 6,2013,Norway,Cyprus,2,0,World Cup qualifier,in Norway,6,-6,1713,1422,0,-1,35,104,1707,1428,T1
3632,September 6,2013,Northern Ireland,Portugal,2,4,World Cup qualifier,in Northern Ireland,-7,7,1447,1918,-1,0,100,9,1454,1911,T2
3633,September 6,2013,Panama,Jamaica,0,0,World Cup qualifier,in Panama,-14,14,1729,1541,-2,3,32,77,1743,1527,draw
3634,September 6,2013,Paraguay,Bolivia,4,0,World Cup qualifier,in Paraguay,20,-20,1730,1609,4,-3,30,57,1710,1629,T1
3635,September 6,2013,Peru,Uruguay,1,2,World Cup qualifier,in Peru,-20,20,1744,1892,-2,1,28,10,1764,1872,T2
3636,September 6,2013,Poland,Montenegro,1,1,World Cup qualifier,in Poland,-6,6,1654,1665,-3,0,50,48,1660,1659,draw
3637,September 6,2013,Romania,Hungary,3,0,World Cup qualifier,in Romania,20,-20,1772,1677,4,-5,24,44,1752,1697,T1
3638,September 6,2013,Russia,Luxembourg,4,1,World Cup qualifier,in Russia,1,-1,1844,1190,1,0,16,160,1843,1191,T1
3639,September 6,2013,Scotland,Belgium,0,2,World Cup qualifier,in Scotland,-23,23,1625,1859,-3,5,53,14,1648,1836,T2
3640,September 6,2013,Serbia,Croatia,1,1,World Cup qualifier,in Serbia,4,-4,1694,1864,2,-1,39,13,1690,1868,draw
3641,September 6,2013,Slovenia,Albania,1,0,World Cup qualifier,in Slovenia,12,-12,1611,1544,5,-4,55,76,1599,1556,T1
3642,September 6,2013,South Korea,Haiti,4,1,Friendly,in South Korea,4,-4,1685,1432,2,0,41,102,1681,1436,T1
3643,September 6,2013,Sri Lanka,Bhutan,5,2,South Asian Cup,in Nepal,12,-12,827,523,1,0,207,233,815,535,T1
3644,September 6,2013,Switzerland,Iceland,4,4,World Cup qualifier,in Switzerland,-17,17,1820,1499,-1,2,19,88,1837,1482,draw
3645,September 6,2013,Turkey,Andorra,5,0,World Cup qualifier,in Turkey,1,-1,1656,996,0,0,49,188,1655,997,T1
3646,September 6,2013,Ukraine,San Marino,9,0,World Cup qualifier,in Ukraine,0,0,1808,883,1,0,21,202,1808,883,T1
3647,September 7,2013,Angola,Liberia,4,1,World Cup qualifier,in Angola,17,-17,1439,1314,3,-2,101,131,1422,1331,T1
3648,September 7,2013,Brazil,Australia,6,0,Friendly,in Brazil,2,-2,2112,1721,0,0,2,33,2110,1723,T1
3649,September 7,2013,Burkina Faso,Gabon,1,0,World Cup qualifier,in Burkina Faso,12,-12,1569,1502,7,-1,66,87,1557,1514,T1
3650,September 7,2013,Ethiopia,Central African Republic,2,1,World Cup qualifier,in Congo,14,-14,1399,1270,2,-2,109,140,1385,1284,T1
3651,September 7,2013,Gambia,Tanzania,2,0,World Cup qualifier,in The Gambia,28,-28,1334,1360,5,-12,129,122,1306,1388,T1
3652,September 7,2013,Israel,Azerbaijan,1,1,World Cup qualifier,in Israel,-16,16,1650,1418,-3,1,50,107,1666,1402,draw
3653,September 7,2013,Ivory Coast,Morocco,1,1,World Cup qualifier,in Ivory Coast,-16,16,1782,1534,-1,5,23,79,1798,1518,draw
3654,September 7,2013,Niger,Congo,2,2,World Cup qualifier,in Niger,1,-1,1285,1395,0,-1,138,110,1284,1396,draw
3655,September 7,2013,Nigeria,Malawi,2,0,World Cup qualifier,in Nigeria,4,-4,1708,1336,0,0,36,128,1704,1340,T1
3656,September 7,2013,Senegal,Uganda,1,0,World Cup qualifier,in Morocco,19,-19,1564,1511,6,-5,69,85,1545,1530,T1
3657,September 7,2013,Sierra Leone,Equatorial Guinea,3,2,World Cup qualifier,in Sierra Leone,13,-13,1365,1304,6,-4,118,134,1352,1317,T1
3658,September 7,2013,South Africa,Botswana,4,1,World Cup qualifier,in South Africa,7,-7,1575,1290,3,0,64,136,1568,1297,T1
3659,September 7,2013,Tunisia,Cape Verde,0,2,World Cup qualifier,in Tunisia,-47,47,1531,1510,-16,9,80,86,1578,1463,T2
3660,September 8,2013,Benin,Rwanda,2,0,World Cup qualifier,in Benin,19,-19,1394,1322,3,-1,111,128,1375,1341,T1
3661,September 8,2013,Cameroon,Libya,1,0,World Cup qualifier,in Cameroon,15,-15,1580,1554,4,-8,64,74,1565,1569,T1
3662,September 8,2013,Canada,Mauritania,0,0,Friendly,in Spain,-8,8,1521,1155,-2,3,83,167,1529,1147,draw
3663,September 8,2013,Kenya,Namibia,1,0,World Cup qualifier,in Kenya,11,-11,1383,1292,2,0,113,135,1372,1303,T1
3664,September 8,2013,Nepal,Afghanistan,0,1,South Asian Cup,in Nepal,-22,22,908,1014,-1,4,200,186,930,992,T2
3665,September 8,2013,Sudan,Lesotho,1,3,World Cup qualifier,in Sudan,-50,50,1311,1238,-11,14,131,147,1361,1188,T2
3666,September 8,2013,Togo,Democratic Republic of Congo,2,1,World Cup qualifier,in Togo,15,-15,1480,1452,2,-4,93,98,1465,1467,T1
3667,September 8,2013,Zimbabwe,Mozambique,1,1,World Cup qualifier,in Zimbabwe,-5,5,1340,1366,1,2,125,118,1345,1361,draw
3668,September 9,2013,India,Maldives,1,0,South Asian Cup,in Nepal,21,-21,1116,1100,2,-3,176,178,1095,1121,T1
3669,September 9,2013,Kuwait,Bahrain,2,1,Friendly,in Kuwait,5,-5,1562,1458,3,-1,70,96,1557,1463,T1
3670,September 9,2013,Qatar,Lebanon,1,1,Friendly,in Qatar,-5,5,1450,1374,-3,0,99,116,1455,1369,draw
3671,September 9,2013,Saudi Arabia,Trinidad and Tobago,1,3,Friendly tournament,in Saudi Arabia,-32,32,1466,1481,-5,7,95,92,1498,1449,T2
3672,September 9,2013,United Arab Emirates,New Zealand,2,0,Friendly tournament,in Saudi Arabia,23,-23,1628,1583,7,-4,52,62,1605,1606,T1
3673,September 10,2013,Algeria,Mali,1,0,World Cup qualifier,in Algeria,15,-15,1589,1566,7,-2,59,65,1574,1581,T1
3674,September 10,2013,Andorra,Netherlands,0,2,World Cup qualifier,in Andorra,0,0,996,1992,0,0,189,5,996,1992,T2
3675,September 10,2013,Armenia,Denmark,0,1,World Cup qualifier,in Armenia,-17,17,1541,1734,-1,7,74,27,1558,1717,T2
3676,September 10,2013,Austria,Ireland,1,0,World Cup qualifier,in Austria,20,-20,1647,1710,3,-7,50,37,1627,1730,T1
3677,September 10,2013,Belarus,France,2,4,World Cup qualifier,in Belarus,-18,18,1585,1865,-1,1,60,14,1603,1847,T2
3678,September 10,2013,Bolivia,Ecuador,1,1,World Cup qualifier,in Bolivia,7,-7,1616,1829,2,-1,56,19,1609,1836,draw
3679,September 10,2013,Brazil,Portugal,3,1,Friendly,in the United States,7,-7,2119,1911,0,0,2,9,2112,1918,T1
3680,September 10,2013,Chile,Spain,2,2,Friendly,in Switzerland,6,-6,1878,2121,0,0,12,1,1872,2127,draw
3681,September 10,2013,China,Malaysia,2,0,Friendly,in China,1,-1,1612,1179,-1,0,57,163,1611,1180,T1
3682,September 10,2013,Cyprus,Slovenia,0,2,World Cup qualifier,in Cyprus,-22,22,1400,1633,-3,3,108,53,1422,1611,T2
3683,September 10,2013,Egypt,Guinea,4,2,World Cup qualifier,in Egypt,11,-11,1691,1515,3,-2,40,83,1680,1526,T1
3684,September 10,2013,Faroe Islands,Germany,0,3,World Cup qualifier,in the Faroe Islands,-1,1,1193,2050,-1,0,161,3,1194,2049,T2
3685,September 10,2013,Georgia,Finland,0,1,World Cup qualifier,in Georgia,-17,17,1499,1684,-5,2,89,44,1516,1667,T2
3686,September 10,2013,Greece,Latvia,1,0,World Cup qualifier,in Greece,3,-3,1821,1482,0,1,20,90,1818,1485,T1
3687,September 10,2013,Honduras,Panama,2,2,World Cup qualifier,in Honduras,-2,2,1669,1731,-2,4,47,28,1671,1729,draw
3688,September 10,2013,Hong Kong,Singapore,1,0,Friendly,in Hong Kong,9,-9,1197,1254,2,-1,160,144,1188,1263,T1
3689,September 10,2013,Hungary,Estonia,5,1,World Cup qualifier,in Hungary,12,-12,1689,1478,2,-4,42,94,1677,1490,T1
3690,September 10,2013,Iceland,Albania,2,1,World Cup qualifier,in Iceland,17,-17,1516,1527,7,-5,82,80,1499,1544,T1
3691,September 10,2013,Italy,Czechia,2,1,World Cup qualifier,in Italy,6,-6,1932,1729,1,0,7,29,1926,1735,T1
3692,September 10,2013,Jamaica,Costa Rica,1,1,World Cup qualifier,in Jamaica,6,-6,1547,1744,3,1,73,26,1541,1750,draw
3693,September 10,2013,Japan,Ghana,3,1,Friendly,in Japan,9,-9,1767,1690,1,-4,25,41,1758,1699,T1
3694,September 10,2013,Kazakhstan,Sweden,0,1,World Cup qualifier,in Kazakhstan,-3,3,1366,1880,0,0,117,11,1369,1877,T2
3695,September 10,2013,Lithuania,Liechtenstein,2,0,World Cup qualifier,in Lithuania,8,-8,1442,1192,2,-5,100,162,1434,1200,T1
3696,September 10,2013,Luxembourg,Northern Ireland,3,2,World Cup qualifier,in Luxembourg,28,-28,1218,1419,8,-4,153,104,1190,1447,T1
3697,September 10,2013,Macedonia,Scotland,1,2,World Cup qualifier,in Macedonia,-22,22,1538,1647,-4,4,76,50,1560,1625,T2
3698,September 10,2013,Malta,Bulgaria,1,2,World Cup qualifier,in Malta,-5,5,1257,1687,1,-1,143,43,1262,1682,T2
3699,September 10,2013,Mauritania,Canada,1,0,Friendly,in Spain,18,-18,1173,1503,1,-3,166,86,1155,1521,T1
3700,September 10,2013,Nigeria,Burkina Faso,4,1,Friendly,in Nigeria,7,-7,1715,1562,2,-1,34,68,1708,1569,T1
3701,September 10,2013,Norway,Switzerland,0,2,World Cup qualifier,in Norway,-29,29,1684,1849,-9,1,44,18,1713,1820,T2
3702,September 10,2013,Paraguay,Argentina,2,5,World Cup qualifier,in Paraguay,-18,18,1712,2038,-5,0,35,4,1730,2020,T2
3703,September 10,2013,Romania,Turkey,0,2,World Cup qualifier,in Romania,-47,47,1725,1703,-8,10,32,38,1772,1656,T2
3704,September 10,2013,Russia,Israel,3,1,World Cup qualifier,in Russia,9,-9,1853,1641,-1,-2,17,52,1844,1650,T1
3705,September 10,2013,San Marino,Poland,1,5,World Cup qualifier,in San Marino,-2,2,881,1656,0,0,202,49,883,1654,T2
3706,September 10,2013,Slovakia,Bosnia and Herzegovina,1,2,World Cup qualifier,in Slovakia,-18,18,1601,1780,-3,2,58,23,1619,1762,T2
3707,September 10,2013,South Africa,Zimbabwe,1,2,Friendly,in South Africa,-17,17,1558,1357,-5,2,70,123,1575,1340,T2
3708,September 10,2013,South Korea,Croatia,1,2,Friendly,in South Korea,-8,8,1677,1872,-5,0,46,13,1685,1864,T2
3709,September 10,2013,Ukraine,England,0,0,World Cup qualifier,in Ukraine,3,-3,1811,1953,0,0,21,6,1808,1956,draw
3710,September 10,2013,Uruguay,Colombia,2,0,World Cup qualifier,in Uruguay,24,-24,1916,1903,2,-3,8,10,1892,1927,T1
3711,September 10,2013,United States,Mexico,2,0,World Cup qualifier,in the United States,18,-18,1856,1771,1,-2,16,24,1838,1789,T1
3712,September 10,2013,Uzbekistan,Jordan,1,1,World Cup qualifier,in Uzbekistan,-9,9,1628,1570,-3,7,54,64,1637,1561,draw
3713,September 10,2013,Venezuela,Peru,3,2,World Cup qualifier,in Venezuela,17,-17,1711,1727,3,-3,36,31,1694,1744,T1
3714,September 10,2013,Wales,Serbia,0,3,World Cup qualifier,in Wales,-35,35,1555,1729,-11,10,71,29,1590,1694,T2
3715,September 11,2013,Afghanistan,India,2,0,South Asian Cup,in Nepal,39,-39,1053,1077,2,-5,184,181,1014,1116,T1
3716,September 30,2013,Botswana,Burkina Faso,1,0,Friendly,in Botswana,15,-15,1305,1547,2,-4,134,72,1290,1562,T1
3717,September 30,2013,Egypt,Uganda,2,0,Friendly,in Egypt,5,-5,1696,1506,0,-1,40,85,1691,1511,T1
3718,October 2,2013,Egypt,Uganda,3,0,Friendly,in Egypt,6,-6,1702,1500,1,-2,39,87,1696,1506,T1
3719,October 5,2013,United Arab Emirates,Laos,2,0,Friendly,in China,0,0,1628,862,0,0,54,205,1628,862,T1
3720,October 6,2013,Iraq,Yemen,3,2,Friendly,in Lebanon,3,-3,1543,1199,1,-2,74,158,1540,1202,T1
3721,October 8,2013,Lebanon,Iraq,1,1,Friendly,in Lebanon,2,-2,1376,1541,0,0,116,74,1374,1543,draw
3722,October 9,2013,Jordan,Kuwait,1,1,Friendly,in Jordan,-3,3,1567,1565,0,2,64,66,1570,1562,draw
3723,October 9,2013,Oman,Mauritania,0,0,Friendly,in Oman,-9,9,1555,1182,-3,3,69,163,1564,1173,draw
3724,October 9,2013,Qatar,Vietnam,1,2,Friendly,in Qatar,-17,17,1433,1236,-2,4,101,148,1450,1219,T2
3725,October 9,2013,United Arab Emirates,Malaysia,3,1,Friendly,in China,2,-2,1630,1177,0,-1,54,164,1628,1179,T1
3726,October 10,2013,Singapore,Laos,1,0,Friendly,in Singapore,1,-1,1255,861,0,0,144,205,1254,862,T1
3727,October 10,2013,Thailand,Bahrain,1,0,Friendly,in Thailand,10,-10,1364,1448,4,-2,120,98,1354,1458,T1
3728,October 11,2013,Albania,Switzerland,1,2,World Cup qualifier,in Albania,-9,9,1518,1858,-2,2,82,16,1527,1849,T2
3729,October 11,2013,Andorra,Romania,0,4,World Cup qualifier,in Andorra,-2,2,994,1727,-1,3,190,29,996,1725,T2
3730,October 11,2013,Argentina,Peru,3,1,World Cup qualifier,in Argentina,5,-5,2043,1722,0,-1,4,32,2038,1727,T1
3731,October 11,2013,Armenia,Bulgaria,2,1,World Cup qualifier,in Armenia,23,-23,1564,1664,6,-3,68,46,1541,1687,T1
3732,October 11,2013,Azerbaijan,Northern Ireland,2,0,World Cup qualifier,in Azerbaijan,22,-22,1440,1397,6,-4,100,108,1418,1419,T1
3733,October 11,2013,Bosnia and Herzegovina,Liechtenstein,4,1,World Cup qualifier,in Bosnia and Herzegovina,1,-1,1781,1191,-1,1,24,161,1780,1192,T1
3734,October 11,2013,Colombia,Chile,3,3,World Cup qualifier,in Colombia,-7,7,1896,1885,1,1,9,11,1903,1878,draw
3735,October 11,2013,Croatia,Belgium,1,2,World Cup qualifier,in Croatia,-26,26,1846,1885,-6,4,19,11,1872,1859,T2
3736,October 11,2013,Denmark,Italy,2,2,World Cup qualifier,in Denmark,5,-5,1739,1927,0,0,27,7,1734,1932,draw
3737,October 11,2013,Ecuador,Uruguay,1,0,World Cup qualifier,in Ecuador,19,-19,1848,1897,1,0,18,8,1829,1916,T1
3738,October 11,2013,England,Montenegro,4,1,World Cup qualifier,in England,7,-7,1960,1658,0,0,6,48,1953,1665,T1
3739,October 11,2013,Estonia,Turkey,0,2,World Cup qualifier,in Estonia,-20,20,1458,1723,-1,7,95,31,1478,1703,T2
3740,October 11,2013,Faroe Islands,Kazakhstan,1,1,World Cup qualifier,in the Faroe Islands,4,-4,1197,1362,2,-3,159,120,1193,1366,draw
3741,October 11,2013,France,Australia,6,0,Friendly,in France,8,-8,1873,1713,0,-3,14,36,1865,1721,T1
3742,October 11,2013,Germany,Ireland,3,0,World Cup qualifier,in Germany,5,-5,2055,1705,0,0,3,37,2050,1710,T1
3743,October 11,2013,Greece,Slovakia,1,0,World Cup qualifier,in Greece,5,-5,1826,1596,0,0,20,58,1821,1601,T1
3744,October 11,2013,Honduras,Costa Rica,1,0,World Cup qualifier,in Honduras,19,-19,1688,1725,5,-4,42,30,1669,1744,T1
3745,October 11,2013,Iceland,Cyprus,2,0,World Cup qualifier,in Iceland,13,-13,1529,1387,3,-3,79,111,1516,1400,T1
3746,October 11,2013,Lithuania,Latvia,2,0,World Cup qualifier,in Lithuania,25,-25,1467,1457,6,-6,93,96,1442,1482,T1
3747,October 11,2013,Luxembourg,Russia,0,4,World Cup qualifier,in Luxembourg,-3,3,1215,1856,0,0,153,17,1218,1853,T2
3748,October 11,2013,Malta,Czechia,1,4,World Cup qualifier,in Malta,-7,7,1250,1736,-1,1,144,28,1257,1729,T2
3749,October 11,2013,Mexico,Panama,2,1,World Cup qualifier,in Mexico,12,-12,1783,1719,2,-5,22,33,1771,1731,T1
3750,October 11,2013,Moldova,San Marino,3,0,World Cup qualifier,in Moldova,2,-2,1385,879,1,0,112,202,1383,881,T1
3751,October 11,2013,Morocco,South Africa,1,1,Friendly,in Morocco,-2,2,1532,1560,1,-2,77,70,1534,1558,draw
3752,October 11,2013,Netherlands,Hungary,8,1,World Cup qualifier,in the Netherlands,8,-8,2000,1681,0,-2,5,44,1992,1689,T1
3753,October 11,2013,Philippines,Taiwan,1,2,Friendly tournament,in the Philippines,-28,28,1190,855,-9,1,162,206,1218,827,T2
3754,October 11,2013,Portugal,Israel,1,1,World Cup qualifier,in Portugal,-16,16,1895,1657,-1,3,10,49,1911,1641,draw
3755,October 11,2013,Serbia,Japan,2,0,Friendly,in Serbia,12,-12,1741,1755,3,0,26,25,1729,1767,T1
3756,October 11,2013,Slovenia,Norway,3,0,World Cup qualifier,in Slovenia,30,-30,1663,1654,6,-6,47,50,1633,1684,T1
3757,October 11,2013,Spain,Belarus,2,1,World Cup qualifier,in Spain,1,-1,2122,1584,0,0,1,60,2121,1585,T1
3758,October 11,2013,Sweden,Austria,2,1,World Cup qualifier,in Sweden,5,-5,1885,1642,0,-3,11,53,1880,1647,T1
3759,October 11,2013,Ukraine,Poland,1,0,World Cup qualifier,in Ukraine,7,-7,1818,1649,0,-2,21,51,1811,1656,T1
3760,October 11,2013,United States,Jamaica,2,0,World Cup qualifier,in the United States,5,-5,1861,1542,1,-2,15,74,1856,1547,T1
3761,October 11,2013,Venezuela,Paraguay,1,1,World Cup qualifier,in Venezuela,-6,6,1705,1718,-1,1,37,34,1711,1712,draw
3762,October 11,2013,Wales,Macedonia,1,0,World Cup qualifier,in Wales,14,-14,1569,1524,5,-4,64,80,1555,1538,T1
3763,October 12,2013,Burkina Faso,Algeria,3,2,World Cup qualifier,in Burkina Faso,17,-17,1564,1572,5,-4,68,63,1547,1589,T1
3764,October 12,2013,Ivory Coast,Senegal,3,1,World Cup qualifier,in Ivory Coast,8,-8,1790,1556,1,-3,22,71,1782,1564,T1
3765,October 12,2013,South Korea,Brazil,0,2,Friendly,in South Korea,-4,4,1673,2123,0,1,45,1,1677,2119,T2
3766,October 13,2013,Ethiopia,Nigeria,1,2,World Cup qualifier,in Ethiopia,-9,9,1390,1724,-3,4,110,31,1399,1715,T2
3767,October 13,2013,Pakistan,Taiwan,1,0,Friendly tournament,in the Philippines,12,-12,949,843,2,-1,194,207,937,855,T1
3768,October 13,2013,Qatar,Yemen,6,0,Asian Cup qualifier,in Qatar,11,-11,1444,1188,2,-5,100,162,1433,1199,T1
3769,October 13,2013,Tunisia,Cameroon,0,0,World Cup qualifier,in Tunisia,-3,3,1528,1583,-1,1,79,61,1531,1580,draw
3770,October 15,2013,Australia,Canada,3,0,Friendly,in England,8,-8,1721,1495,4,-4,32,89,1713,1503,T1
3771,October 15,2013,Azerbaijan,Russia,1,1,World Cup qualifier,in Azerbaijan,14,-14,1454,1842,4,0,97,17,1440,1856,draw
3772,October 15,2013,Belarus,Japan,1,0,Friendly,in Belarus,12,-12,1596,1743,2,-2,57,27,1584,1755,T1
3773,October 15,2013,Belgium,Wales,1,1,World Cup qualifier,in Belgium,-17,17,1868,1586,-3,4,14,60,1885,1569,draw
3774,October 15,2013,Brazil,Zambia,2,0,Friendly,in China,1,-1,2124,1537,0,0,1,76,2123,1538,T1
3775,October 15,2013,Bulgaria,Czechia,0,1,World Cup qualifier,in Bulgaria,-22,22,1642,1758,-5,3,51,25,1664,1736,T2
3776,October 15,2013,Chile,Ecuador,2,1,World Cup qualifier,in Chile,12,-12,1897,1836,1,0,10,18,1885,1848,T1
3777,October 15,2013,Costa Rica,Mexico,2,1,World Cup qualifier,in Costa Rica,18,-18,1743,1765,3,-1,27,24,1725,1783,T1
3778,October 15,2013,Cyprus,Albania,0,0,World Cup qualifier,in Cyprus,2,-2,1389,1516,-1,2,112,80,1387,1518,draw
3779,October 15,2013,Denmark,Malta,6,0,World Cup qualifier,in Denmark,3,-3,1742,1247,-2,-1,29,145,1739,1250,T1
3780,October 15,2013,England,Poland,2,0,World Cup qualifier,in England,5,-5,1965,1644,0,2,6,49,1960,1649,T1
3781,October 15,2013,Faroe Islands,Austria,0,3,World Cup qualifier,in the Faroe Islands,-8,8,1189,1650,-2,5,160,48,1197,1642,T2
3782,October 15,2013,France,Finland,3,0,World Cup qualifier,in France,11,-11,1884,1673,2,-2,12,45,1873,1684,T1
3783,October 15,2013,Ghana,Egypt,6,1,World Cup qualifier,in Ghana,30,-30,1720,1672,8,-7,33,46,1690,1702,T1
3784,October 15,2013,Greece,Liechtenstein,2,0,World Cup qualifier,in Greece,1,-1,1827,1190,1,1,19,159,1826,1191,T1
3785,October 15,2013,Hong Kong,United Arab Emirates,0,4,Asian Cup qualifier,in Hong Kong,-10,10,1187,1640,-4,1,162,53,1197,1630,T2
3786,October 15,2013,Hungary,Andorra,2,0,World Cup qualifier,in Hungary,1,-1,1682,993,1,0,43,190,1681,994,T1
3787,October 15,2013,Indonesia,China,1,1,Asian Cup qualifier,in Indonesia,14,-14,1239,1598,4,1,147,56,1225,1612,draw
3788,October 15,2013,Iran,Thailand,2,1,Asian Cup qualifier,in Iran,3,-3,1701,1361,1,-1,39,120,1698,1364,T1
3789,October 15,2013,Ireland,Kazakhstan,3,1,World Cup qualifier,in Ireland,4,-4,1709,1358,2,-2,35,122,1705,1362,T1
3790,October 15,2013,Israel,Northern Ireland,1,1,World Cup qualifier,in Israel,-16,16,1641,1413,-3,-1,52,108,1657,1397,draw
3791,October 15,2013,Italy,Armenia,2,2,World Cup qualifier,in Italy,-17,17,1910,1581,-2,4,9,64,1927,1564,draw
3792,October 15,2013,Jamaica,Honduras,2,2,World Cup qualifier,in Jamaica,3,-3,1545,1685,0,1,74,41,1542,1688,draw
3793,October 15,2013,Jordan,Oman,0,0,Asian Cup qualifier,in Jordan,-6,6,1561,1561,-2,5,67,67,1567,1555,draw
3794,October 15,2013,Kyrgyzstan,Tajikistan,1,4,Friendly,in Kyrgyzstan,-18,18,1137,1260,-5,2,173,144,1155,1242,T2
3795,October 15,2013,Latvia,Slovakia,2,2,World Cup qualifier,in Latvia,2,-2,1459,1594,2,-1,94,59,1457,1596,draw
3796,October 15,2013,Lebanon,Kuwait,1,1,Asian Cup qualifier,in Lebanon,5,-5,1381,1560,1,-2,115,69,1376,1565,draw
3797,October 15,2013,Lithuania,Bosnia and Herzegovina,0,1,World Cup qualifier,in Lithuania,-9,9,1458,1790,-2,2,95,22,1467,1781,T2
3798,October 15,2013,Malaysia,Bahrain,1,1,Asian Cup qualifier,in Malaysia,9,-9,1186,1439,1,-3,163,102,1177,1448,draw
3799,October 15,2013,Montenegro,Moldova,2,5,World Cup qualifier,in Montenegro,-63,63,1595,1448,-10,12,58,100,1658,1385,T2
3800,October 15,2013,Norway,Iceland,1,1,World Cup qualifier,in Norway,-11,11,1643,1540,0,3,50,75,1654,1529,draw
3801,October 15,2013,Panama,United States,2,3,World Cup qualifier,in Panama,-18,18,1701,1879,-5,2,39,13,1719,1861,T2
3802,October 15,2013,Paraguay,Colombia,1,2,World Cup qualifier,in Paraguay,-16,16,1702,1912,-3,1,38,8,1718,1896,T2
3803,October 15,2013,Peru,Bolivia,1,1,World Cup qualifier,in Peru,-11,11,1711,1627,-1,1,34,55,1722,1616,draw
3804,October 15,2013,Philippines,Pakistan,3,1,Friendly tournament,in the Philippines,6,-6,1196,943,3,-1,158,195,1190,949,T1
3805,October 15,2013,Portugal,Luxembourg,3,0,World Cup qualifier,in Portugal,1,-1,1896,1214,-1,0,11,153,1895,1215,T1
3806,October 15,2013,Romania,Estonia,2,0,World Cup qualifier,in Romania,6,-6,1733,1452,-1,-3,30,98,1727,1458,T1
3807,October 15,2013,San Marino,Ukraine,0,8,World Cup qualifier,in San Marino,-1,1,878,1819,0,1,202,20,879,1818,T2
3808,October 15,2013,Saudi Arabia,Iraq,2,0,Asian Cup qualifier,in Jordan,36,-36,1502,1505,9,-9,85,84,1466,1541,T1
3809,October 15,2013,Scotland,Croatia,2,0,World Cup qualifier,in Scotland,38,-38,1685,1808,11,-2,41,21,1647,1846,T1
3810,October 15,2013,Serbia,Macedonia,5,1,World Cup qualifier,in Serbia,10,-10,1751,1514,0,-2,26,82,1741,1524,T1
3811,October 15,2013,Singapore,Syria,2,1,Asian Cup qualifier,in Singapore,28,-28,1283,1472,4,-6,139,93,1255,1500,T1
3812,October 15,2013,South Korea,Mali,3,1,Friendly,in South Korea,7,-7,1680,1559,1,-5,44,71,1673,1566,T1
3813,October 15,2013,Spain,Georgia,2,0,World Cup qualifier,in Spain,1,-1,2123,1498,0,1,2,88,2122,1499,T1
3814,October 15,2013,Sweden,Germany,3,5,World Cup qualifier,in Sweden,-24,24,1861,2079,-5,0,16,3,1885,2055,T2
3815,October 15,2013,Switzerland,Slovenia,1,0,World Cup qualifier,in Switzerland,6,-6,1864,1657,1,0,15,47,1858,1663,T1
3816,October 15,2013,Trinidad and Tobago,New Zealand,0,0,Friendly,in Trinidad and Tobago,0,0,1481,1583,0,-1,90,62,1481,1583,draw
3817,October 15,2013,Turkey,Netherlands,0,2,World Cup qualifier,in Turkey,-16,16,1707,2016,-4,0,36,5,1723,2000,T2
3818,October 15,2013,Uruguay,Argentina,3,2,World Cup qualifier,in Uruguay,23,-23,1920,2020,1,0,7,4,1897,2043,T1
3819,October 15,2013,Uzbekistan,Vietnam,3,1,Asian Cup qualifier,in Uzbekistan,3,-3,1631,1233,1,-1,54,149,1628,1236,T1
3820,October 28,2013,Jordan,Nigeria,1,0,Friendly,in Jordan,12,-12,1573,1712,2,-2,65,33,1561,1724,T1
3821,November 1,2013,Indonesia,Kyrgyzstan,4,0,Friendly,in Indonesia,9,-9,1248,1128,2,-1,145,174,1239,1137,T1
3822,November 6,2013,Jordan,Zambia,1,0,Friendly,in Qatar,9,-9,1582,1528,1,-1,64,77,1573,1537,T1
3823,November 8,2013,Kuwait,Malaysia,3,0,Friendly,in Kuwait,2,-2,1562,1184,1,0,68,163,1560,1186,T1
3824,November 9,2013,Bahrain,Lebanon,1,0,Friendly,in Bahrain,6,-6,1445,1375,1,-1,101,116,1439,1381,T1
3825,November 9,2013,United Arab Emirates,Philippines,4,0,Friendly,in the United Arab Emirates,2,-2,1642,1194,2,0,51,158,1640,1196,T1
3826,November 11,2013,Iraq,Syria,2,1,Friendly,in Jordan,9,-9,1514,1463,2,0,82,93,1505,1472,T1
3827,November 13,2013,Jordan,Uruguay,0,5,World Cup qualifier,in Jordan,-16,16,1566,1936,-2,0,66,7,1582,1920,T2
3828,November 13,2013,Mexico,New Zealand,5,1,World Cup qualifier,in Mexico,12,-12,1777,1571,0,-3,24,65,1765,1583,T1
3829,November 14,2013,Belgium,Colombia,0,2,Friendly,in Belgium,-17,17,1851,1929,-2,0,16,8,1868,1912,T2
3830,November 14,2013,Curaçao,Aruba,2,0,Friendly tournament,in Curaçao,14,-14,1024,964,1,-1,186,192,1010,978,T1
3831,November 14,2013,Egypt,Zambia,2,0,Friendly,in Egypt,6,-6,1678,1522,1,-2,45,79,1672,1528,T1
3832,November 14,2013,Suriname,Bonaire,2,0,Friendly tournament,in Curaçao,9,-9,1212,954,0,0,154,193,1203,963,T1
3833,November 15,2013,Albania,Belarus,0,0,Friendly,in Turkey,2,-2,1518,1594,0,-2,80,59,1516,1596,draw
3834,November 15,2013,Argentina,Ecuador,0,0,Friendly,in the United States,-5,5,2015,1841,-1,-1,5,19,2020,1836,draw
3835,November 15,2013,Bahrain,Malaysia,1,0,Asian Cup qualifier,in Bahrain,4,-4,1449,1180,1,0,100,163,1445,1184,T1
3836,November 15,2013,China,Indonesia,1,0,Asian Cup qualifier,in China,3,-3,1601,1245,-1,-2,57,147,1598,1248,T1
3837,November 15,2013,Czechia,Canada,2,0,Friendly,in Czechia,3,-3,1761,1492,0,-1,25,90,1758,1495,T1
3838,November 15,2013,Denmark,Norway,2,1,Friendly,in Denmark,5,-5,1747,1638,2,-3,27,53,1742,1643,T1
3839,November 15,2013,England,Chile,0,2,Friendly,in England,-22,22,1943,1919,0,1,6,9,1965,1897,T2
3840,November 15,2013,Estonia,Azerbaijan,2,1,Friendly,in Estonia,7,-7,1459,1447,4,-5,94,102,1452,1454,T1
3841,November 15,2013,Greece,Romania,3,1,World Cup qualifier,in Greece,15,-15,1842,1718,1,-2,18,32,1827,1733,T1
3842,November 15,2013,Iceland,Croatia,0,0,World Cup qualifier,in Iceland,9,-9,1549,1799,3,0,72,21,1540,1808,draw
3843,November 15,2013,India,Philippines,1,1,Friendly,in India,0,0,1077,1194,0,0,181,158,1077,1194,draw
3844,November 15,2013,Ireland,Latvia,3,0,Friendly,in Ireland,4,-4,1713,1455,1,-3,34,97,1709,1459,T1
3845,November 15,2013,Italy,Germany,1,1,Friendly,in Italy,2,-2,1912,2077,-1,0,10,3,1910,2079,draw
3846,November 15,2013,Jamaica,Trinidad and Tobago,0,1,Friendly,in Jamaica,-14,14,1531,1495,-2,1,76,89,1545,1481,T2
3847,November 15,2013,Kuwait,Lebanon,0,0,Asian Cup qualifier,in Kuwait,-14,14,1548,1389,-5,4,73,112,1562,1375,draw
3848,November 15,2013,Libya,Niger,1,1,Friendly,in Tunisia,-6,6,1548,1291,0,1,73,137,1554,1285,draw
3849,November 15,2013,Poland,Slovakia,0,2,Friendly,in Poland,-21,21,1623,1615,-6,3,55,56,1644,1594,T2
3850,November 15,2013,Portugal,Sweden,1,0,World Cup qualifier,in Portugal,13,-13,1909,1848,0,-1,11,16,1896,1861,T1
3851,November 15,2013,Qatar,Yemen,4,1,Asian Cup qualifier,in the United Arab Emirates,13,-13,1457,1175,6,-4,96,165,1444,1188,T1
3852,November 15,2013,Russia,Serbia,1,1,Friendly,in the United Arab Emirates,-3,3,1839,1754,-3,0,20,26,1842,1751,draw
3853,November 15,2013,Saudi Arabia,Iraq,2,1,Asian Cup qualifier,in Saudi Arabia,15,-15,1517,1499,4,-5,81,87,1502,1514,T1
3854,November 15,2013,Scotland,United States,0,0,Friendly,in Scotland,3,-3,1688,1876,-1,1,42,12,1685,1879,draw
3855,November 15,2013,South Korea,Switzerland,2,1,Friendly,in South Korea,12,-12,1692,1852,3,0,41,14,1680,1864,T1
3856,November 15,2013,Swaziland,South Africa,0,3,Friendly,in Swaziland,-4,4,1081,1564,-1,3,180,67,1085,1560,T2
3857,November 15,2013,Syria,Singapore,4,0,Asian Cup qualifier,in Iran,20,-20,1483,1263,2,-4,91,143,1463,1283,T1
3858,November 15,2013,Thailand,Iran,0,3,Asian Cup qualifier,in Thailand,-14,14,1347,1715,-4,6,124,33,1361,1701,T2
3859,November 15,2013,Turkey,Northern Ireland,1,0,Friendly,in Turkey,2,-2,1709,1411,-1,0,37,108,1707,1413,T1
3860,November 15,2013,United Arab Emirates,Hong Kong,4,0,Asian Cup qualifier,in the United Arab Emirates,3,-3,1645,1184,2,1,49,161,1642,1187,T1
3861,November 15,2013,Ukraine,France,2,0,World Cup qualifier,in Ukraine,27,-27,1846,1857,3,-1,17,13,1819,1884,T1
3862,November 15,2013,Vietnam,Uzbekistan,0,3,Asian Cup qualifier,in Vietnam,-11,11,1222,1642,-2,4,151,50,1233,1631,T2
3863,November 16,2013,Bonaire,Aruba,2,1,Friendly tournament,in Curaçao,15,-15,969,949,2,-1,191,193,954,964,T1
3864,November 16,2013,Brazil,Honduras,5,0,Friendly,in the United States,3,-3,2127,1682,0,0,1,43,2124,1685,T1
3865,November 16,2013,Curaçao,Suriname,1,3,Friendly tournament,in Curaçao,-17,17,1007,1229,-1,4,187,150,1024,1212,T2
3866,November 16,2013,Equatorial Guinea,Spain,1,2,Friendly,in Equatorial Guinea,0,0,1304,2123,0,0,135,2,1304,2123,T2
3867,November 16,2013,Ivory Coast,Senegal,1,1,World Cup qualifier,in Morocco,-12,12,1778,1568,-1,5,23,66,1790,1556,draw
3868,November 16,2013,Japan,Netherlands,2,2,Friendly,in Belgium,7,-7,1750,2009,1,-1,27,5,1743,2016,draw
3869,November 16,2013,Laos,Guam,1,1,Friendly,in Laos,-6,6,855,737,0,0,205,212,861,731,draw
3870,November 16,2013,Nigeria,Ethiopia,2,0,World Cup qualifier,in Nigeria,5,-5,1717,1385,2,-2,33,113,1712,1390,T1
3871,November 16,2013,Uganda,Rwanda,0,0,Friendly,in Uganda,-7,7,1493,1329,-3,0,89,128,1500,1322,draw
3872,November 16,2013,Wales,Finland,1,1,Friendly,in Wales,0,0,1586,1673,0,0,60,46,1586,1673,draw
3873,November 17,2013,Cameroon,Tunisia,4,1,World Cup qualifier,in Cameroon,20,-20,1603,1508,5,-7,57,84,1583,1528,T1
3874,November 17,2013,Luxembourg,Montenegro,1,4,Friendly,in Luxembourg,-6,6,1208,1601,0,0,154,58,1214,1595,T2
3875,November 18,2013,Argentina,Bosnia and Herzegovina,2,0,Friendly,in the United States,6,-6,2021,1784,0,0,4,22,2015,1790,T1
3876,November 18,2013,Italy,Nigeria,2,2,Friendly,in England,-5,5,1907,1722,-1,3,11,30,1912,1717,draw
3877,November 18,2013,Libya,Benin,1,0,Friendly,in Tunisia,6,-6,1554,1388,1,-2,72,112,1548,1394,T1
3878,November 18,2013,Moldova,Lithuania,1,1,Friendly,in Moldova,-3,3,1445,1461,-1,1,102,94,1448,1458,draw
3879,November 19,2013,Algeria,Burkina Faso,1,0,World Cup qualifier,in Algeria,14,-14,1586,1550,3,-5,61,73,1572,1564,T1
3880,November 19,2013,Australia,Costa Rica,1,0,Friendly,in Australia,8,-8,1729,1735,0,0,31,29,1721,1743,T1
3881,November 19,2013,Austria,United States,1,0,Friendly,in Austria,13,-13,1663,1863,1,-1,47,13,1650,1876,T1
3882,November 19,2013,Bahrain,Yemen,2,0,Asian Cup qualifier,in Bahrain,6,-6,1455,1169,3,0,97,165,1449,1175,T1
3883,November 19,2013,Belgium,Japan,2,3,Friendly,in Belgium,-15,15,1836,1765,-3,2,18,25,1851,1750,T2
3884,November 19,2013,Brazil,Chile,2,1,Friendly,in Canada,5,-5,2132,1914,0,-1,1,10,2127,1919,T1
3885,November 19,2013,China,Saudi Arabia,0,0,Asian Cup qualifier,in China,-10,10,1591,1527,-1,4,59,76,1601,1517,draw
3886,November 19,2013,Croatia,Iceland,2,0,World Cup qualifier,in Croatia,7,-7,1806,1542,0,-1,21,74,1799,1549,T1
3887,November 19,2013,Ecuador,Honduras,2,2,Friendly,in the United States,-4,4,1837,1686,2,0,17,43,1841,1682,draw
3888,November 19,2013,Egypt,Ghana,2,1,World Cup qualifier,in Egypt,17,-17,1695,1703,3,-6,42,38,1678,1720,T1
3889,November 19,2013,England,Germany,0,1,Friendly,in England,-9,9,1934,2086,-1,0,7,3,1943,2077,T2
3890,November 19,2013,France,Ukraine,3,0,World Cup qualifier,in France,24,-24,1881,1822,1,-3,12,20,1857,1846,T1
3891,November 19,2013,Gibraltar,Slovakia,0,0,Friendly,in Portugal,9,-9,1152,1606,3,0,168,56,1143,1615,draw
3892,November 19,2013,Hong Kong,Uzbekistan,0,2,Asian Cup qualifier,in Hong Kong,-7,7,1177,1649,-1,1,162,49,1184,1642,T2
3893,November 19,2013,India,Nepal,2,0,Friendly,in India,5,-5,1082,903,2,0,179,200,1077,908,T1
3894,November 19,2013,Indonesia,Iraq,0,2,Asian Cup qualifier,in Indonesia,-18,18,1227,1517,-3,5,150,81,1245,1499,T2
3895,November 19,2013,Kuwait,Thailand,3,1,Asian Cup qualifier,in Kuwait,9,-9,1557,1338,3,-1,71,125,1548,1347,T1
3896,November 19,2013,Kyrgyzstan,Azerbaijan,0,0,Friendly,in Kyrgyzstan,6,-6,1134,1441,0,-1,174,102,1128,1447,draw
3897,November 19,2013,Lebanon,Iran,1,4,Asian Cup qualifier,in Lebanon,-15,15,1374,1730,-6,4,116,30,1389,1715,T2
3898,November 19,2013,Liechtenstein,Estonia,0,3,Friendly,in Liechtenstein,-10,10,1180,1469,-2,2,161,93,1190,1459,T2
3899,November 19,2013,Malaysia,Qatar,0,1,Asian Cup qualifier,in Malaysia,-11,11,1169,1468,-2,2,165,94,1180,1457,T2
3900,November 19,2013,Malta,Faroe Islands,3,2,Friendly,in Malta,6,-6,1253,1183,0,1,145,159,1247,1189,T1
3901,November 19,2013,Namibia,Mozambique,0,0,Friendly,in Namibia,-1,1,1291,1367,0,0,136,117,1292,1366,draw
3902,November 19,2013,Netherlands,Colombia,0,0,Friendly,in the Netherlands,-5,5,2004,1934,0,1,5,7,2009,1929,draw
3903,November 19,2013,Norway,Scotland,0,1,Friendly,in Norway,-11,11,1627,1699,0,1,53,41,1638,1688,T2
3904,November 19,2013,Oman,Syria,1,0,Asian Cup qualifier,in Iran,16,-16,1577,1467,4,-4,66,95,1561,1483,T1
3905,November 19,2013,Poland,Ireland,0,0,Friendly,in Poland,0,0,1623,1713,0,1,55,34,1623,1713,draw
3906,November 19,2013,Romania,Greece,1,1,World Cup qualifier,in Romania,1,-1,1719,1841,0,2,33,16,1718,1842,draw
3907,November 19,2013,Russia,South Korea,2,1,Friendly,in the United Arab Emirates,6,-6,1845,1686,5,-2,15,43,1839,1692,T1
3908,November 19,2013,Slovenia,Canada,1,0,Friendly,in Slovenia,4,-4,1661,1488,-1,0,48,90,1657,1492,T1
3909,November 19,2013,South Africa,Spain,1,0,Friendly,in South Africa,19,-19,1583,2104,4,0,64,2,1564,2123,T1
3910,November 19,2013,Sweden,Portugal,2,3,World Cup qualifier,in Sweden,-22,22,1826,1931,-3,1,19,9,1848,1909,T2
3911,November 19,2013,Tanzania,Zimbabwe,0,0,Friendly,in Tanzania,-3,3,1357,1360,-3,3,123,120,1360,1357,draw
3912,November 19,2013,Trinidad and Tobago,Jamaica,2,0,Friendly,in Trinidad and Tobago,12,-12,1507,1519,2,-3,86,79,1495,1531,T1
3913,November 19,2013,Turkey,Belarus,2,1,Friendly,in Turkey,4,-4,1713,1590,3,0,34,60,1709,1594,T1
3914,November 19,2013,United Arab Emirates,Vietnam,5,0,Asian Cup qualifier,in the United Arab Emirates,4,-4,1649,1218,0,-1,49,153,1645,1222,T1
3915,November 20,2013,New Zealand,Mexico,2,4,World Cup qualifier,in New Zealand,-21,21,1550,1798,-5,2,72,22,1571,1777,T2
3916,November 20,2013,Uruguay,Jordan,0,0,World Cup qualifier,in Uruguay,-17,17,1919,1583,-3,5,9,64,1936,1566,draw
3917,November 27,2013,Kenya,Ethiopia,0,0,CECAFA Cup,in Kenya,-5,5,1378,1390,-1,2,115,110,1383,1385,draw
3918,November 27,2013,Seychelles,Maldives,3,1,Friendly,in the Seychelles,16,-16,983,1084,1,-1,191,178,967,1100,T1
3919,November 27,2013,Zanzibar,South Sudan,2,1,CECAFA Cup,in Kenya,9,-9,1316,1073,4,-2,129,181,1307,1082,T1
3920,November 28,2013,Burundi,Somalia,2,0,CECAFA Cup,in Kenya,4,-4,1320,872,0,0,129,203,1316,876,T1
3921,November 28,2013,Tanzania,Zambia,1,1,CECAFA Cup,in Kenya,9,-9,1366,1513,5,-5,118,83,1357,1522,draw
3922,November 29,2013,Seychelles,Maldives,2,1,Friendly,in the Seychelles,10,-10,993,1074,1,-2,190,180,983,1084,T1
3923,November 29,2013,Sudan,Eritrea,3,0,CECAFA Cup,in Kenya,20,-20,1331,1126,4,-3,128,174,1311,1146,T1
3924,November 29,2013,Uganda,Rwanda,1,0,CECAFA Cup,in Kenya,11,-11,1504,1318,2,-2,87,130,1493,1329,T1
3925,November 30,2013,Dominica,Saint Lucia,0,1,Friendly,in Dominica,-12,12,1006,1063,-2,2,188,183,1018,1051,T2
3926,November 30,2013,Ethiopia,Zanzibar,3,1,CECAFA Cup,in Kenya,24,-24,1414,1292,2,-4,108,135,1390,1316,T1
3927,November 30,2013,Kenya,South Sudan,3,1,CECAFA Cup,in Kenya,5,-5,1383,1068,1,0,114,181,1378,1073,T1
3928,December 1,2013,Dominica,Saint Lucia,1,0,Friendly,in Dominica,9,-9,1015,1054,2,0,186,183,1006,1063,T1
3929,December 1,2013,Tanzania,Somalia,1,0,CECAFA Cup,in Kenya,2,-2,1368,870,1,0,117,203,1366,872,T1
3930,December 1,2013,Zambia,Burundi,1,0,CECAFA Cup,in Kenya,10,-10,1523,1310,5,-3,78,132,1513,1320,T1
3931,December 2,2013,Sudan,Rwanda,1,0,CECAFA Cup,in Kenya,19,-19,1350,1299,4,-5,124,134,1331,1318,T1
3932,December 2,2013,Uganda,Eritrea,3,0,CECAFA Cup,in Kenya,7,-7,1511,1119,3,0,84,174,1504,1126,T1
3933,December 3,2013,Ethiopia,South Sudan,2,0,CECAFA Cup,in Kenya,7,-7,1421,1061,2,-1,106,182,1414,1068,T1
3934,December 3,2013,Kenya,Zanzibar,2,0,CECAFA Cup,in Kenya,15,-15,1398,1277,4,-4,110,139,1383,1292,T1
3935,December 4,2013,Tanzania,Burundi,1,0,CECAFA Cup,in Kenya,17,-17,1385,1293,3,-3,114,134,1368,1310,T1
3936,December 4,2013,Zambia,Somalia,4,0,CECAFA Cup,in Kenya,2,-2,1525,868,1,-1,77,204,1523,870,T1
3937,December 5,2013,Rwanda,Eritrea,1,0,CECAFA Cup,in Kenya,10,-10,1309,1109,2,-1,131,175,1299,1119,T1
3938,December 5,2013,Uganda,Sudan,1,0,CECAFA Cup,in Kenya,11,-11,1522,1339,5,-1,79,125,1511,1350,T1
3939,December 7,2013,Kenya,Rwanda,1,0,CECAFA Cup,in Kenya,10,-10,1408,1299,0,-2,110,133,1398,1309,T1
3940,December 7,2013,Tanzania,Uganda,2,2,CECAFA Cup,in Kenya,8,-8,1393,1514,2,-4,112,83,1385,1522,draw
3941,December 8,2013,Burundi,Zambia,0,0,CECAFA Cup,in Kenya,12,-12,1305,1513,3,-7,131,84,1293,1525,draw
3942,December 8,2013,Sudan,Ethiopia,2,0,CECAFA Cup,in Kenya,37,-37,1376,1384,8,-9,117,115,1339,1421,T1
3943,December 10,2013,Kenya,Tanzania,1,0,CECAFA Cup,in Kenya,14,-14,1422,1379,3,-5,106,116,1408,1393,T1
3944,December 10,2013,Sudan,Zambia,2,1,CECAFA Cup,in Kenya,28,-28,1404,1485,7,-6,110,90,1376,1513,T1
3945,December 12,2013,Kenya,Sudan,2,0,CECAFA Cup,in Kenya,20,-20,1442,1384,4,-5,102,115,1422,1404,T1
3946,December 12,2013,Tanzania,Zambia,1,1,CECAFA Cup,in Kenya,6,-6,1385,1479,3,-1,113,91,1379,1485,draw
3947,December 21,2013,Qatar,Bahrain,1,1,Friendly,in Qatar,-3,3,1465,1458,-1,0,95,97,1468,1455,draw
3948,December 25,2013,Qatar,Palestine,1,0,West Asian Championship,in Qatar,7,-7,1472,1279,2,-1,93,138,1465,1286,T1
3949,January 4,2014,Jordan,Bahrain,1,0,West Asian Championship,in Qatar,14,-14,1586,1444,6,-4,61,101,1572,1458,T1
3950,January 7,2014,Qatar,Jordan,2,0,West Asian Championship,in Qatar,31,-31,1503,1555,6,-9,87,70,1472,1586,T1
3951,January 15,2014,Norway,Moldova,2,1,Friendly,in the United Arab Emirates,5,-5,1632,1440,0,-3,53,103,1627,1445,T1
3952,January 17,2014,Sweden,Moldova,2,1,Friendly,in the United Arab Emirates,2,-2,1828,1438,0,-1,19,104,1826,1440,T1
3953,January 18,2014,Poland,Norway,3,0,Friendly,in the United Arab Emirates,18,-18,1641,1614,3,-2,52,55,1623,1632,T1
3954,January 20,2014,Poland,Moldova,1,0,Friendly,in the United Arab Emirates,5,-5,1646,1433,1,0,51,104,1641,1438,T1
3955,January 21,2014,Sweden,Iceland,2,0,Friendly,in the United Arab Emirates,5,-5,1833,1537,0,0,19,74,1828,1542,T1
3956,January 22,2014,Chile,Costa Rica,4,0,Friendly,in Chile,6,-6,1920,1729,1,-1,9,30,1914,1735,T1
3957,January 24,2014,Oman,Finland,0,0,Friendly,in Oman,0,0,1577,1673,0,0,66,46,1577,1673,draw
3958,January 25,2014,South Korea,Costa Rica,1,0,Friendly,in the United States,11,-11,1697,1718,1,-3,42,33,1686,1729,T1
3959,January 29,2014,Mexico,South Korea,4,0,Friendly,in the United States,13,-13,1811,1684,1,-2,21,44,1798,1697,T1
3960,January 31,2014,Oman,Jordan,0,0,Asian Cup qualifier,in Oman,-7,7,1570,1562,0,2,66,68,1577,1555,draw
3961,February 1,2014,United States,South Korea,2,0,Friendly,in the United States,5,-5,1868,1679,0,-1,13,45,1863,1684,T1
3962,February 4,2014,Singapore,Jordan,1,3,Asian Cup qualifier,in Singapore,-14,14,1249,1576,-2,2,145,66,1263,1562,T2
3963,February 7,2014,Saint Vincent and the Grenadines,Dominica,3,2,Friendly,in Saint Vincent and the Grenadines,4,-4,1146,1011,0,0,171,186,1142,1015,T1
3964,February 9,2014,Saint Vincent and the Grenadines,Dominica,0,0,Friendly,in Saint Vincent and the Grenadines,-6,6,1140,1017,0,0,171,186,1146,1011,draw
3965,February 19,2014,Lebanon,Pakistan,3,1,Friendly,in Lebanon,1,-1,1386,942,0,-1,113,196,1385,943,T1
3966,February 21,2014,Iraq,North Korea,2,0,Friendly,in the United Arab Emirates,18,-18,1535,1566,5,-5,75,68,1517,1584,T1
3967,March 1,2014,Gibraltar,Faroe Islands,1,4,Friendly,in Gibraltar,-21,21,1131,1204,-5,4,173,155,1152,1183,T2
3968,March 1,2014,Malaysia,Philippines,0,0,Friendly,in Malaysia,-2,2,1167,1196,-1,-1,166,159,1169,1194,draw
3969,March 2,2014,Barbados,Jamaica,0,2,Friendly,in Barbados,-5,5,1130,1524,-2,1,173,78,1135,1519,T2
3970,March 3,2014,Iran,Kuwait,3,2,Asian Cup qualifier,in Iran,7,-7,1737,1550,0,-1,29,71,1730,1557,T1
3971,March 5,2014,Albania,Malta,2,0,Friendly,in Albania,3,-3,1521,1250,-1,0,81,144,1518,1253,T1
3972,March 5,2014,Algeria,Slovenia,2,0,Friendly,in Algeria,14,-14,1600,1647,3,-2,58,50,1586,1661,T1
3973,March 5,2014,Andorra,Moldova,0,3,Friendly,in Andorra,-4,4,989,1437,-1,0,191,104,993,1433,T2
3974,March 5,2014,Austria,Uruguay,1,1,Friendly,in Austria,4,-4,1667,1915,0,0,47,10,1663,1919,draw
3975,March 5,2014,Azerbaijan,Philippines,1,0,Friendly,in the United Arab Emirates,4,-4,1445,1192,1,0,101,159,1441,1196,T1
3976,March 5,2014,Belgium,Ivory Coast,2,2,Friendly,in Belgium,-4,4,1832,1782,0,1,18,23,1836,1778,draw
3977,March 5,2014,Botswana,South Sudan,3,0,Friendly,in Botswana,4,-4,1309,1057,1,0,130,182,1305,1061,T1
3978,March 5,2014,Bulgaria,Belarus,2,1,Friendly,in Bulgaria,6,-6,1648,1584,3,-2,49,62,1642,1590,T1
3979,March 5,2014,Burkina Faso,Comoros,1,1,Friendly,in France,-10,10,1540,879,-3,1,74,202,1550,869,draw
3980,March 5,2014,Burundi,Rwanda,1,1,Friendly,in Burundi,-3,3,1302,1302,-1,2,132,132,1305,1299,draw
3981,March 5,2014,Colombia,Tunisia,1,1,Friendly,in Spain,-8,8,1926,1516,-2,2,8,83,1934,1508,draw
3982,March 5,2014,Costa Rica,Paraguay,2,1,Friendly,in Costa Rica,7,-7,1725,1695,4,-3,29,42,1718,1702,T1
3983,March 5,2014,Cyprus,Northern Ireland,0,0,Friendly,in Cyprus,-2,2,1387,1413,-2,-1,113,110,1389,1411,draw
3984,March 5,2014,Czechia,Norway,2,2,Friendly,in Czechia,-6,6,1755,1620,-1,0,27,55,1761,1614,draw
3985,March 5,2014,Ecuador,Australia,4,3,Friendly,in England,7,-7,1844,1722,1,-3,16,33,1837,1729,T1
3986,March 5,2014,Egypt,Bosnia and Herzegovina,2,0,Friendly,in Austria,19,-19,1714,1765,7,-3,35,26,1695,1784,T1
3987,March 5,2014,England,Denmark,1,0,Friendly,in England,3,-3,1937,1744,0,0,6,28,1934,1747,T1
3988,March 5,2014,France,Netherlands,2,0,Friendly,in France,16,-16,1897,1988,0,0,12,5,1881,2004,T1
3989,March 5,2014,Georgia,Liechtenstein,2,0,Friendly,in Georgia,2,-2,1500,1178,1,-1,88,162,1498,1180,T1
3990,March 5,2014,Germany,Chile,1,0,Friendly,in Germany,4,-4,2090,1916,0,0,3,9,2086,1920,T1
3991,March 5,2014,Gibraltar,Estonia,0,2,Friendly,in Gibraltar,-6,6,1125,1475,-1,0,173,94,1131,1469,T2
3992,March 5,2014,Greece,South Korea,0,2,Friendly,in Greece,-25,25,1816,1704,-4,7,20,38,1841,1679,T2
3993,March 5,2014,Honduras,Venezuela,2,1,Friendly,in Honduras,8,-8,1694,1697,0,-4,43,41,1686,1705,T1
3994,March 5,2014,Hungary,Finland,1,2,Friendly,in Hungary,-13,13,1669,1686,-2,1,46,45,1682,1673,T2
3995,March 5,2014,India,Bangladesh,2,2,Friendly,in India,-6,6,1076,949,-1,2,179,193,1082,943,draw
3996,March 5,2014,Iran,Guinea,1,2,Friendly,in Iran,-17,17,1720,1532,-5,6,34,75,1737,1515,T2
3997,March 5,2014,Iraq,China,3,1,Asian Cup qualifier,in the United Arab Emirates,35,-35,1570,1556,9,-11,66,70,1535,1591,T1
3998,March 5,2014,Ireland,Serbia,1,2,Friendly,in Ireland,-12,12,1701,1766,-5,2,39,25,1713,1754,T2
3999,March 5,2014,Israel,Slovakia,1,3,Friendly,in Israel,-21,21,1620,1627,-2,3,55,53,1641,1606,T2
4000,March 5,2014,Japan,New Zealand,4,2,Friendly,in Japan,4,-4,1769,1546,1,-2,24,73,1765,1550,T1
4001,March 5,2014,Jordan,Syria,2,1,Asian Cup qualifier,in Jordan,9,-9,1585,1458,4,0,61,95,1576,1467,T1
4002,March 5,2014,Kazakhstan,Lithuania,1,1,Friendly,in Turkey,3,-3,1361,1458,0,1,123,95,1358,1461,draw
4003,March 5,2014,Kosovo,Haiti,0,0,Friendly,in Kosovo,-1,1,1378,1433,-1,0,119,105,1379,1432,draw
4004,March 5,2014,Luxembourg,Cape Verde,0,0,Friendly,in Luxembourg,5,-5,1213,1505,0,-3,154,87,1208,1510,draw
4005,March 5,2014,Macedonia,Latvia,2,1,Friendly,in Macedonia,6,-6,1520,1449,0,-3,82,100,1514,1455,T1
4006,March 5,2014,Malawi,Zimbabwe,1,4,Friendly,in Malawi,-21,21,1315,1381,0,4,127,118,1336,1360,T2
4007,March 5,2014,Malaysia,Yemen,2,1,Asian Cup qualifier,in the United Arab Emirates,20,-20,1187,1149,6,-4,160,169,1167,1169,T1
4008,March 5,2014,Mali,Senegal,1,1,Friendly,in France,0,0,1559,1568,0,0,69,67,1559,1568,draw
4009,March 5,2014,Mauritania,Niger,1,1,Friendly,in Mauritania,0,0,1182,1291,-1,0,161,135,1182,1291,draw
4010,March 5,2014,Mexico,Nigeria,0,0,Friendly,in the United States,-3,3,1808,1725,-1,2,22,29,1811,1722,draw
4011,March 5,2014,Montenegro,Ghana,1,0,Friendly,in Montenegro,10,-10,1611,1693,1,-6,57,44,1601,1703,T1
4012,March 5,2014,Morocco,Gabon,1,1,Friendly,in Morocco,-4,4,1528,1506,-1,3,77,85,1532,1502,draw
4013,March 5,2014,Mozambique,Angola,1,1,Friendly,in Mozambique,-1,1,1366,1440,-1,0,120,103,1367,1439,draw
4014,March 5,2014,Namibia,Tanzania,1,1,Friendly,in Namibia,0,0,1291,1385,0,0,135,114,1291,1385,draw
4015,March 5,2014,Oman,Singapore,3,1,Asian Cup qualifier,in Oman,5,-5,1575,1244,1,-1,65,146,1570,1249,T1
4016,March 5,2014,Poland,Scotland,0,1,Friendly,in Poland,-11,11,1635,1710,-1,4,52,37,1646,1699,T2
4017,March 5,2014,Portugal,Cameroon,5,1,Friendly,in Portugal,3,-3,1934,1600,1,-1,7,58,1931,1603,T1
4018,March 5,2014,Qatar,Bahrain,0,0,Asian Cup qualifier,in Qatar,-9,9,1494,1453,-2,2,89,98,1503,1444,draw
4019,March 5,2014,Romania,Argentina,0,0,Friendly,in Romania,5,-5,1724,2016,1,0,31,4,1719,2021,draw
4020,March 5,2014,Russia,Armenia,2,0,Friendly,in Russia,3,-3,1848,1578,1,0,14,64,1845,1581,T1
4021,March 5,2014,Saudi Arabia,Indonesia,1,0,Asian Cup qualifier,in Saudi Arabia,4,-4,1531,1223,1,-2,76,152,1527,1227,T1
4022,March 5,2014,South Africa,Brazil,0,5,Friendly,in South Africa,-3,3,1580,2135,0,0,63,1,1583,2132,T2
4023,March 5,2014,Spain,Italy,1,0,Friendly,in Spain,3,-3,2107,1904,0,0,2,11,2104,1907,T1
4024,March 5,2014,Saint Lucia,Jamaica,0,5,Friendly,in Saint Lucia,-4,4,1050,1528,-2,1,185,77,1054,1524,T2
4025,March 5,2014,Switzerland,Croatia,2,2,Friendly,in Switzerland,-4,4,1848,1810,0,1,14,21,1852,1806,draw
4026,March 5,2014,Thailand,Lebanon,2,5,Asian Cup qualifier,in Thailand,-40,40,1298,1426,-8,7,134,106,1338,1386,T2
4027,March 5,2014,Turkey,Sweden,2,1,Friendly,in Turkey,11,-11,1724,1822,3,0,31,19,1713,1833,T1
4028,March 5,2014,Ukraine,United States,2,0,Friendly,in Cyprus,17,-17,1839,1851,3,0,17,13,1822,1868,T1
4029,March 5,2014,Uzbekistan,United Arab Emirates,1,1,Asian Cup qualifier,in Uzbekistan,-6,6,1643,1655,-2,1,51,48,1649,1649,draw
4030,March 5,2014,Vietnam,Hong Kong,3,1,Asian Cup qualifier,in Vietnam,18,-18,1236,1159,5,-4,148,166,1218,1177,T1
4031,March 5,2014,Wales,Iceland,3,1,Friendly,in Wales,9,-9,1595,1528,1,-3,60,77,1586,1537,T1
4032,March 5,2014,Zambia,Uganda,2,1,Friendly,in Zambia,8,-8,1487,1506,1,-3,91,85,1479,1514,T1
4033,March 7,2014,Lesotho,Swaziland,0,1,Friendly,in Lesotho,-16,16,1222,1097,-5,1,152,177,1238,1081,T2
4034,March 9,2014,Lesotho,Swaziland,0,0,Friendly,in Lesotho,-6,6,1216,1103,-1,0,153,177,1222,1097,draw
4035,March 19,2014,Saint Lucia,Martinique,0,0,Friendly,in Saint Lucia,6,-6,1056,1413,2,-1,183,109,1050,1419,draw
4036,March 25,2014,Yemen,Nepal,2,0,Friendly,in Qatar,6,-6,1155,897,2,-1,167,201,1149,903,T1
4037,March 26,2014,Indonesia,Andorra,1,0,Friendly,in Spain,4,-4,1227,985,1,0,150,191,1223,989,T1
4038,March 27,2014,Aruba,Guam,2,2,Friendly,in Aruba,-7,7,942,744,-2,0,195,212,949,737,draw
4039,March 29,2014,Cuba,Indonesia,1,0,Friendly,in Spain,5,-5,1422,1222,0,-1,108,151,1417,1227,T1
4040,March 30,2014,Aruba,Guam,2,0,Friendly,in Aruba,5,-5,947,739,1,0,194,212,942,744,T1
4041,April 2,2014,United States,Mexico,2,2,Friendly,in the United States,-4,4,1847,1812,-2,1,15,21,1851,1808,draw
4042,April 11,2014,Philippines,Nepal,3,0,Friendly,in Qatar,5,-5,1197,892,0,0,159,201,1192,897,T1
4043,April 12,2014,Mauritania,Mauritius,1,0,African Nations Cup qualifier,in Mauritania,8,-8,1190,1046,1,-1,160,185,1182,1054,T1
4044,April 13,2014,Afghanistan,Kyrgyzstan,0,0,Friendly,in the United Arab Emirates,2,-2,1055,1132,0,0,184,171,1053,1134,draw
4045,April 15,2014,Chad,Yemen,0,0,Friendly,in Qatar,-2,2,1231,1157,0,0,148,167,1233,1155,draw
4046,April 17,2014,Guadeloupe,French Guiana,3,2,Friendly tournament,in Guadeloupe,6,-6,1391,1241,2,-1,112,146,1385,1247,T1
4047,April 19,2014,Guadeloupe,Martinique,0,1,Friendly tournament,in Guadeloupe,-18,18,1373,1431,-7,3,119,106,1391,1413,T2
4048,April 20,2014,Mauritius,Mauritania,0,2,African Nations Cup qualifier,in Mauritius,-26,26,1020,1216,0,7,185,153,1046,1190,T2
4049,April 26,2014,Tanzania,Burundi,0,3,Friendly,in Tanzania,-26,26,1359,1328,-9,5,123,127,1385,1302,T2
4050,April 27,2014,Philippines,Malaysia,0,0,Friendly,in the Philippines,-3,3,1194,1190,0,0,160,161,1197,1187,draw
4051,April 30,2014,Dominica,Saint Lucia,0,2,Windward Islands Championship,in Dominica,-26,26,991,1082,-4,4,190,179,1017,1056,T2
4052,April 30,2014,Grenada,Saint Vincent and the Grenadines,0,0,Windward Islands Championship,in Dominica,-2,2,1196,1142,0,0,159,170,1198,1140,draw
4053,May 2,2014,Dominica,Saint Vincent and the Grenadines,2,3,Windward Islands Championship,in Dominica,-13,13,978,1155,-1,2,191,168,991,1142,T2
4054,May 2,2014,Saint Lucia,Grenada,1,0,Windward Islands Championship,in Dominica,20,-20,1102,1176,1,-3,178,162,1082,1196,T1
4055,May 4,2014,Dominica,Grenada,3,5,Windward Islands Championship,in Dominica,-16,16,962,1192,-1,2,192,160,978,1176,T2
4056,May 4,2014,Saint Lucia,Saint Vincent and the Grenadines,0,0,Windward Islands Championship,in Dominica,2,-2,1104,1153,2,0,176,168,1102,1155,draw
4057,May 4,2014,Tajikistan,Afghanistan,1,0,Friendly,in Tajikistan,3,-3,1263,1052,0,0,143,184,1260,1055,T1
4058,May 4,2014,Tanzania,Malawi,0,0,Friendly,in Tanzania,-4,4,1355,1319,-1,0,124,128,1359,1315,draw
4059,May 10,2014,Monaco,Vatican,2,0,Friendly,in Italy,7,-7,909,686,0,0,200,217,902,693,T1
4060,May 11,2014,Botswana,Swaziland,1,4,Friendly,in Botswana,-30,30,1279,1133,-6,7,137,171,1309,1103,T2
4061,May 12,2014,Afghanistan,Kyrgyzstan,1,0,Friendly,in Kuwait,12,-12,1064,1120,1,-2,183,174,1052,1132,T1
4062,May 13,2014,Germany,Poland,0,0,Friendly,in Germany,-9,9,2081,1644,0,1,3,51,2090,1635,draw
4063,May 13,2014,Maldives,Laos,7,1,Friendly,in the Maldives,6,-6,1080,849,1,0,180,205,1074,855,T1
4064,May 14,2014,Kuwait,Afghanistan,3,2,Friendly,in Kuwait,1,-1,1551,1063,0,0,72,183,1550,1064,T1
4065,May 16,2014,Kuwait,Kyrgyzstan,2,2,Friendly,in Kuwait,-9,9,1542,1129,-1,1,73,173,1551,1120,draw
4066,May 17,2014,Malawi,Chad,2,0,African Nations Cup qualifier,in Malawi,15,-15,1334,1216,2,-5,126,153,1319,1231,T1
4067,May 17,2014,Mauritania,Equatorial Guinea,1,0,African Nations Cup qualifier,in Mauritania,19,-19,1235,1285,5,-4,148,135,1216,1304,T1
4068,May 17,2014,Namibia,Congo,1,0,African Nations Cup qualifier,in Namibia,20,-20,1311,1375,4,-6,130,117,1291,1395,T1
4069,May 17,2014,Netherlands,Ecuador,1,1,Friendly,in the Netherlands,-6,6,1982,1850,0,3,5,13,1988,1844,draw
4070,May 17,2014,São Tomé and Príncipe,Benin,0,2,African Nations Cup qualifier,in São Tomé and Príncipe,-15,15,1089,1403,-1,1,178,111,1104,1388,T2
4071,May 18,2014,Belarus,Iran,0,0,Friendly,in Austria,4,-4,1588,1716,1,0,61,34,1584,1720,draw
4072,May 18,2014,Burundi,Botswana,0,0,African Nations Cup qualifier,in Burundi,-8,8,1320,1287,-1,2,129,135,1328,1279,draw
4073,May 18,2014,Central African Republic,Guinea-Bissau,0,0,African Nations Cup qualifier,in Congo,-3,3,1267,1225,-1,0,141,151,1270,1222,draw
4074,May 18,2014,Kenya,Comoros,1,0,African Nations Cup qualifier,in Kenya,1,-1,1443,878,0,0,102,202,1442,879,T1
4075,May 18,2014,Liberia,Lesotho,1,0,African Nations Cup qualifier,in Liberia,10,-10,1324,1206,1,-2,128,155,1314,1216,T1
4076,May 18,2014,Libya,Rwanda,0,0,African Nations Cup qualifier,in Tunisia,-12,12,1542,1314,-1,2,72,130,1554,1302,draw
4077,May 18,2014,Madagascar,Uganda,2,1,African Nations Cup qualifier,in Madagascar,32,-32,1196,1474,6,-9,159,94,1164,1506,T1
4078,May 18,2014,Mozambique,South Sudan,5,0,African Nations Cup qualifier,in Mozambique,7,-7,1373,1050,2,0,117,184,1366,1057,T1
4079,May 18,2014,Swaziland,Sierra Leone,1,1,African Nations Cup qualifier,in Swaziland,7,-7,1140,1358,0,-3,171,123,1133,1365,draw
4080,May 18,2014,Tanzania,Zimbabwe,1,0,African Nations Cup qualifier,in Tanzania,16,-16,1371,1365,5,-5,119,120,1355,1381,T1
4081,May 19,2014,Maldives,Myanmar,2,3,Asian Cup qual &amp; Asian Challenge Cup,in the Maldives,-29,29,1051,1036,-3,1,183,185,1080,1007,T2
4082,May 19,2014,Palestine,Kyrgyzstan,1,0,Asian Cup qual &amp; Asian Challenge Cup,in the Maldives,12,-12,1291,1117,4,-1,134,174,1279,1129,T1
4083,May 20,2014,Afghanistan,Philippines,0,0,Asian Cup qual &amp; Asian Challenge Cup,in the Maldives,7,-7,1070,1187,1,-2,181,162,1063,1194,draw
4084,May 20,2014,French Guiana,Suriname,0,0,Friendly,in French Guiana,-3,3,1238,1232,0,0,146,149,1241,1229,draw
4085,May 20,2014,Turkmenistan,Laos,5,1,Asian Cup qual &amp; Asian Challenge Cup,in the Maldives,4,-4,1351,845,0,-1,125,206,1347,849,T1
4086,May 21,2014,Burkina Faso,Senegal,1,1,Friendly,in Burkina Faso,-2,2,1538,1570,0,1,74,66,1540,1568,draw
4087,May 21,2014,Finland,Czechia,2,2,Friendly,in Finland,-1,1,1685,1756,0,0,45,27,1686,1755,draw
4088,May 21,2014,Kosovo,Turkey,1,6,Friendly,in Kosovo,-8,8,1370,1732,-4,2,119,29,1378,1724,T2
4089,May 21,2014,Liechtenstein,Belarus,1,5,Friendly,in Liechtenstein,-5,5,1173,1593,-2,0,165,61,1178,1588,T2
4090,May 21,2014,Maldives,Kyrgyzstan,2,0,Asian Cup qual &amp; Asian Challenge Cup,in the Maldives,27,-27,1078,1090,3,-3,180,177,1051,1117,T1
4091,May 21,2014,Palestine,Myanmar,2,0,Asian Cup qual &amp; Asian Challenge Cup,in the Maldives,11,-11,1302,1025,1,0,133,185,1291,1036,T1
4092,May 22,2014,Afghanistan,Turkmenistan,3,1,Asian Cup qual &amp; Asian Challenge Cup,in the Maldives,50,-50,1120,1301,8,-8,174,133,1070,1351,T1
4093,May 22,2014,Hungary,Denmark,2,2,Friendly,in Hungary,-1,1,1668,1745,0,0,46,28,1669,1744,draw
4094,May 22,2014,Philippines,Laos,2,0,Asian Cup qual &amp; Asian Challenge Cup,in the Maldives,7,-7,1194,838,2,-1,160,207,1187,845,T1
4095,May 22,2014,Ukraine,Niger,2,1,Friendly,in Ukraine,0,0,1839,1291,0,0,17,135,1839,1291,T1
4096,May 23,2014,Bulgaria,Canada,1,1,Friendly,in Austria,-4,4,1644,1492,-1,0,50,89,1648,1488,draw
4097,May 23,2014,Kyrgyzstan,Myanmar,1,0,Asian Cup qual &amp; Asian Challenge Cup,in the Maldives,16,-16,1106,1009,1,-1,177,186,1090,1025,T1
4098,May 23,2014,Maldives,Palestine,0,0,Asian Cup qual &amp; Asian Challenge Cup,in the Maldives,7,-7,1085,1295,0,-2,181,134,1078,1302,draw
4099,May 23,2014,Morocco,Mozambique,4,0,Friendly,in Portugal,11,-11,1539,1362,3,-4,74,120,1528,1373,T1
4100,May 23,2014,Slovakia,Montenegro,2,0,Friendly,in Slovakia,10,-10,1637,1601,0,0,53,57,1627,1611,T1
4101,May 24,2014,Afghanistan,Laos,0,0,Asian Cup qual &amp; Asian Challenge Cup,in the Maldives,-13,13,1107,851,-2,2,176,205,1120,838,draw
4102,May 24,2014,Moldova,Saudi Arabia,4,0,Friendly,in Spain,24,-24,1461,1507,9,-6,95,83,1437,1531,T1
4103,May 24,2014,Philippines,Turkmenistan,2,0,Asian Cup qual &amp; Asian Challenge Cup,in the Maldives,39,-39,1233,1262,11,-11,149,143,1194,1301,T1
4104,May 25,2014,Guinea,Mali,2,1,Friendly,in France,11,-11,1543,1548,4,-1,72,70,1532,1559,T1
4105,May 25,2014,Ireland,Turkey,1,2,Friendly,in Ireland,-12,12,1689,1744,-5,0,44,29,1701,1732,T2
4106,May 25,2014,Senegal,Kosovo,3,1,Friendly,in Switzerland,7,-7,1577,1363,1,-1,65,119,1570,1370,T1
4107,May 26,2014,Australia,South Africa,1,1,Friendly,in Australia,-6,6,1716,1586,0,1,33,62,1722,1580,draw
4108,May 26,2014,Belgium,Luxembourg,5,1,Friendly,in Belgium,1,-1,1833,1212,0,0,18,155,1832,1213,T1
4109,May 26,2014,Cameroon,Macedonia,2,0,Friendly,in Austria,12,-12,1612,1508,1,-1,57,82,1600,1520,T1
4110,May 26,2014,Estonia,Gibraltar,1,1,Friendly,in Estonia,-9,9,1466,1134,-1,1,94,172,1475,1125,draw
4111,May 26,2014,Iran,Montenegro,0,0,Friendly,in Austria,-3,3,1713,1604,-1,-1,35,58,1716,1601,draw
4112,May 26,2014,Russia,Slovakia,1,0,Friendly,in Russia,3,-3,1851,1634,1,0,13,53,1848,1637,T1
4113,May 26,2014,Serbia,Jamaica,2,1,Friendly,in the United States,4,-4,1770,1524,1,-1,24,78,1766,1528,T1
4114,May 27,2014,Armenia,United Arab Emirates,4,3,Friendly,in Switzerland,12,-12,1590,1643,2,-3,62,51,1578,1655,T1
4115,May 27,2014,Canada,Moldova,1,1,Friendly,in Austria,-1,1,1491,1462,0,0,89,95,1492,1461,draw
4116,May 27,2014,France,Norway,4,0,Friendly,in France,4,-4,1901,1616,0,-1,12,56,1897,1620,T1
4117,May 27,2014,Japan,Cyprus,1,0,Friendly,in Japan,1,-1,1770,1386,1,0,24,112,1769,1387,T1
4118,May 27,2014,Maldives,Philippines,2,3,Asian Cup qual &amp; Asian Challenge Cup,in the Maldives,-17,17,1068,1250,-1,5,182,144,1085,1233,T2
4119,May 27,2014,Palestine,Afghanistan,2,0,Asian Cup qual &amp; Asian Challenge Cup,in the Maldives,15,-15,1310,1092,1,-2,132,178,1295,1107,T1
4120,May 27,2014,Suriname,French Guiana,1,0,Friendly,in Suriname,7,-7,1239,1231,3,-4,147,150,1232,1238,T1
4121,May 27,2014,Tanzania,Malawi,1,0,Friendly,in Tanzania,6,-6,1377,1328,2,-1,115,126,1371,1334,T1
4122,May 27,2014,United States,Azerbaijan,2,0,Friendly,in the United States,2,-2,1849,1443,1,0,15,102,1847,1445,T1
4123,May 27,2014,Uzbekistan,Oman,0,1,Friendly,in Uzbekistan,-14,14,1629,1589,-1,3,53,63,1643,1575,T2
4124,May 28,2014,Angola,Morocco,2,0,Friendly,in Portugal,19,-19,1459,1520,8,-6,96,81,1440,1539,T1
4125,May 28,2014,Denmark,Sweden,1,0,Friendly,in Denmark,9,-9,1754,1813,0,-2,28,21,1745,1822,T1
4126,May 28,2014,Mexico,Israel,3,0,Friendly,in Mexico,5,-5,1817,1615,2,-1,19,56,1812,1620,T1
4127,May 28,2014,Nigeria,Scotland,2,2,Friendly,in England,0,0,1725,1710,0,0,30,37,1725,1710,draw
4128,May 28,2014,South Korea,Tunisia,0,1,Friendly,in South Korea,-17,17,1687,1533,-6,5,44,76,1704,1516,T2
4129,May 29,2014,Georgia,Saudi Arabia,2,0,Friendly,in Spain,15,-15,1515,1492,5,-5,82,88,1500,1507,T1
4130,May 29,2014,Latvia,Estonia,0,0,Baltic Cup,in Latvia,-4,4,1445,1470,0,-1,102,95,1449,1466,draw
4131,May 29,2014,Lithuania,Finland,1,0,Baltic Cup,in Latvia,24,-24,1482,1661,6,-2,91,47,1458,1685,T1
4132,May 29,2014,Maldives,Afghanistan,1,1,Asian Cup qual &amp; Asian Challenge Cup,in the Maldives,-4,4,1064,1096,-1,0,183,178,1068,1092,draw
4133,May 29,2014,Paraguay,Cameroon,2,1,Friendly,in Austria,8,-8,1703,1604,2,0,38,57,1695,1612,T1
4134,May 29,2014,Turkey,Honduras,2,0,Friendly,in the United States,13,-13,1757,1681,2,-3,27,44,1744,1694,T1
4135,May 29,2014,Uzbekistan,Oman,0,1,Friendly,in Uzbekistan,-14,14,1615,1603,-2,4,55,59,1629,1589,T2
4136,May 30,2014,Angola,Iran,1,1,Friendly,in Austria,6,-6,1465,1707,1,-1,96,36,1459,1713,draw
4137,May 30,2014,Aruba,Turks and Caicos,1,0,CONCACAF Champ &amp; Carib Champ qual,in Aruba,7,-7,954,759,1,0,193,211,947,766,T1
4138,May 30,2014,Austria,Iceland,1,1,Friendly,in Austria,-6,6,1661,1534,0,1,46,76,1667,1528,draw
4139,May 30,2014,Bosnia and Herzegovina,Ivory Coast,2,1,Friendly,in the United States,10,-10,1775,1772,3,-1,23,24,1765,1782,T1
4140,May 30,2014,Chile,Egypt,3,2,Friendly,in Chile,3,-3,1919,1711,0,0,9,34,1916,1714,T1
4141,May 30,2014,Comoros,Kenya,1,1,African Nations Cup qualifier,in the Comoros,17,-17,895,1426,1,-3,201,106,878,1443,draw
4142,May 30,2014,England,Peru,3,0,Friendly,in England,5,-5,1942,1706,0,-1,6,37,1937,1711,T1
4143,May 30,2014,French Guiana,British Virgin Islands,6,0,CONCACAF Champ &amp; Carib Champ qual,in Aruba,4,-4,1235,681,2,-2,148,220,1231,685,T1
4144,May 30,2014,Macedonia,Qatar,0,0,Friendly,in Italy,0,0,1508,1494,0,0,83,87,1508,1494,draw
4145,May 30,2014,Montserrat,US Virgin Islands,1,0,CONCACAF Champ &amp; Carib Champ qual,in Montserrat,21,-21,605,686,1,-2,228,216,584,707,T1
4146,May 30,2014,Mozambique,South Sudan,0,0,African Nations Cup qualifier,in Sudan,-14,14,1348,1064,-4,1,124,183,1362,1050,draw
4147,May 30,2014,New Zealand,South Africa,0,0,Friendly,in New Zealand,-2,2,1544,1588,0,0,71,64,1546,1586,draw
4148,May 30,2014,Palestine,Philippines,1,0,Asian Cup qual &amp; Asian Challenge Cup,in the Maldives,17,-17,1327,1233,5,-6,127,150,1310,1250,T1
4149,May 30,2014,Spain,Bolivia,2,0,Friendly,in Spain,1,-1,2108,1626,0,0,2,53,2107,1627,T1
4150,May 30,2014,Switzerland,Jamaica,1,0,Friendly,in Switzerland,2,-2,1850,1522,2,-1,14,79,1848,1524,T1
4151,May 30,2014,Uruguay,Northern Ireland,1,0,Friendly,in Uruguay,1,-1,1916,1412,0,0,10,110,1915,1413,T1
4152,May 31,2014,Algeria,Armenia,3,1,Friendly,in Switzerland,15,-15,1615,1575,5,-3,55,66,1600,1590,T1
4153,May 31,2014,Chad,Malawi,3,1,African Nations Cup qualifier,in Chad,31,-31,1247,1297,9,-7,145,133,1216,1328,T1
4154,May 31,2014,Colombia,Senegal,2,2,Friendly,in Argentina,-8,8,1918,1585,-1,2,9,64,1926,1577,draw
4155,May 31,2014,Croatia,Mali,2,1,Friendly,in Croatia,2,-2,1812,1546,0,0,22,70,1810,1548,T1
4156,May 31,2014,Finland,Estonia,2,0,Baltic Cup,in Latvia,11,-11,1672,1459,1,-2,45,97,1661,1470,T1
4157,May 31,2014,Guinea-Bissau,Central African Republic,3,1,African Nations Cup qualifier,in Guinea-Bissau,25,-25,1250,1242,9,-7,143,147,1225,1267,T1
4158,May 31,2014,Ireland,Italy,0,0,Friendly,in England,6,-6,1695,1898,1,-1,41,12,1689,1904,draw
4159,May 31,2014,Latvia,Lithuania,1,0,Baltic Cup,in Latvia,12,-12,1457,1470,3,-3,99,94,1445,1482,T1
4160,May 31,2014,Mexico,Ecuador,3,1,Friendly,in the United States,16,-16,1833,1834,1,-3,18,17,1817,1850,T1
4161,May 31,2014,Netherlands,Ghana,1,0,Friendly,in the Netherlands,2,-2,1984,1691,0,-1,5,42,1982,1693,T1
4162,May 31,2014,Norway,Russia,1,1,Friendly,in Norway,4,-4,1620,1847,0,-2,54,15,1616,1851,draw
4163,May 31,2014,Panama,Serbia,1,1,Friendly,in the United States,2,-2,1703,1768,1,-1,38,26,1701,1770,draw
4164,May 31,2014,Portugal,Greece,0,0,Friendly,in Portugal,-6,6,1928,1822,0,0,7,20,1934,1816,draw
4165,May 31,2014,Romania,Albania,1,0,Friendly,in Switzerland,5,-5,1729,1516,2,0,30,80,1724,1521,T1
4166,May 31,2014,Rwanda,Libya,3,0,African Nations Cup qualifier,in Rwanda,47,-47,1361,1495,8,-13,122,86,1314,1542,T1
4167,May 31,2014,Sierra Leone,Swaziland,1,0,African Nations Cup qualifier,in Sierra Leone,6,-6,1364,1134,3,0,119,171,1358,1140,T1
4168,May 31,2014,Uganda,Madagascar,1,0,African Nations Cup qualifier,in Uganda,4,-4,1478,1192,1,0,93,160,1474,1196,T1
4169,June 1,2014,Aruba,British Virgin Islands,7,0,CONCACAF Champ &amp; Carib Champ qual,in Aruba,9,-9,963,672,1,-3,192,223,954,681,T1
4170,June 1,2014,Benin,São Tomé and Príncipe,2,0,African Nations Cup qualifier,in Benin,5,-5,1408,1084,0,-1,111,180,1403,1089,T1
4171,June 1,2014,Bonaire,US Virgin Islands,2,1,CONCACAF Champ &amp; Carib Champ qual,in Montserrat,7,-7,976,679,0,-3,191,219,969,686,T1
4172,June 1,2014,Botswana,Burundi,1,0,African Nations Cup qualifier,in Botswana,16,-16,1303,1304,4,-1,131,130,1287,1320,T1
4173,June 1,2014,Congo,Namibia,3,0,African Nations Cup qualifier,in Congo,20,-20,1395,1291,4,-5,112,135,1375,1311,T1
4174,June 1,2014,Equatorial Guinea,Mauritania,3,0,African Nations Cup qualifier,in Equatorial Guinea,21,-21,1306,1214,7,-5,129,155,1285,1235,T1
4175,June 1,2014,France,Paraguay,1,1,Friendly,in France,-7,7,1894,1710,-1,3,12,35,1901,1703,draw
4176,June 1,2014,French Guiana,Turks and Caicos,6,0,CONCACAF Champ &amp; Carib Champ qual,in Aruba,5,-5,1240,754,2,0,148,211,1235,759,T1
4177,June 1,2014,Germany,Cameroon,2,2,Friendly,in Germany,-9,9,2072,1613,0,0,3,58,2081,1604,draw
4178,June 1,2014,Israel,Honduras,4,2,Friendly,in the United States,18,-18,1633,1663,2,-2,53,46,1615,1681,T1
4179,June 1,2014,Lesotho,Liberia,2,0,African Nations Cup qualifier,in Lesotho,32,-32,1238,1292,6,-6,150,134,1206,1324,T1
4180,June 1,2014,Sweden,Belgium,0,2,Friendly,in Sweden,-18,18,1795,1851,-1,4,22,14,1813,1833,T2
4181,June 1,2014,United States,Turkey,2,1,Friendly,in the United States,5,-5,1854,1752,1,-2,13,29,1849,1757,T1
4182,June 1,2014,Zimbabwe,Tanzania,2,2,African Nations Cup qualifier,in Zimbabwe,-5,5,1360,1382,-5,-1,123,116,1365,1377,draw
4183,June 2,2014,Japan,Costa Rica,3,1,Friendly,in the United States,13,-13,1783,1712,2,-2,23,33,1770,1725,T1
4184,June 3,2014,Aruba,French Guiana,0,2,CONCACAF Champ &amp; Carib Champ qual,in Aruba,-16,16,947,1256,-2,5,194,143,963,1240,T2
4185,June 3,2014,Bosnia and Herzegovina,Mexico,1,0,Friendly,in the United States,12,-12,1787,1821,1,0,23,19,1775,1833,T1
4186,June 3,2014,Brazil,Panama,4,0,Friendly,in Brazil,2,-2,2137,1701,0,1,1,38,2135,1703,T1
4187,June 3,2014,Czechia,Austria,1,2,Friendly,in Czechia,-15,15,1741,1676,-2,3,29,44,1756,1661,T2
4188,June 3,2014,Greece,Nigeria,0,0,Friendly,in the United States,-3,3,1819,1728,0,0,20,31,1822,1725,draw
4189,June 3,2014,Montserrat,Bonaire,0,0,CONCACAF Champ &amp; Carib Champ qual,in Montserrat,13,-13,618,963,2,0,226,191,605,976,draw
4190,June 3,2014,Switzerland,Peru,2,0,Friendly,in Switzerland,6,-6,1856,1700,2,-1,13,39,1850,1706,T1
4191,June 3,2014,Turks and Caicos,British Virgin Islands,2,0,CONCACAF Champ &amp; Carib Champ qual,in Aruba,23,-23,777,649,0,-1,211,224,754,672,T1
4192,June 3,2014,United Arab Emirates,Georgia,1,0,Friendly,in Switzerland,6,-6,1649,1509,3,0,48,81,1643,1515,T1
4193,June 4,2014,Algeria,Romania,2,1,Friendly,in Switzerland,13,-13,1628,1716,2,-1,54,31,1615,1729,T1
4194,June 4,2014,Argentina,Trinidad and Tobago,3,0,Friendly,in Argentina,1,-1,2017,1506,0,0,4,83,2016,1507,T1
4195,June 4,2014,Chile,Northern Ireland,2,0,Friendly,in Chile,1,-1,1920,1411,0,0,8,110,1919,1412,T1
4196,June 4,2014,Ecuador,England,2,2,Friendly,in the United States,3,-3,1837,1939,0,0,18,6,1834,1942,draw
4197,June 4,2014,Egypt,Jamaica,2,2,Friendly,in England,-5,5,1706,1527,-3,1,37,77,1711,1522,draw
4198,June 4,2014,Equatorial Guinea,São Tomé and Príncipe,3,2,Friendly,in Equatorial Guinea,3,-3,1309,1081,0,0,129,180,1306,1084,T1
4199,June 4,2014,Gibraltar,Malta,1,0,Friendly,in Portugal,13,-13,1147,1237,0,-6,171,150,1134,1250,T1
4200,June 4,2014,Hungary,Albania,1,0,Friendly,in Hungary,4,-4,1672,1512,1,0,45,80,1668,1516,T1
4201,June 4,2014,Iceland,Estonia,1,0,Friendly,in Iceland,5,-5,1539,1454,1,-3,74,100,1534,1459,T1
4202,June 4,2014,Italy,Luxembourg,1,1,Friendly,in Italy,-10,10,1888,1222,-1,2,12,154,1898,1212,draw
4203,June 4,2014,Ivory Coast,El Salvador,2,1,Friendly,in the United States,4,-4,1776,1520,0,-1,25,78,1772,1524,T1
4204,June 4,2014,Netherlands,Wales,2,0,Friendly,in the Netherlands,2,-2,1986,1593,0,0,5,61,1984,1595,T1
4205,June 4,2014,Uruguay,Slovenia,2,0,Friendly,in Uruguay,3,-3,1919,1644,1,0,9,49,1916,1647,T1
4206,June 6,2014,Brazil,Serbia,1,0,Friendly,in Brazil,1,-1,2138,1767,0,0,1,26,2137,1768,T1
4207,June 6,2014,Colombia,Jordan,3,0,Friendly,in Argentina,4,-4,1922,1581,2,-1,8,65,1918,1585,T1
4208,June 6,2014,Costa Rica,Ireland,1,1,Friendly,in the United States,0,0,1712,1695,1,0,32,41,1712,1695,draw
4209,June 6,2014,Croatia,Australia,1,0,Friendly,in Brazil,7,-7,1819,1709,1,-4,20,35,1812,1716,T1
4210,June 6,2014,Germany,Armenia,6,1,Friendly,in Germany,1,-1,2073,1574,0,0,3,66,2072,1575,T1
4211,June 6,2014,Greece,Bolivia,2,1,Friendly,in the United States,5,-5,1824,1621,1,0,19,55,1819,1626,T1
4212,June 6,2014,Japan,Zambia,4,3,Friendly,in the United States,3,-3,1786,1484,0,0,24,90,1783,1487,T1
4213,June 6,2014,Poland,Lithuania,2,1,Friendly,in Poland,3,-3,1647,1467,0,0,49,94,1644,1470,T1
4214,June 6,2014,Portugal,Mexico,1,0,Friendly,in the United States,7,-7,1935,1814,0,-2,7,21,1928,1821,T1
4215,June 6,2014,Russia,Morocco,2,0,Friendly,in Russia,2,-2,1849,1518,0,-1,16,79,1847,1520,T1
4216,June 7,2014,Argentina,Slovenia,2,0,Friendly,in Argentina,2,-2,2019,1642,0,-1,4,51,2017,1644,T1
4217,June 7,2014,Belgium,Tunisia,1,0,Friendly,in Belgium,2,-2,1853,1531,0,0,15,76,1851,1533,T1
4218,June 7,2014,Cameroon,Moldova,1,0,Friendly,in Cameroon,4,-4,1617,1458,1,0,57,96,1613,1462,T1
4219,June 7,2014,England,Honduras,0,0,Friendly,in the United States,-7,7,1932,1670,-1,0,7,47,1939,1663,draw
4220,June 7,2014,Estonia,Tajikistan,2,1,Friendly,in Estonia,3,-3,1457,1260,2,-1,98,142,1454,1263,T1
4221,June 7,2014,Hungary,Kazakhstan,3,0,Friendly,in Hungary,3,-3,1675,1358,0,-2,45,123,1672,1361,T1
4222,June 7,2014,Spain,El Salvador,2,0,Friendly,in the United States,1,-1,2109,1519,0,0,2,78,2108,1520,T1
4223,June 7,2014,United States,Nigeria,2,1,Friendly,in the United States,4,-4,1858,1724,1,0,13,30,1854,1728,T1
4224,June 8,2014,France,Jamaica,8,0,Friendly,in France,3,-3,1897,1524,0,0,11,77,1894,1527,T1
4225,June 8,2014,Iran,Trinidad and Tobago,2,0,Friendly,in Brazil,7,-7,1714,1499,4,-2,32,85,1707,1506,T1
4226,June 8,2014,San Marino,Albania,0,3,Friendly,in San Marino,-2,2,876,1514,0,0,203,80,878,1512,T2
4227,June 9,2014,Ghana,South Korea,4,0,Friendly,in the United States,19,-19,1710,1668,8,-4,34,47,1691,1687,T1
4228,June 10,2014,Portugal,Ireland,5,1,Friendly,in the United States,8,-8,1943,1687,0,0,6,42,1935,1695,T1
4229,June 12,2014,Brazil,Croatia,3,1,World Cup,in Brazil,7,-7,2145,1812,0,-1,1,21,2138,1819,T1
4230,June 13,2014,Chile,Australia,3,1,World Cup,in Brazil,21,-21,1941,1688,2,-4,7,41,1920,1709,T1
4231,June 13,2014,Mexico,Cameroon,1,0,World Cup,in Brazil,15,-15,1829,1602,1,-3,19,60,1814,1617,T1
4232,June 13,2014,Netherlands,Spain,5,1,World Cup,in Brazil,75,-75,2061,2034,2,-2,3,4,1986,2109,T1
4233,June 14,2014,Colombia,Greece,3,0,World Cup,in Brazil,38,-38,1960,1786,3,-4,6,24,1922,1824,T1
4234,June 14,2014,Costa Rica,Uruguay,3,1,World Cup,in Brazil,69,-69,1781,1850,8,-5,25,15,1712,1919,T1
4235,June 14,2014,Italy,England,2,1,World Cup,in Brazil,34,-34,1922,1898,3,-2,9,10,1888,1932,T1
4236,June 14,2014,Ivory Coast,Japan,2,1,World Cup,in Brazil,31,-31,1807,1755,4,-3,21,27,1776,1786,T1
4237,June 15,2014,Argentina,Bosnia and Herzegovina,2,1,World Cup,in Brazil,12,-12,2031,1775,0,-2,5,25,2019,1787,T1
4238,June 15,2014,France,Honduras,3,0,World Cup,in Brazil,22,-22,1919,1648,1,-2,10,48,1897,1670,T1
4239,June 15,2014,Switzerland,Ecuador,2,1,World Cup,in Brazil,28,-28,1884,1809,1,-2,12,20,1856,1837,T1
4240,June 16,2014,Germany,Portugal,4,0,World Cup,in Brazil,36,-36,2109,1907,0,-3,2,10,2073,1943,T1
4241,June 16,2014,Iran,Nigeria,0,0,World Cup,in Brazil,1,-1,1715,1723,0,0,33,31,1714,1724,draw
4242,June 16,2014,United States,Ghana,2,1,World Cup,in Brazil,18,-18,1876,1692,0,-6,13,40,1858,1710,T1
4243,June 17,2014,Belgium,Algeria,2,1,World Cup,in Brazil,13,-13,1866,1615,0,-2,14,56,1853,1628,T1
4244,June 17,2014,Brazil,Mexico,0,0,World Cup,in Brazil,-25,25,2120,1854,0,3,1,15,2145,1829,draw
4245,June 17,2014,Russia,South Korea,1,1,World Cup,in Brazil,-14,14,1835,1682,-2,3,18,43,1849,1668,draw
4246,June 18,2014,Chile,Spain,2,0,World Cup,in Brazil,57,-57,1998,1977,2,-2,5,6,1941,2034,T1
4247,June 18,2014,China,Macedonia,2,0,Friendly,in China,9,-9,1565,1499,0,-2,69,84,1556,1508,T1
4248,June 18,2014,Croatia,Cameroon,4,0,World Cup,in Brazil,26,-26,1838,1576,1,-5,18,65,1812,1602,T1
4249,June 18,2014,Netherlands,Australia,3,2,World Cup,in Brazil,6,-6,2067,1682,0,-1,3,42,2061,1688,T1
4250,June 19,2014,Colombia,Ivory Coast,2,1,World Cup,in Brazil,18,-18,1978,1789,1,-1,6,22,1960,1807,T1
4251,June 19,2014,Greece,Japan,0,0,World Cup,in Brazil,-3,3,1783,1758,0,0,23,27,1786,1755,draw
4252,June 19,2014,Uruguay,England,2,1,World Cup,in Brazil,34,-34,1884,1864,5,-4,11,15,1850,1898,T1
4253,June 20,2014,Costa Rica,Italy,1,0,World Cup,in Brazil,42,-42,1823,1880,3,-3,21,11,1781,1922,T1
4254,June 20,2014,Ecuador,Honduras,2,1,World Cup,in Brazil,17,-17,1826,1631,0,-5,20,53,1809,1648,T1
4255,June 20,2014,France,Switzerland,5,2,World Cup,in Brazil,47,-47,1966,1837,1,-7,8,18,1919,1884,T1
4256,June 21,2014,Argentina,Iran,1,0,World Cup,in Brazil,8,-8,2039,1707,0,-3,4,36,2031,1715,T1
4257,June 21,2014,Germany,Ghana,2,2,World Cup,in Brazil,-25,25,2084,1717,0,8,2,32,2109,1692,draw
4258,June 21,2014,Indonesia,Pakistan,4,0,Friendly,in Indonesia,4,-4,1226,938,1,0,153,196,1222,942,T1
4259,June 21,2014,Nigeria,Bosnia and Herzegovina,1,0,World Cup,in Brazil,34,-34,1757,1741,4,-5,27,30,1723,1775,T1
4260,June 22,2014,Algeria,South Korea,4,2,World Cup,in Brazil,54,-54,1669,1628,10,-12,46,54,1615,1682,T1
4261,June 22,2014,Belgium,Russia,1,0,World Cup,in Brazil,27,-27,1893,1808,3,-2,10,21,1866,1835,T1
4262,June 22,2014,China,Macedonia,0,0,Friendly,in China,-4,4,1561,1503,0,0,69,84,1565,1499,draw
4263,June 22,2014,Portugal,United States,2,2,World Cup,in Brazil,-3,3,1904,1879,0,-1,9,13,1907,1876,draw
4264,June 23,2014,Brazil,Cameroon,4,1,World Cup,in Brazil,3,-3,2123,1573,0,-1,1,66,2120,1576,T1
4265,June 23,2014,Mexico,Croatia,3,1,World Cup,in Brazil,43,-43,1897,1795,5,-4,10,21,1854,1838,T1
4266,June 23,2014,Netherlands,Chile,2,0,World Cup,in Brazil,36,-36,2103,1962,1,-3,2,8,2067,1998,T1
4267,June 23,2014,Spain,Australia,3,0,World Cup,in Brazil,16,-16,1993,1666,2,-4,5,46,1977,1682,T1
4268,June 24,2014,Colombia,Japan,4,1,World Cup,in Brazil,23,-23,2001,1735,1,-5,5,31,1978,1758,T1
4269,June 24,2014,Costa Rica,England,0,0,World Cup,in Brazil,4,-4,1827,1860,1,1,18,14,1823,1864,draw
4270,June 24,2014,Greece,Ivory Coast,2,1,World Cup,in Brazil,31,-31,1814,1758,4,-2,20,25,1783,1789,T1
4271,June 24,2014,Uruguay,Italy,1,0,World Cup,in Brazil,30,-30,1914,1850,3,-2,9,15,1884,1880,T1
4272,June 25,2014,Argentina,Nigeria,3,2,World Cup,in Brazil,10,-10,2049,1747,0,-3,4,29,2039,1757,T1
4273,June 25,2014,Bosnia and Herzegovina,Iran,3,1,World Cup,in Brazil,41,-41,1782,1666,5,-9,24,45,1741,1707,T1
4274,June 25,2014,Ecuador,France,0,0,World Cup,in Brazil,11,-11,1837,1955,1,-1,18,8,1826,1966,draw
4275,June 25,2014,Indonesia,Nepal,2,0,Friendly,in Indonesia,2,-2,1228,890,0,0,153,202,1226,892,T1
4276,June 25,2014,Switzerland,Honduras,3,0,World Cup,in Brazil,25,-25,1862,1606,3,-4,14,57,1837,1631,T1
4277,June 26,2014,Algeria,Russia,1,1,World Cup,in Brazil,11,-11,1680,1797,3,0,41,21,1669,1808,draw
4278,June 26,2014,Belgium,South Korea,1,0,World Cup,in Brazil,11,-11,1904,1617,1,-2,11,55,1893,1628,T1
4279,June 26,2014,Germany,United States,1,0,World Cup,in Brazil,14,-14,2098,1865,0,0,3,13,2084,1879,T1
4280,June 26,2014,Portugal,Ghana,2,1,World Cup,in Brazil,15,-15,1919,1702,1,-4,9,36,1904,1717,T1
4281,June 28,2014,Brazil,Chile,1,1,World Cup,in Brazil,-19,19,2104,1981,0,0,1,7,2123,1962,draw
4282,June 28,2014,Colombia,Uruguay,2,0,World Cup,in Brazil,34,-34,2035,1880,0,-2,5,12,2001,1914,T1
4283,June 29,2014,China,Mali,1,3,Friendly,in China,-20,20,1541,1566,-4,2,73,68,1561,1546,T2
4284,June 29,2014,Costa Rica,Greece,1,1,World Cup,in Brazil,-1,1,1826,1815,0,0,19,20,1827,1814,draw
4285,June 29,2014,Netherlands,Mexico,2,1,World Cup,in Brazil,14,-14,2117,1883,1,0,1,11,2103,1897,T1
4286,June 30,2014,France,Nigeria,2,0,World Cup,in Brazil,21,-21,1976,1726,0,-2,8,31,1955,1747,T1
4287,June 30,2014,Germany,Algeria,2,1,World Cup,in Brazil,5,-5,2103,1675,0,-1,3,42,2098,1680,T1
4288,July 1,2014,Argentina,Switzerland,1,0,World Cup,in Brazil,15,-15,2064,1847,0,-1,4,15,2049,1862,T1
4289,July 1,2014,Belgium,United States,2,1,World Cup,in Brazil,27,-27,1931,1838,1,-4,9,17,1904,1865,T1
4290,July 1,2014,Botswana,Tanzania,4,2,Friendly,in Botswana,14,-14,1317,1368,3,-1,128,117,1303,1382,T1
4291,July 2,2014,Vietnam,Myanmar,6,0,Friendly,in Vietnam,6,-6,1242,1003,4,-1,147,187,1236,1009,T1
4292,July 4,2014,Brazil,Colombia,2,1,World Cup,in Brazil,16,-16,2120,2019,0,0,2,5,2104,2035,T1
4293,July 4,2014,Germany,France,1,0,World Cup,in Brazil,19,-19,2122,1957,2,0,1,8,2103,1976,T1
4294,July 5,2014,Argentina,Belgium,1,0,World Cup,in Brazil,19,-19,2083,1912,0,-1,4,10,2064,1931,T1
4295,July 5,2014,Costa Rica,Netherlands,0,0,World Cup,in Brazil,21,-21,1847,2096,4,0,15,3,1826,2117,draw
4296,July 6,2014,Malawi,Mozambique,1,1,Friendly,in Malawi,-1,1,1296,1349,0,0,133,125,1297,1348,draw
4297,July 8,2014,Brazil,Germany,1,7,World Cup,in Brazil,-81,81,2039,2203,-2,0,4,1,2120,2122,T2
4298,July 9,2014,Argentina,Netherlands,0,0,World Cup,in Brazil,1,-1,2084,2095,0,0,3,2,2083,2096,draw
4299,July 11,2014,Uganda,Seychelles,1,0,Friendly,in Uganda,1,-1,1479,992,1,0,92,189,1478,993,T1
4300,July 12,2014,Brazil,Netherlands,0,3,World Cup,in Brazil,-59,59,1980,2154,-3,0,7,2,2039,2095,T2
4301,July 12,2014,Rwanda,Gabon,1,0,Friendly,in Rwanda,11,-11,1372,1495,4,-3,117,85,1361,1506,T1
4302,July 13,2014,Germany,Argentina,1,0,World Cup,in Brazil,20,-20,2223,2064,0,0,1,3,2203,2084,T1
4303,July 14,2014,Botswana,Lesotho,2,0,Friendly,in Botswana,8,-8,1325,1230,0,-3,128,153,1317,1238,T1
4304,July 14,2014,Qatar,Indonesia,2,2,Friendly,in Qatar,-8,8,1486,1236,-2,2,89,151,1494,1228,draw
4305,July 15,2014,Kenya,Burundi,0,0,Friendly,in Kenya,-6,6,1420,1310,-3,1,109,130,1426,1304,draw
4306,July 15,2014,Uganda,Malawi,0,0,Friendly,in Uganda,-7,7,1472,1303,-1,1,93,132,1479,1296,draw
4307,July 19,2014,Botswana,Guinea-Bissau,2,0,African Nations Cup qualifier,in Botswana,16,-16,1341,1234,2,-7,126,151,1325,1250,T1
4308,July 19,2014,Sierra Leone,Seychelles,2,0,African Nations Cup qualifier,in Sierra Leone,4,-4,1368,988,1,0,118,189,1364,992,T1
4309,July 19,2014,Uganda,Mauritania,2,0,African Nations Cup qualifier,in Uganda,7,-7,1479,1207,1,0,92,156,1472,1214,T1
4310,July 20,2014,Benin,Malawi,1,0,African Nations Cup qualifier,in Benin,9,-9,1417,1294,2,-1,109,133,1408,1303,T1
4311,July 20,2014,Congo,Rwanda,2,0,African Nations Cup qualifier,in Congo,20,-20,1415,1352,2,-8,110,125,1395,1372,T1
4312,July 20,2014,Lesotho,Kenya,1,0,African Nations Cup qualifier,in Lesotho,25,-25,1255,1395,9,-3,144,112,1230,1420,T1
4313,July 20,2014,Tanzania,Mozambique,2,2,African Nations Cup qualifier,in Tanzania,-7,7,1361,1356,-2,1,120,124,1368,1349,draw
4314,July 21,2014,Guam,Macao,0,0,East Asian Cup qualifier,in Guam,-11,11,728,629,0,0,212,226,739,618,draw
4315,July 21,2014,Mongolia,Northern Mariana Islands,4,0,East Asian Cup qualifier,in Guam,10,-10,790,440,1,0,209,234,780,450,T1
4316,July 23,2014,Guam,Mongolia,2,0,East Asian Cup qualifier,in Guam,27,-27,755,763,0,-2,212,211,728,790,T1
4317,July 23,2014,Northern Mariana Islands,Macao,2,1,East Asian Cup qualifier,in Guam,30,-30,470,599,0,-2,234,228,440,629,T1
4318,July 25,2014,Guam,Northern Mariana Islands,5,0,East Asian Cup qualifier,in Guam,8,-8,763,462,1,0,211,234,755,470,T1
4319,July 25,2014,Macao,Mongolia,3,2,East Asian Cup qualifier,in Guam,29,-29,628,734,2,-1,226,212,599,763,T1
4320,July 27,2014,Gabon,Rwanda,0,1,Friendly,in Gabon,-16,16,1479,1368,-6,8,91,117,1495,1352,T2
4321,August 2,2014,Guinea-Bissau,Botswana,1,1,African Nations Cup qualifier,in Guinea-Bissau,0,0,1234,1341,0,0,152,126,1234,1341,draw
4322,August 2,2014,Malawi,Benin,1,0,African Nations Cup qualifier,in Malawi,21,-21,1315,1396,4,-1,129,110,1294,1417,T1
4323,August 2,2014,Rwanda,Congo,2,0,African Nations Cup qualifier,in Rwanda,25,-25,1393,1390,5,-3,112,113,1368,1415,T1
4324,August 3,2014,Angola,Ethiopia,1,0,Friendly,in Angola,5,-5,1470,1379,1,-1,94,116,1465,1384,T1
4325,August 3,2014,Kenya,Lesotho,0,0,African Nations Cup qualifier,in Kenya,-12,12,1383,1267,-4,4,115,140,1395,1255,draw
4326,August 3,2014,Mauritania,Uganda,0,1,African Nations Cup qualifier,in Mauritania,-11,11,1196,1490,-3,3,159,88,1207,1479,T2
4327,August 3,2014,Mozambique,Tanzania,2,1,African Nations Cup qualifier,in Mozambique,15,-15,1371,1346,7,-4,118,125,1356,1361,T1
4328,August 6,2014,Peru,Panama,3,0,Friendly,in Peru,13,-13,1713,1688,5,-2,33,39,1700,1701,T1
4329,August 8,2014,Tajikistan,Malaysia,4,1,Friendly,in Tajikistan,10,-10,1270,1180,4,0,139,162,1260,1190,T1
4330,August 12,2014,Kazakhstan,Tajikistan,2,1,Friendly,in Kazakhstan,5,-5,1363,1265,3,-2,120,141,1358,1270,T1
4331,August 13,2014,Angola,Botswana,0,0,Friendly,in Angola,-6,6,1464,1347,-1,1,95,125,1470,1341,draw
4332,August 14,2014,Guatemala,Nicaragua,3,0,Friendly,in Guatemala,2,-2,1481,1115,1,0,91,174,1479,1117,T1
4333,August 16,2014,British Virgin Islands,Saint Martin,2,4,Friendly,in the British Virgin Islands,-11,11,638,860,0,1,224,205,649,849,T2
4334,August 20,2014,Azerbaijan,Uzbekistan,0,0,Friendly,in Azerbaijan,2,-2,1445,1613,0,0,103,56,1443,1615,draw
4335,August 20,2014,Panama,Cuba,4,0,Friendly,in Panama,4,-4,1692,1418,0,0,39,108,1688,1422,T1
4336,August 23,2014,Guatemala,Cuba,1,0,Friendly,in Guatemala,6,-6,1487,1412,2,0,89,108,1481,1418,T1
4337,August 24,2014,French Guiana,Suriname,0,1,Friendly,in French Guiana,-13,13,1243,1252,-3,5,147,144,1256,1239,T2
4338,August 26,2014,Seychelles,Sri Lanka,1,2,Friendly,in the Seychelles,-16,16,972,843,-1,1,190,207,988,827,T2
4339,August 27,2014,Norway,United Arab Emirates,0,0,Friendly,in Norway,-2,2,1618,1651,0,0,54,47,1620,1649,draw
4340,August 28,2014,Seychelles,Sri Lanka,3,0,Friendly,in the Seychelles,7,-7,979,836,0,-1,190,208,972,843,T1
4341,August 30,2014,Egypt,Kenya,1,0,Friendly,in Egypt,2,-2,1708,1381,0,0,36,115,1706,1383,T1
4342,August 30,2014,El Salvador,Dominican Republic,2,0,Friendly,in El Salvador,3,-3,1522,1262,0,-1,78,142,1519,1265,T1
4343,August 31,2014,Zambia,Sudan,3,1,Friendly,in Zambia,7,-7,1491,1377,4,-2,87,116,1484,1384,T1
4344,September 2,2014,Niger,Uganda,2,0,Friendly,in Niger,19,-19,1310,1471,4,-4,131,93,1291,1490,T1
4345,September 3,2014,Antigua and Barbuda,Anguilla,6,0,CONCACAF Champ &amp; Carib Champ qual,in Antigua and Barbuda,1,-1,1270,562,0,0,139,231,1269,563,T1
4346,September 3,2014,Barbados,Suriname,1,1,CONCACAF Champ &amp; Carib Champ qual,in Martinique,7,-7,1137,1245,1,0,172,144,1130,1252,draw
4347,September 3,2014,Costa Rica,Nicaragua,3,0,CONCACAF Champ q &amp; Central Am Cup,in the United States,1,-1,1848,1114,0,0,15,174,1847,1115,T1
4348,September 3,2014,Czechia,United States,0,1,Friendly,in Czechia,-10,10,1731,1848,-1,3,30,15,1741,1838,T2
4349,September 3,2014,Denmark,Turkey,1,2,Friendly,in Denmark,-13,13,1741,1765,-1,2,28,26,1754,1752,T2
4350,September 3,2014,Dominica,Guyana,0,0,CONCACAF Champ &amp; Carib Champ qual,in Saint Kitts and Nevis,15,-15,977,1296,1,-3,191,133,962,1311,draw
4351,September 3,2014,England,Norway,1,0,Friendly,in England,2,-2,1862,1616,0,-1,13,55,1860,1618,T1
4352,September 3,2014,French Guiana,Grenada,1,1,CONCACAF Champ &amp; Carib Champ qual,in Puerto Rico,-3,3,1240,1195,-1,0,148,160,1243,1192,draw
4353,September 3,2014,Germany,Argentina,2,4,Friendly,in Germany,-24,24,2199,2088,0,0,1,3,2223,2064,T2
4354,September 3,2014,Guatemala,El Salvador,2,1,CONCACAF Champ q &amp; Central Am Cup,in the United States,22,-22,1509,1500,9,-6,80,84,1487,1522,T1
4355,September 3,2014,Honduras,Belize,2,0,CONCACAF Champ q &amp; Central Am Cup,in the United States,4,-4,1610,1146,0,-1,57,170,1606,1150,T1
4356,September 3,2014,Ireland,Oman,2,0,Friendly,in Ireland,8,-8,1695,1595,1,0,39,59,1687,1603,T1
4357,September 3,2014,Latvia,Armenia,2,0,Friendly,in Latvia,16,-16,1473,1558,5,-4,93,69,1457,1574,T1
4358,September 3,2014,Lithuania,United Arab Emirates,1,1,Friendly,in Austria,5,-5,1472,1646,0,-1,94,48,1467,1651,draw
4359,September 3,2014,Martinique,Bonaire,6,0,CONCACAF Champ &amp; Carib Champ qual,in Martinique,3,-3,1434,960,1,-1,104,192,1431,963,T1
4360,September 3,2014,Morocco,Qatar,0,0,Friendly,in Morocco,-4,4,1514,1490,1,0,78,90,1518,1486,draw
4361,September 3,2014,Myanmar,Palestine,4,1,Friendly tournament,in the Philippines,45,-45,1048,1282,2,-8,185,136,1003,1327,T1
4362,September 3,2014,Philippines,Taiwan,5,1,Friendly tournament,in the Philippines,3,-3,1236,840,3,0,150,207,1233,843,T1
4363,September 3,2014,Puerto Rico,Curaçao,2,2,CONCACAF Champ &amp; Carib Champ qual,in Puerto Rico,-9,9,1077,1016,-1,-1,180,187,1086,1007,draw
4364,September 3,2014,Russia,Azerbaijan,4,0,Friendly,in Russia,3,-3,1800,1442,0,0,21,103,1797,1445,T1
4365,September 3,2014,Saint Kitts and Nevis,Saint Lucia,0,0,CONCACAF Champ &amp; Carib Champ qual,in Saint Kitts and Nevis,-8,8,1142,1112,-2,2,171,175,1150,1104,draw
4366,September 3,2014,Saint Vincent and the Grenadines,Dominican Republic,1,0,CONCACAF Champ &amp; Carib Champ qual,in Antigua and Barbuda,26,-26,1179,1236,5,-8,163,150,1153,1262,T1
4367,September 3,2014,Ukraine,Moldova,1,0,Friendly,in Ukraine,1,-1,1840,1457,-1,-2,18,98,1839,1458,T1
4368,September 4,2014,Belarus,Tajikistan,6,1,Friendly,in Belarus,3,-3,1596,1262,1,0,59,141,1593,1265,T1
4369,September 4,2014,Belgium,Australia,2,0,Friendly,in Belgium,4,-4,1916,1662,0,-1,10,46,1912,1666,T1
4370,September 4,2014,Bosnia and Herzegovina,Liechtenstein,3,0,Friendly,in Bosnia and Herzegovina,1,-1,1783,1172,0,0,24,166,1782,1173,T1
4371,September 4,2014,China,Kuwait,3,1,Friendly,in China,11,-11,1552,1531,3,-3,70,75,1541,1542,T1
4372,September 4,2014,Croatia,Cyprus,2,0,Friendly,in Croatia,2,-2,1797,1384,0,0,22,113,1795,1386,T1
4373,September 4,2014,France,Spain,1,0,Friendly,in France,8,-8,1965,1985,0,0,8,5,1957,1993,T1
4374,September 4,2014,Italy,Netherlands,2,0,Friendly,in Italy,23,-23,1873,2131,1,0,13,2,1850,2154,T1
4375,September 4,2014,Peru,Iraq,2,0,Friendly,in the United Arab Emirates,9,-9,1722,1561,1,-2,32,68,1713,1570,T1
4376,September 4,2014,Slovakia,Malta,1,0,Friendly,in Slovakia,1,-1,1635,1236,0,0,51,149,1634,1237,T1
4377,September 4,2014,Sweden,Estonia,2,0,Friendly,in Sweden,2,-2,1797,1455,0,-1,22,99,1795,1457,T1
4378,September 4,2014,Uzbekistan,Jordan,2,0,Friendly,in Uzbekistan,10,-10,1623,1571,3,-1,53,65,1613,1581,T1
4379,September 5,2014,Antigua and Barbuda,Dominican Republic,2,1,CONCACAF Champ &amp; Carib Champ qual,in Antigua and Barbuda,13,-13,1283,1223,4,-4,135,153,1270,1236,T1
4380,September 5,2014,Bonaire,Suriname,3,2,CONCACAF Champ &amp; Carib Champ qual,in Martinique,34,-34,994,1211,3,-11,189,155,960,1245,T1
4381,September 5,2014,Brazil,Colombia,1,0,Friendly,in the United States,11,-11,1991,2008,2,0,5,4,1980,2019,T1
4382,September 5,2014,Curaçao,Grenada,2,1,CONCACAF Champ &amp; Carib Champ qual,in Puerto Rico,29,-29,1045,1166,1,-6,186,166,1016,1195,T1
4383,September 5,2014,Guinea,Togo,2,1,African Nations Cup qualifier,in Morocco,16,-16,1559,1464,3,-4,69,95,1543,1480,T1
4384,September 5,2014,Japan,Uruguay,0,2,Friendly,in Japan,-13,13,1722,1893,-2,1,31,11,1735,1880,T2
4385,September 5,2014,Kazakhstan,Kyrgyzstan,7,1,Friendly,in Kazakhstan,5,-5,1368,1101,2,0,118,177,1363,1106,T1
4386,September 5,2014,Martinique,Barbados,3,2,CONCACAF Champ &amp; Carib Champ qual,in Martinique,4,-4,1438,1133,0,-2,104,174,1434,1137,T1
4387,September 5,2014,Puerto Rico,French Guiana,1,2,CONCACAF Champ &amp; Carib Champ qual,in Puerto Rico,-16,16,1061,1256,-4,6,184,142,1077,1240,T2
4388,September 5,2014,Senegal,Egypt,2,0,African Nations Cup qualifier,in Senegal,32,-32,1617,1676,7,-4,56,40,1585,1708,T1
4389,September 5,2014,South Korea,Venezuela,3,1,Friendly,in South Korea,14,-14,1631,1683,2,-1,53,39,1617,1697,T1
4390,September 5,2014,Saint Kitts and Nevis,Dominica,5,0,CONCACAF Champ &amp; Carib Champ qual,in Saint Kitts and Nevis,14,-14,1156,963,1,-1,170,192,1142,977,T1
4391,September 5,2014,Saint Lucia,Guyana,2,0,CONCACAF Champ &amp; Carib Champ qual,in Saint Kitts and Nevis,45,-45,1157,1251,7,-10,168,143,1112,1296,T1
4392,September 5,2014,Saint Vincent and the Grenadines,Anguilla,4,0,CONCACAF Champ &amp; Carib Champ qual,in Antigua and Barbuda,2,-2,1181,560,2,0,161,231,1179,562,T1
4393,September 5,2014,Sudan,South Africa,0,3,African Nations Cup qualifier,in Sudan,-24,24,1353,1612,-8,4,124,58,1377,1588,T2
4394,September 6,2014,Burkina Faso,Lesotho,2,0,African Nations Cup qualifier,in Burkina Faso,6,-6,1544,1261,2,-2,72,141,1538,1267,T1
4395,September 6,2014,Chile,Mexico,0,0,Friendly,in the United States,-3,3,1978,1886,0,0,7,12,1981,1883,draw
4396,September 6,2014,Democratic Republic of Congo,Cameroon,0,2,African Nations Cup qualifier,in the Democratic Republic of the Congo,-28,28,1424,1601,-5,3,107,61,1452,1573,T2
4397,September 6,2014,Ecuador,Bolivia,4,0,Friendly,in the United States,8,-8,1845,1613,1,-2,18,57,1837,1621,T1
4398,September 6,2014,Ethiopia,Algeria,1,2,African Nations Cup qualifier,in Ethiopia,-10,10,1369,1685,-2,3,117,39,1379,1675,T2
4399,September 6,2014,Gabon,Angola,1,0,African Nations Cup qualifier,in Gabon,14,-14,1493,1450,5,-6,86,101,1479,1464,T1
4400,September 6,2014,Ghana,Uganda,1,1,African Nations Cup qualifier,in Ghana,-15,15,1687,1486,-2,3,38,91,1702,1471,draw
4401,September 6,2014,Ivory Coast,Sierra Leone,2,1,African Nations Cup qualifier,in Ivory Coast,2,-2,1760,1366,0,-1,27,119,1758,1368,T1
4402,September 6,2014,Niger,Cape Verde,1,3,African Nations Cup qualifier,in Niger,-22,22,1288,1527,-5,5,134,77,1310,1505,T2
4403,September 6,2014,Nigeria,Congo,2,3,African Nations Cup qualifier,in Nigeria,-37,37,1689,1427,-7,7,37,105,1726,1390,T2
4404,September 6,2014,Palestine,Taiwan,7,3,Friendly tournament,in the Philippines,4,-4,1286,836,1,0,135,207,1282,840,T1
4405,September 6,2014,Philippines,Myanmar,2,3,Friendly tournament,in the Philippines,-25,25,1211,1073,-6,4,154,181,1236,1048,T2
4406,September 6,2014,Singapore,Papua New Guinea,2,1,Friendly,in Singapore,3,-3,1247,1062,0,-3,145,184,1244,1065,T1
4407,September 6,2014,Trinidad and Tobago,Guadeloupe,1,1,Friendly,in Trinidad and Tobago,-6,6,1493,1379,-1,0,86,116,1499,1373,draw
4408,September 6,2014,Tunisia,Botswana,2,1,African Nations Cup qualifier,in Tunisia,7,-7,1538,1340,0,-1,75,126,1531,1347,T1
4409,September 6,2014,Vietnam,Hong Kong,3,1,Friendly,in Vietnam,8,-8,1250,1151,2,-3,144,170,1242,1159,T1
4410,September 6,2014,Zambia,Mozambique,0,0,African Nations Cup qualifier,in Zambia,-11,11,1480,1382,-4,3,92,114,1491,1371,draw
4411,September 7,2014,Antigua and Barbuda,Saint Vincent and the Grenadines,2,1,CONCACAF Champ &amp; Carib Champ qual,in Antigua and Barbuda,10,-10,1293,1171,4,-5,132,166,1283,1181,T1
4412,September 7,2014,Barbados,Bonaire,4,1,CONCACAF Champ &amp; Carib Champ qual,in Martinique,22,-22,1155,972,4,-2,170,191,1133,994,T1
4413,September 7,2014,Burundi,Tanzania,2,0,Friendly,in Burundi,12,-12,1322,1334,1,-1,128,126,1310,1346,T1
4414,September 7,2014,Costa Rica,Panama,2,2,CONCACAF Champ q &amp; Central Am Cup,in the United States,-8,8,1840,1700,-3,0,18,36,1848,1692,draw
4415,September 7,2014,Curaçao,French Guiana,0,0,CONCACAF Champ &amp; Carib Champ qual,in Puerto Rico,11,-11,1056,1245,0,-3,186,145,1045,1256,draw
4416,September 7,2014,Denmark,Armenia,2,1,European Championship qualifier,in Denmark,7,-7,1748,1551,0,-2,28,72,1741,1558,T1
4417,September 7,2014,Dominican Republic,Anguilla,10,0,CONCACAF Champ &amp; Carib Champ qual,in Antigua and Barbuda,2,-2,1225,558,0,0,152,231,1223,560,T1
4418,September 7,2014,El Salvador,Honduras,1,0,CONCACAF Champ q &amp; Central Am Cup,in the United States,26,-26,1526,1584,5,-4,79,63,1500,1610,T1
4419,September 7,2014,Faroe Islands,Finland,1,3,European Championship qualifier,in the Faroe Islands,-6,6,1198,1678,-2,3,158,41,1204,1672,T2
4420,September 7,2014,Georgia,Ireland,1,2,European Championship qualifier,in Georgia,-15,15,1494,1710,-3,2,84,33,1509,1695,T2
4421,September 7,2014,Germany,Scotland,2,1,European Championship qualifier,in Germany,1,-1,2200,1709,0,-1,1,34,2199,1710,T1
4422,September 7,2014,Greece,Romania,0,1,European Championship qualifier,in Greece,-30,30,1785,1746,-3,3,23,29,1815,1716,T2
4423,September 7,2014,Guatemala,Belize,2,1,CONCACAF Champ q &amp; Central Am Cup,in the United States,4,-4,1513,1142,-1,0,82,172,1509,1146,T1
4424,September 7,2014,Hungary,Northern Ireland,1,2,European Championship qualifier,in Hungary,-36,36,1639,1447,-7,8,50,102,1675,1411,T2
4425,September 7,2014,Kosovo,Oman,1,0,Friendly,in Kosovo,14,-14,1377,1581,3,-1,117,64,1363,1595,T1
4426,September 7,2014,Mali,Malawi,2,0,African Nations Cup qualifier,in Mali,7,-7,1573,1308,1,-2,65,130,1566,1315,T1
4427,September 7,2014,Martinique,Suriname,0,0,CONCACAF Champ &amp; Carib Champ qual,in Martinique,-15,15,1423,1226,-6,4,109,150,1438,1211,draw
4428,September 7,2014,Morocco,Libya,3,0,Friendly,in Morocco,12,-12,1526,1483,0,-6,79,91,1514,1495,T1
4429,September 7,2014,Paraguay,United Arab Emirates,0,0,Friendly,in Austria,-2,2,1708,1648,-2,1,35,47,1710,1646,draw
4430,September 7,2014,Poland,Gibraltar,7,0,European Championship qualifier,in Portugal,5,-5,1652,1142,1,-1,46,172,1647,1147,T1
4431,September 7,2014,Portugal,Albania,0,1,European Championship qualifier,in Portugal,-38,38,1881,1552,-3,9,12,70,1919,1514,T2
4432,September 7,2014,Puerto Rico,Grenada,2,2,CONCACAF Champ &amp; Carib Champ qual,in Puerto Rico,0,0,1061,1166,0,-2,185,168,1061,1166,draw
4433,September 7,2014,Serbia,France,1,1,Friendly,in Serbia,3,-3,1770,1962,0,0,25,8,1767,1965,draw
4434,September 7,2014,Saint Kitts and Nevis,Guyana,2,0,CONCACAF Champ &amp; Carib Champ qual,in Saint Kitts and Nevis,30,-30,1186,1221,8,-11,161,154,1156,1251,T1
4435,September 7,2014,Saint Lucia,Dominica,2,1,CONCACAF Champ &amp; Carib Champ qual,in Saint Kitts and Nevis,10,-10,1167,953,0,0,167,192,1157,963,T1
4436,September 8,2014,Australia,Saudi Arabia,3,2,Friendly,in England,5,-5,1667,1487,0,-2,45,89,1662,1492,T1
4437,September 8,2014,Austria,Sweden,1,1,European Championship qualifier,in Austria,1,-1,1677,1796,0,-1,42,22,1676,1797,draw
4438,September 8,2014,Estonia,Slovenia,1,0,European Championship qualifier,in Estonia,25,-25,1480,1617,6,-5,92,54,1455,1642,T1
4439,September 8,2014,Luxembourg,Belarus,1,1,European Championship qualifier,in Luxembourg,13,-13,1235,1583,4,-2,149,63,1222,1596,draw
4440,September 8,2014,Montenegro,Moldova,2,0,European Championship qualifier,in Montenegro,12,-12,1616,1445,3,-5,56,102,1604,1457,T1
4441,September 8,2014,Russia,Liechtenstein,4,0,European Championship qualifier,in Russia,1,-1,1801,1171,0,0,20,165,1800,1172,T1
4442,September 8,2014,San Marino,Lithuania,0,2,European Championship qualifier,in San Marino,-3,3,873,1475,0,0,203,94,876,1472,T2
4443,September 8,2014,South Korea,Uruguay,0,1,Friendly,in South Korea,-6,6,1625,1899,0,0,53,10,1631,1893,T2
4444,September 8,2014,Spain,Macedonia,5,1,European Championship qualifier,in Spain,3,-3,1988,1500,0,0,6,83,1985,1503,T1
4445,September 8,2014,Switzerland,England,0,2,European Championship qualifier,in Switzerland,-37,37,1810,1899,-2,4,18,10,1847,1862,T2
4446,September 8,2014,Ukraine,Slovakia,0,1,European Championship qualifier,in Ukraine,-34,34,1806,1669,-1,7,19,44,1840,1635,T2
4447,September 8,2014,Uzbekistan,New Zealand,3,1,Friendly,in Uzbekistan,8,-8,1631,1536,2,-3,52,76,1623,1544,T1
4448,September 9,2014,Andorra,Wales,1,2,European Championship qualifier,in Andorra,-2,2,983,1595,0,0,189,61,985,1593,T2
4449,September 9,2014,Azerbaijan,Bulgaria,1,2,European Championship qualifier,in Azerbaijan,-14,14,1428,1658,-1,2,104,47,1442,1644,T2
4450,September 9,2014,Bosnia and Herzegovina,Cyprus,1,2,European Championship qualifier,in Bosnia and Herzegovina,-38,38,1745,1422,-5,3,29,110,1783,1384,T2
4451,September 9,2014,Brazil,Ecuador,1,0,Friendly,in the United States,6,-6,1997,1839,0,-1,5,17,1991,1845,T1
4452,September 9,2014,Canada,Jamaica,3,1,Friendly,in Canada,12,-12,1503,1512,4,-1,83,82,1491,1524,T1
4453,September 9,2014,Chile,Haiti,1,0,Friendly,in the United States,1,-1,1979,1432,0,1,7,103,1978,1433,T1
4454,September 9,2014,China,Jordan,1,1,Friendly,in China,-2,2,1550,1573,-3,0,73,66,1552,1571,draw
4455,September 9,2014,Croatia,Malta,2,0,European Championship qualifier,in Croatia,1,-1,1798,1235,0,0,21,147,1797,1236,T1
4456,September 9,2014,Czechia,Netherlands,2,1,European Championship qualifier,in Czechia,34,-34,1765,2097,5,0,25,2,1731,2131,T1
4457,September 9,2014,Iceland,Turkey,3,0,European Championship qualifier,in Iceland,47,-47,1586,1718,12,-5,62,31,1539,1765,T1
4458,September 9,2014,Indonesia,Yemen,0,0,Friendly,in Indonesia,-5,5,1231,1162,-3,0,150,169,1236,1157,draw
4459,September 9,2014,Japan,Venezuela,2,2,Friendly,in Japan,-4,4,1718,1687,0,2,31,38,1722,1683,draw
4460,September 9,2014,Kazakhstan,Latvia,0,0,European Championship qualifier,in Kazakhstan,0,0,1368,1473,0,0,119,95,1368,1473,draw
4461,September 9,2014,Kuwait,Bahrain,0,1,Friendly,in Kuwait,-15,15,1516,1468,-3,3,80,96,1531,1453,T2
4462,September 9,2014,Mexico,Bolivia,1,0,Friendly,in the United States,3,-3,1889,1610,-1,0,13,58,1886,1613,T1
4463,September 9,2014,Norway,Italy,0,2,European Championship qualifier,in Norway,-17,17,1599,1890,-4,2,60,12,1616,1873,T2
4464,September 9,2014,Qatar,Peru,0,2,Friendly,in Qatar,-10,10,1480,1732,-3,1,91,30,1490,1722,T2
4465,September 9,2014,Singapore,Hong Kong,0,0,Friendly,in Singapore,-5,5,1242,1156,-2,1,145,170,1247,1151,draw
4466,September 10,2014,Algeria,Mali,1,0,African Nations Cup qualifier,in Algeria,9,-9,1694,1564,2,-3,38,69,1685,1573,T1
4467,September 10,2014,Angola,Burkina Faso,0,3,African Nations Cup qualifier,in Angola,-36,36,1414,1580,-10,9,110,65,1450,1544,T2
4468,September 10,2014,Botswana,Senegal,0,2,African Nations Cup qualifier,in Botswana,-16,16,1324,1633,-3,2,128,52,1340,1617,T2
4469,September 10,2014,Cameroon,Ivory Coast,4,1,African Nations Cup qualifier,in Cameroon,41,-41,1642,1719,9,-4,50,30,1601,1760,T1
4470,September 10,2014,Cape Verde,Zambia,2,1,African Nations Cup qualifier,in Cape Verde,12,-12,1539,1468,1,-4,76,95,1527,1480,T1
4471,September 10,2014,Congo,Sudan,2,0,African Nations Cup qualifier,in Congo,16,-16,1443,1337,3,0,102,124,1427,1353,T1
4472,September 10,2014,Democratic Republic of Congo,Sierra Leone,2,0,African Nations Cup qualifier,in the Democratic Republic of the Congo,17,-17,1441,1349,4,-3,103,123,1424,1366,T1
4473,September 10,2014,Egypt,Tunisia,0,1,African Nations Cup qualifier,in Egypt,-32,32,1644,1570,-6,8,49,67,1676,1538,T2
4474,September 10,2014,El Salvador,Belize,2,0,CONCACAF Champ q &amp; Central Am Cup,in the United States,6,-6,1532,1136,0,-2,78,174,1526,1142,T1
4475,September 10,2014,Guatemala,Honduras,2,0,CONCACAF Champ q &amp; Central Am Cup,in the United States,36,-36,1549,1548,7,-12,74,75,1513,1584,T1
4476,September 10,2014,Lesotho,Gabon,1,1,African Nations Cup qualifier,in Lesotho,7,-7,1268,1486,2,-3,139,89,1261,1493,draw
4477,September 10,2014,Malawi,Ethiopia,3,2,African Nations Cup qualifier,in Malawi,18,-18,1326,1351,3,-4,127,122,1308,1369,T1
4478,September 10,2014,Mozambique,Niger,1,1,African Nations Cup qualifier,in Mozambique,-10,10,1372,1298,-3,4,117,131,1382,1288,draw
4479,September 10,2014,Namibia,Swaziland,1,1,Friendly,in Namibia,-6,6,1285,1140,-2,1,136,173,1291,1134,draw
4480,September 10,2014,Panama,Nicaragua,2,0,CONCACAF Champ q &amp; Central Am Cup,in the United States,2,-2,1702,1112,0,0,36,175,1700,1114,T1
4481,September 10,2014,South Africa,Nigeria,0,0,African Nations Cup qualifier,in South Africa,-1,1,1611,1690,-1,-2,58,39,1612,1689,draw
4482,September 10,2014,Togo,Ghana,2,3,African Nations Cup qualifier,in Togo,-13,13,1451,1700,-2,1,99,37,1464,1687,T2
4483,September 10,2014,Uganda,Guinea,2,0,African Nations Cup qualifier,in Uganda,28,-28,1514,1531,7,-9,82,79,1486,1559,T1
4484,September 13,2014,Costa Rica,Guatemala,2,1,Central American Cup,in the United States,6,-6,1846,1543,0,-1,16,75,1840,1549,T1
4485,September 13,2014,Honduras,Nicaragua,1,0,CONCACAF Champ q &amp; Central Am Cup,in the United States,3,-3,1551,1109,3,0,72,175,1548,1112,T1
4486,September 13,2014,Panama,El Salvador,1,0,Central American Cup,in the United States,11,-11,1713,1521,3,-2,33,80,1702,1532,T1
4487,September 14,2014,Indonesia,Malaysia,2,0,Friendly,in Indonesia,9,-9,1240,1171,3,-2,147,164,1231,1180,T1
4488,September 20,2014,Malaysia,Cambodia,4,1,Friendly,in Malaysia,1,-1,1172,672,0,0,164,222,1171,673,T1
4489,September 21,2014,British Virgin Islands,Saint Vincent and the Grenadines,0,6,Friendly,in the British Virgin Islands,-3,3,635,1174,0,2,224,163,638,1171,T2
4490,September 25,2014,Indonesia,Cambodia,1,0,Friendly,in Indonesia,0,0,1240,672,0,0,147,222,1240,672,T1
4491,October 6,2014,India,Palestine,2,3,Friendly,in India,-7,7,1069,1293,-1,2,181,133,1076,1286,T2
4492,October 6,2014,Qatar,Uzbekistan,3,0,Friendly,in Qatar,20,-20,1500,1611,6,-3,85,57,1480,1631,T1
4493,October 8,2014,Antigua and Barbuda,Saint Lucia,2,1,CONCACAF Champ &amp; Carib Champ qual,in Trinidad and Tobago,13,-13,1306,1154,2,-4,131,171,1293,1167,T1
4494,October 8,2014,Barbados,Saint Kitts and Nevis,3,2,CONCACAF Champ &amp; Carib Champ qual,in Haiti,22,-22,1177,1164,10,-7,161,168,1155,1186,T1
4495,October 8,2014,Curaçao,Martinique,1,1,CONCACAF Champ &amp; Carib Champ qual,in Guadeloupe,16,-16,1072,1407,5,-3,181,111,1056,1423,draw
4496,October 8,2014,Guadeloupe,Saint Vincent and the Grenadines,3,1,CONCACAF Champ &amp; Carib Champ qual,in Guadeloupe,9,-9,1388,1165,1,-4,114,167,1379,1174,T1
4497,October 8,2014,Haiti,French Guiana,2,2,CONCACAF Champ &amp; Carib Champ qual,in Haiti,-14,14,1418,1259,-4,2,108,142,1432,1245,draw
4498,October 8,2014,Taiwan,Cambodia,0,2,Friendly,in Taiwan,-25,25,811,697,-1,7,208,215,836,672,T2
4499,October 8,2014,Trinidad and Tobago,Dominican Republic,6,1,CONCACAF Champ &amp; Carib Champ qual,in Trinidad and Tobago,9,-9,1502,1216,3,-1,85,154,1493,1225,T1
4500,October 9,2014,Belarus,Ukraine,0,2,European Championship qualifier,in Belarus,-20,20,1563,1826,-6,1,69,18,1583,1806,T2
4501,October 9,2014,England,San Marino,5,0,European Championship qualifier,in England,0,0,1899,873,0,0,10,203,1899,873,T1
4502,October 9,2014,Liechtenstein,Montenegro,0,0,European Championship qualifier,in Liechtenstein,15,-15,1186,1601,4,-3,161,59,1171,1616,draw
4503,October 9,2014,Lithuania,Estonia,1,0,European Championship qualifier,in Lithuania,15,-15,1490,1465,4,-4,89,96,1475,1480,T1
4504,October 9,2014,Macedonia,Luxembourg,3,2,European Championship qualifier,in Macedonia,4,-4,1504,1231,1,-2,85,150,1500,1235,T1
4505,October 9,2014,Mexico,Honduras,2,0,Friendly,in Mexico,2,-2,1891,1549,1,-2,12,74,1889,1551,T1
4506,October 9,2014,Moldova,Austria,1,2,European Championship qualifier,in Moldova,-13,13,1432,1690,-2,2,103,40,1445,1677,T2
4507,October 9,2014,Morocco,Central African Republic,4,0,Friendly,in Morocco,4,-4,1530,1238,0,-2,79,147,1526,1242,T1
4508,October 9,2014,Qatar,Lebanon,5,0,Friendly,in Qatar,11,-11,1511,1415,2,-3,84,108,1500,1426,T1
4509,October 9,2014,Slovakia,Spain,2,1,European Championship qualifier,in Slovakia,31,-31,1700,1957,6,-2,37,8,1669,1988,T1
4510,October 9,2014,Slovenia,Switzerland,1,0,European Championship qualifier,in Slovenia,25,-25,1642,1785,5,-4,50,22,1617,1810,T1
4511,October 9,2014,Sweden,Russia,1,1,European Championship qualifier,in Sweden,-5,5,1791,1806,1,1,21,19,1796,1801,draw
4512,October 10,2014,Antigua and Barbuda,Dominican Republic,0,0,CONCACAF Champ &amp; Carib Champ qual,in Trinidad and Tobago,-5,5,1301,1221,0,1,131,153,1306,1216,draw
4513,October 10,2014,Bahrain,Uzbekistan,0,0,Friendly,in the United Arab Emirates,4,-4,1472,1607,1,-4,93,60,1468,1611,draw
4514,October 10,2014,Belgium,Andorra,6,0,European Championship qualifier,in Belgium,0,0,1916,983,0,0,9,189,1916,983,T1
4515,October 10,2014,Botswana,Egypt,0,2,African Nations Cup qualifier,in Botswana,-13,13,1311,1657,-1,3,129,46,1324,1644,T2
4516,October 10,2014,Bulgaria,Croatia,0,1,European Championship qualifier,in Bulgaria,-18,18,1640,1816,-6,1,52,19,1658,1798,T2
4517,October 10,2014,Chile,Peru,3,0,Friendly,in Chile,4,-4,1983,1728,0,0,6,29,1979,1732,T1
4518,October 10,2014,China,Thailand,3,0,Friendly,in China,4,-4,1554,1294,3,-1,70,133,1550,1298,T1
4519,October 10,2014,Colombia,El Salvador,3,0,Friendly,in the United States,2,-2,2010,1519,0,-1,4,81,2008,1521,T1
4520,October 10,2014,Cyprus,Israel,1,2,European Championship qualifier,in Cyprus,-14,14,1408,1647,-5,5,111,48,1422,1633,T2
4521,October 10,2014,Guadeloupe,Martinique,1,2,CONCACAF Champ &amp; Carib Champ qual,in Guadeloupe,-25,25,1363,1432,-4,8,118,103,1388,1407,T2
4522,October 10,2014,Haiti,Barbados,4,2,CONCACAF Champ &amp; Carib Champ qual,in Haiti,7,-7,1425,1170,1,-5,106,167,1418,1177,T1
4523,October 10,2014,Hong Kong,Singapore,2,1,Friendly,in Hong Kong,10,-10,1166,1232,1,-3,169,148,1156,1242,T1
4524,October 10,2014,Iraq,Yemen,1,1,Friendly,in Bahrain,-8,8,1553,1170,-1,2,71,167,1561,1162,draw
4525,October 10,2014,Italy,Azerbaijan,2,1,European Championship qualifier,in Italy,2,-2,1892,1426,2,-1,11,105,1890,1428,T1
4526,October 10,2014,Japan,Jamaica,1,0,Friendly,in Japan,3,-3,1721,1509,1,-1,30,84,1718,1512,T1
4527,October 10,2014,Jordan,Kuwait,0,1,Friendly,in Jordan,-14,14,1559,1530,-4,2,69,79,1573,1516,T2
4528,October 10,2014,Latvia,Iceland,0,3,European Championship qualifier,in Latvia,-34,34,1439,1620,-9,6,102,56,1473,1586,T2
4529,October 10,2014,Lesotho,Angola,0,0,African Nations Cup qualifier,in Lesotho,3,-3,1271,1411,0,-1,139,110,1268,1414,draw
4530,October 10,2014,Malta,Norway,0,3,European Championship qualifier,in Malta,-13,13,1222,1612,-4,3,152,57,1235,1599,T2
4531,October 10,2014,Netherlands,Kazakhstan,3,1,European Championship qualifier,in the Netherlands,1,-1,2098,1367,0,1,2,117,2097,1368,T1
4532,October 10,2014,Oman,Costa Rica,3,4,Friendly,in Oman,-6,6,1575,1852,-2,1,65,15,1581,1846,T2
4533,October 10,2014,Saudi Arabia,Uruguay,1,1,Friendly,in Saudi Arabia,7,-7,1494,1892,2,-1,88,11,1487,1899,draw
4534,October 10,2014,Senegal,Tunisia,0,0,African Nations Cup qualifier,in Senegal,-9,9,1624,1579,-2,2,55,64,1633,1570,draw
4535,October 10,2014,South Korea,Paraguay,2,0,Friendly,in South Korea,14,-14,1639,1694,2,-2,53,38,1625,1708,T1
4536,October 10,2014,Saint Kitts and Nevis,French Guiana,2,1,CONCACAF Champ &amp; Carib Champ qual,in Haiti,25,-25,1189,1234,7,-4,161,146,1164,1259,T1
4537,October 10,2014,Saint Vincent and the Grenadines,Curaçao,1,0,CONCACAF Champ &amp; Carib Champ qual,in Guadeloupe,15,-15,1180,1057,4,-5,163,186,1165,1072,T1
4538,October 10,2014,Trinidad and Tobago,Saint Lucia,2,0,CONCACAF Champ &amp; Carib Champ qual,in Trinidad and Tobago,4,-4,1506,1150,2,0,85,171,1502,1154,T1
4539,October 10,2014,Turkey,Czechia,1,2,European Championship qualifier,in Turkey,-23,23,1695,1788,-6,3,37,22,1718,1765,T2
4540,October 10,2014,United Arab Emirates,Australia,0,0,Friendly,in the United Arab Emirates,-2,2,1646,1669,-1,0,49,44,1648,1667,draw
4541,October 10,2014,United States,Ecuador,1,1,Friendly,in the United States,-3,3,1845,1842,-1,0,16,17,1848,1839,draw
4542,October 10,2014,Wales,Bosnia and Herzegovina,0,0,European Championship qualifier,in Wales,3,-3,1598,1742,-1,0,62,28,1595,1745,draw
4543,October 11,2014,Albania,Denmark,1,1,European Championship qualifier,in Albania,5,-5,1557,1743,2,0,70,26,1552,1748,draw
4544,October 11,2014,Armenia,Serbia,1,1,European Championship qualifier,in Armenia,7,-7,1558,1763,4,0,69,25,1551,1770,draw
4545,October 11,2014,Brazil,Argentina,2,0,Friendly tournament,in China,28,-28,2025,2060,1,0,4,3,1997,2088,T1
4546,October 11,2014,Cameroon,Sierra Leone,0,0,African Nations Cup qualifier,in Cameroon,-16,16,1626,1365,-5,4,55,119,1642,1349,draw
4547,October 11,2014,Congo,South Africa,0,2,African Nations Cup qualifier,in Congo,-24,24,1419,1635,-7,4,107,54,1443,1611,T2
4548,October 11,2014,Democratic Republic of Congo,Ivory Coast,1,2,African Nations Cup qualifier,in the Democratic Republic of the Congo,-11,11,1430,1730,-2,2,103,29,1441,1719,T2
4549,October 11,2014,Ethiopia,Mali,0,2,African Nations Cup qualifier,in Ethiopia,-21,21,1330,1585,-4,4,126,63,1351,1564,T2
4550,October 11,2014,Finland,Greece,1,1,European Championship qualifier,in Finland,0,0,1678,1785,0,0,43,23,1678,1785,draw
4551,October 11,2014,France,Portugal,2,1,Friendly,in France,5,-5,1967,1876,0,0,7,14,1962,1881,T1
4552,October 11,2014,Gabon,Burkina Faso,2,0,African Nations Cup qualifier,in Gabon,29,-29,1515,1551,10,-10,81,73,1486,1580,T1
4553,October 11,2014,Ghana,Guinea,1,1,African Nations Cup qualifier,in Morocco,-9,9,1691,1540,-5,2,40,76,1700,1531,draw
4554,October 11,2014,Ireland,Gibraltar,7,0,European Championship qualifier,in Ireland,2,-2,1712,1140,-1,0,34,172,1710,1142,T1
4555,October 11,2014,Malawi,Algeria,0,2,African Nations Cup qualifier,in Malawi,-11,11,1315,1705,-1,2,128,36,1326,1694,T2
4556,October 11,2014,Mozambique,Cape Verde,2,0,African Nations Cup qualifier,in Mozambique,36,-36,1408,1503,5,-10,111,86,1372,1539,T1
4557,October 11,2014,Niger,Zambia,0,0,African Nations Cup qualifier,in Niger,4,-4,1302,1464,1,-2,131,96,1298,1468,draw
4558,October 11,2014,Northern Ireland,Faroe Islands,2,0,European Championship qualifier,in Northern Ireland,7,-7,1454,1191,0,-2,99,160,1447,1198,T1
4559,October 11,2014,Poland,Germany,2,0,European Championship qualifier,in Poland,56,-56,1708,2144,12,0,35,1,1652,2200,T1
4560,October 11,2014,Romania,Hungary,1,1,European Championship qualifier,in Romania,-11,11,1735,1650,-1,5,28,48,1746,1639,draw
4561,October 11,2014,Scotland,Georgia,1,0,European Championship qualifier,in Scotland,6,-6,1715,1488,2,-2,32,90,1709,1494,T1
4562,October 11,2014,Sudan,Nigeria,1,0,African Nations Cup qualifier,in Sudan,32,-32,1369,1658,7,-6,117,46,1337,1690,T1
4563,October 11,2014,Uganda,Togo,0,1,African Nations Cup qualifier,in Uganda,-29,29,1485,1480,-9,5,91,93,1514,1451,T2
4564,October 12,2014,Austria,Montenegro,1,0,European Championship qualifier,in Austria,10,-10,1700,1591,3,-1,38,62,1690,1601,T1
4565,October 12,2014,Belarus,Slovakia,1,3,European Championship qualifier,in Belarus,-27,27,1536,1727,-9,6,76,31,1563,1700,T2
4566,October 12,2014,Dominican Republic,Saint Lucia,3,2,CONCACAF Champ &amp; Carib Champ qual,in Trinidad and Tobago,16,-16,1237,1134,6,-3,147,174,1221,1150,T1
4567,October 12,2014,East Timor,Brunei,4,2,Southeast Asian Championship qualifier,in Laos,35,-35,650,635,5,-1,223,224,615,670,T1
4568,October 12,2014,Estonia,England,0,1,European Championship qualifier,in Estonia,-5,5,1460,1904,-1,0,96,10,1465,1899,T2
4569,October 12,2014,French Guiana,Barbados,2,0,CONCACAF Champ &amp; Carib Champ qual,in Haiti,25,-25,1259,1145,4,-3,142,170,1234,1170,T1
4570,October 12,2014,Guadeloupe,Curaçao,0,1,CONCACAF Champ &amp; Carib Champ qual,in Guadeloupe,-36,36,1327,1093,-6,7,126,179,1363,1057,T2
4571,October 12,2014,Haiti,Saint Kitts and Nevis,0,0,CONCACAF Champ &amp; Carib Champ qual,in Haiti,-15,15,1410,1204,-5,5,110,156,1425,1189,draw
4572,October 12,2014,Laos,Cambodia,3,2,Southeast Asian Championship qualifier,in Laos,8,-8,859,689,0,-1,206,216,851,697,T1
4573,October 12,2014,Lithuania,Slovenia,0,2,European Championship qualifier,in Lithuania,-26,26,1464,1668,-5,6,94,45,1490,1642,T2
4574,October 12,2014,Luxembourg,Spain,0,4,European Championship qualifier,in Luxembourg,-2,2,1229,1959,-1,0,150,8,1231,1957,T2
4575,October 12,2014,Martinique,Saint Vincent and the Grenadines,4,3,CONCACAF Champ &amp; Carib Champ qual,in Guadeloupe,8,-8,1440,1172,0,-2,101,165,1432,1180,T1
4576,October 12,2014,Mexico,Panama,1,0,Friendly,in Mexico,3,-3,1894,1710,2,-2,11,35,1891,1713,T1
4577,October 12,2014,Pakistan,Palestine,0,2,Friendly,in Pakistan,-6,6,932,1299,-1,2,197,132,938,1293,T2
4578,October 12,2014,Philippines,Papua New Guinea,5,0,Friendly,in the Philippines,8,-8,1219,1054,0,-2,155,186,1211,1062,T1
4579,October 12,2014,Russia,Moldova,1,1,European Championship qualifier,in Russia,-18,18,1788,1450,-1,1,21,100,1806,1432,draw
4580,October 12,2014,Sweden,Liechtenstein,2,0,European Championship qualifier,in Sweden,1,-1,1792,1185,1,0,20,162,1791,1186,T1
4581,October 12,2014,Tanzania,Benin,4,1,Friendly,in Tanzania,16,-16,1350,1380,1,-2,123,115,1334,1396,T1
4582,October 12,2014,Trinidad and Tobago,Antigua and Barbuda,1,0,CONCACAF Champ &amp; Carib Champ qual,in Trinidad and Tobago,6,-6,1512,1295,2,-1,82,133,1506,1301,T1
4583,October 12,2014,Ukraine,Macedonia,1,0,European Championship qualifier,in Ukraine,3,-3,1829,1501,0,-2,18,87,1826,1504,T1
4584,October 13,2014,Andorra,Israel,1,4,European Championship qualifier,in Andorra,-3,3,980,1650,0,0,189,50,983,1647,T2
4585,October 13,2014,Bosnia and Herzegovina,Belgium,1,1,European Championship qualifier,in Bosnia and Herzegovina,4,-4,1746,1912,1,0,26,9,1742,1916,draw
4586,October 13,2014,Croatia,Azerbaijan,6,0,European Championship qualifier,in Croatia,5,-5,1821,1421,0,-1,19,105,1816,1426,T1
4587,October 13,2014,Iceland,Netherlands,2,0,European Championship qualifier,in Iceland,54,-54,1674,2044,13,-1,44,3,1620,2098,T1
4588,October 13,2014,Jordan,Kuwait,1,1,Friendly,in Jordan,-4,4,1555,1534,-2,-1,69,79,1559,1530,draw
4589,October 13,2014,Kazakhstan,Czechia,2,4,European Championship qualifier,in Kazakhstan,-8,8,1359,1796,-3,1,121,20,1367,1788,T2
4590,October 13,2014,Latvia,Turkey,1,1,European Championship qualifier,in Latvia,8,-8,1447,1687,1,-2,101,41,1439,1695,draw
4591,October 13,2014,Malta,Italy,0,1,European Championship qualifier,in Malta,-1,1,1221,1893,0,-1,153,13,1222,1892,T2
4592,October 13,2014,Morocco,Kenya,3,0,Friendly,in Morocco,7,-7,1537,1374,2,-2,76,116,1530,1381,T1
4593,October 13,2014,Norway,Bulgaria,2,1,European Championship qualifier,in Norway,16,-16,1628,1624,3,-5,55,57,1612,1640,T1
4594,October 13,2014,Oman,Uruguay,0,3,Friendly,in Oman,-8,8,1567,1900,0,1,65,11,1575,1892,T2
4595,October 13,2014,Wales,Cyprus,2,1,European Championship qualifier,in Wales,6,-6,1604,1402,0,-1,61,112,1598,1408,T1
4596,October 14,2014,Armenia,France,0,3,Friendly,in Armenia,-5,5,1553,1972,-5,0,72,7,1558,1967,T2
4597,October 14,2014,Bahrain,Iraq,0,0,Friendly,in Bahrain,-1,1,1471,1554,-1,0,94,71,1472,1553,draw
4598,October 14,2014,Brazil,Japan,4,0,Friendly,in Singapore,6,-6,2031,1715,0,-2,4,34,2025,1721,T1
4599,October 14,2014,Chile,Bolivia,2,2,Friendly,in Chile,-9,9,1974,1619,0,-1,6,60,1983,1610,draw
4600,October 14,2014,China,Paraguay,2,1,Friendly,in China,11,-11,1565,1683,2,-3,68,42,1554,1694,T1
4601,October 14,2014,Colombia,Canada,1,0,Friendly,in the United States,1,-1,2011,1502,0,-2,5,87,2010,1503,T1
4602,October 14,2014,Denmark,Portugal,0,1,European Championship qualifier,in Denmark,-18,18,1725,1894,-5,2,32,12,1743,1876,T2
4603,October 14,2014,East Timor,Myanmar,0,0,Southeast Asian Championship qualifier,in Laos,17,-17,667,1056,0,-4,223,185,650,1073,draw
4604,October 14,2014,Ecuador,El Salvador,5,1,Friendly,in the United States,5,-5,1847,1514,1,-2,16,82,1842,1519,T1
4605,October 14,2014,Faroe Islands,Hungary,0,1,European Championship qualifier,in the Faroe Islands,-4,4,1187,1654,0,1,161,49,1191,1650,T2
4606,October 14,2014,Finland,Romania,0,2,European Championship qualifier,in Finland,-34,34,1644,1769,-8,4,51,24,1678,1735,T2
4607,October 14,2014,Georgia,Gibraltar,3,0,European Championship qualifier,in Portugal,8,-8,1496,1132,0,-3,89,174,1488,1140,T1
4608,October 14,2014,Germany,Ireland,1,1,European Championship qualifier,in Germany,-18,18,2126,1730,0,6,1,28,2144,1712,draw
4609,October 14,2014,Greece,Northern Ireland,0,2,European Championship qualifier,in Greece,-55,55,1730,1509,-5,15,28,84,1785,1454,T2
4610,October 14,2014,Hong Kong,Argentina,0,7,Friendly,in Hong Kong,0,0,1166,2060,0,0,168,2,1166,2060,T2
4611,October 14,2014,Laos,Brunei,4,2,Southeast Asian Championship qualifier,in Laos,8,-8,867,627,1,-3,205,227,859,635,T1
4612,October 14,2014,Macao,Singapore,2,2,Friendly,in Macao,9,-9,637,1223,3,-3,224,152,628,1232,draw
4613,October 14,2014,Peru,Guatemala,1,0,Friendly,in Peru,3,-3,1731,1540,3,0,27,74,1728,1543,T1
4614,October 14,2014,Poland,Scotland,2,2,European Championship qualifier,in Poland,-5,5,1703,1720,-1,0,37,33,1708,1715,draw
4615,October 14,2014,Qatar,Australia,1,0,Friendly,in Qatar,12,-12,1523,1657,3,-2,80,47,1511,1669,T1
4616,October 14,2014,San Marino,Switzerland,0,4,European Championship qualifier,in San Marino,-1,1,872,1786,0,0,203,23,873,1785,T2
4617,October 14,2014,Saudi Arabia,Lebanon,1,1,Friendly,in Saudi Arabia,-5,5,1489,1420,-2,1,90,106,1494,1415,draw
4618,October 14,2014,Serbia,Albania,0,0,European Championship qualifier,in Serbia,-14,14,1749,1571,0,3,25,65,1763,1557,draw
4619,October 14,2014,South Korea,Costa Rica,1,3,Friendly,in South Korea,-10,10,1629,1862,-1,0,54,15,1639,1852,T2
4620,October 14,2014,United Arab Emirates,Uzbekistan,0,4,Friendly,in the United Arab Emirates,-26,26,1620,1633,-7,7,59,53,1646,1607,T2
4621,October 14,2014,United States,Honduras,1,1,Friendly,in the United States,-8,8,1837,1557,-1,4,17,69,1845,1549,draw
4622,October 15,2014,Algeria,Malawi,3,0,African Nations Cup qualifier,in Algeria,4,-4,1709,1311,1,0,35,128,1705,1315,T1
4623,October 15,2014,Angola,Lesotho,4,0,African Nations Cup qualifier,in Angola,15,-15,1426,1256,4,-3,105,142,1411,1271,T1
4624,October 15,2014,Burkina Faso,Gabon,1,1,African Nations Cup qualifier,in Burkina Faso,-7,7,1544,1522,0,0,73,81,1551,1515,draw
4625,October 15,2014,Cameroon,Sierra Leone,2,0,African Nations Cup qualifier,in Cameroon,7,-7,1633,1358,4,-4,52,122,1626,1365,T1
4626,October 15,2014,Cape Verde,Mozambique,1,0,African Nations Cup qualifier,in Cape Verde,10,-10,1513,1398,3,-1,83,112,1503,1408,T1
4627,October 15,2014,Egypt,Botswana,2,0,African Nations Cup qualifier,in Egypt,4,-4,1661,1307,0,-1,47,130,1657,1311,T1
4628,October 15,2014,Ghana,Guinea,3,1,African Nations Cup qualifier,in Ghana,11,-11,1702,1529,2,-5,37,79,1691,1540,T1
4629,October 15,2014,Ivory Coast,Democratic Republic of Congo,3,4,African Nations Cup qualifier,in Ivory Coast,-36,36,1694,1466,-11,7,39,96,1730,1430,T2
4630,October 15,2014,Mali,Ethiopia,2,3,African Nations Cup qualifier,in Mali,-35,35,1550,1365,-9,8,72,117,1585,1330,T2
4631,October 15,2014,Nigeria,Sudan,3,1,African Nations Cup qualifier,in Nigeria,6,-6,1664,1363,0,-1,46,118,1658,1369,T1
4632,October 15,2014,South Africa,Congo,0,0,African Nations Cup qualifier,in South Africa,-14,14,1621,1433,-5,3,57,104,1635,1419,draw
4633,October 15,2014,Togo,Uganda,1,0,African Nations Cup qualifier,in Togo,15,-15,1495,1470,3,-4,90,95,1480,1485,T1
4634,October 15,2014,Tunisia,Senegal,1,0,African Nations Cup qualifier,in Tunisia,17,-17,1596,1607,2,-3,62,60,1579,1624,T1
4635,October 15,2014,Zambia,Niger,3,0,African Nations Cup qualifier,in Zambia,13,-13,1477,1289,2,-4,93,135,1464,1302,T1
4636,October 16,2014,Cambodia,East Timor,3,2,Southeast Asian Championship qualifier,in Laos,19,-19,708,648,2,0,214,223,689,667,T1
4637,October 16,2014,Myanmar,Brunei,3,1,Southeast Asian Championship qualifier,in Laos,5,-5,1061,622,1,0,184,227,1056,627,T1
4638,October 18,2014,Laos,East Timor,2,0,Southeast Asian Championship qualifier,in Laos,8,-8,875,640,2,0,203,223,867,648,T1
4639,October 18,2014,Myanmar,Cambodia,1,0,Southeast Asian Championship qualifier,in Laos,5,-5,1066,703,2,0,182,214,1061,708,T1
4640,October 20,2014,Cambodia,Brunei,1,0,Southeast Asian Championship qualifier,in Laos,15,-15,718,607,0,-1,214,228,703,622,T1
4641,October 20,2014,Laos,Myanmar,1,2,Southeast Asian Championship qualifier,in Laos,-15,15,860,1081,-2,2,205,180,875,1066,T2
4642,October 24,2014,Bangladesh,Sri Lanka,1,1,Friendly,in Bangladesh,-5,5,944,841,-2,0,195,207,949,836,draw
4643,October 27,2014,Bangladesh,Sri Lanka,1,0,Friendly,in Bangladesh,5,-5,949,836,2,0,193,207,944,841,T1
4644,October 31,2014,Chagos Islands,Somaliland,1,1,Friendly tournament,in England,8,-8,808,992,0,0,210,189,800,1000,draw
4645,October 31,2014,Kuwait,North Korea,1,0,Friendly,in the United Arab Emirates,11,-11,1545,1555,5,-2,73,68,1534,1566,T1
4646,October 31,2014,Philippines,Nepal,3,0,Friendly,in Qatar,5,-5,1224,885,3,-1,152,203,1219,890,T1
4647,November 2,2014,Bahrain,North Korea,2,2,Friendly,in Bahrain,0,0,1471,1555,0,0,94,68,1471,1555,draw
4648,November 4,2014,Kuwait,Yemen,1,1,Friendly,in the United Arab Emirates,-8,8,1537,1178,-2,4,75,163,1545,1170,draw
4649,November 6,2014,Qatar,North Korea,3,1,Friendly,in Qatar,12,-12,1535,1543,1,-5,79,73,1523,1555,T1
4650,November 6,2014,Saudi Arabia,Palestine,2,0,Friendly,in Saudi Arabia,5,-5,1494,1294,0,-1,91,132,1489,1299,T1
4651,November 6,2014,United Arab Emirates,Lebanon,3,2,Friendly,in Saudi Arabia,5,-5,1625,1415,2,0,56,108,1620,1420,T1
4652,November 7,2014,Bahrain,Singapore,2,0,Friendly,in Bahrain,4,-4,1475,1219,0,-2,94,155,1471,1223,T1
4653,November 7,2014,Oman,Yemen,2,0,Friendly,in Oman,2,-2,1569,1176,0,0,65,163,1567,1178,T1
4654,November 9,2014,Thailand,Philippines,3,0,Friendly,in Thailand,10,-10,1304,1214,0,-3,132,155,1294,1224,T1
4655,November 9,2014,Uganda,Ethiopia,3,0,Friendly,in Uganda,8,-8,1478,1357,2,-6,93,123,1470,1365,T1
4656,November 9,2014,Vietnam,Palestine,1,3,Friendly,in Vietnam,-17,17,1233,1311,-5,4,148,128,1250,1294,T2
4657,November 11,2014,Cuba,French Guiana,1,1,CONCACAF Champ qual &amp; Carib Champ,in Jamaica,-8,8,1404,1267,-1,2,110,139,1412,1259,draw
4658,November 11,2014,Indonesia,East Timor,4,0,Friendly,in Indonesia,1,-1,1241,639,0,0,144,225,1240,640,T1
4659,November 11,2014,Trinidad and Tobago,Curaçao,3,2,CONCACAF Champ qual &amp; Carib Champ,in Jamaica,3,-3,1515,1090,2,0,82,179,1512,1093,T1
4660,November 12,2014,Antigua and Barbuda,Haiti,2,2,CONCACAF Champ qual &amp; Carib Champ,in Jamaica,6,-6,1301,1404,0,0,133,109,1295,1410,draw
4661,November 12,2014,Argentina,Croatia,2,1,Friendly,in England,4,-4,2064,1817,0,0,2,19,2060,1821,T1
4662,November 12,2014,Belgium,Iceland,3,1,Friendly,in Belgium,4,-4,1916,1670,0,0,9,43,1912,1674,T1
4663,November 12,2014,Jamaica,Martinique,1,1,CONCACAF Champ qual &amp; Carib Champ,in Jamaica,-9,9,1500,1449,-3,1,88,102,1509,1440,draw
4664,November 12,2014,Malaysia,Syria,0,3,Friendly,in Malaysia,-9,9,1163,1467,-3,2,169,97,1172,1458,T2
4665,November 12,2014,Netherlands,Mexico,2,3,Friendly,in the Netherlands,-16,16,2028,1910,-1,2,4,10,2044,1894,T2
4666,November 12,2014,Norway,Estonia,0,1,Friendly,in Norway,-16,16,1612,1476,-4,3,59,95,1628,1460,T2
4667,November 12,2014,Turkey,Brazil,0,4,Friendly,in Turkey,-7,7,1680,2038,-2,1,42,3,1687,2031,T2
4668,November 13,2014,Bahrain,Yemen,0,0,Gulf Cup,in Saudi Arabia,-14,14,1461,1190,-3,2,99,161,1475,1176,draw
4669,November 13,2014,Cuba,Curaçao,3,2,CONCACAF Champ qual &amp; Carib Champ,in Jamaica,6,-6,1410,1084,0,0,109,179,1404,1090,T1
4670,November 13,2014,Morocco,Benin,6,1,Friendly,in Morocco,7,-7,1544,1373,2,-2,73,116,1537,1380,T1
4671,November 13,2014,North Korea,Hong Kong,2,1,East Asian Cup qualifier,in Taiwan,4,-4,1547,1162,1,-2,72,169,1543,1166,T1
4672,November 13,2014,Saudi Arabia,Qatar,1,1,Gulf Cup,in Saudi Arabia,-3,3,1491,1538,0,3,91,76,1494,1535,draw
4673,November 13,2014,Singapore,Laos,2,0,Friendly,in Singapore,2,-2,1221,858,2,-1,152,207,1219,860,T1
4674,November 13,2014,Taiwan,Guam,1,2,East Asian Cup qualifier,in Taiwan,-28,28,783,791,-3,3,212,210,811,763,T2
4675,November 13,2014,Trinidad and Tobago,French Guiana,4,2,CONCACAF Champ qual &amp; Carib Champ,in Jamaica,12,-12,1527,1255,1,-3,81,142,1515,1267,T1
4676,November 13,2014,Uruguay,Costa Rica,3,3,Friendly tournament,in Uruguay,-6,6,1894,1868,0,0,12,15,1900,1862,draw
4677,November 14,2014,Botswana,Tunisia,0,0,African Nations Cup qualifier,in Botswana,10,-10,1317,1586,3,-1,128,63,1307,1596,draw
4678,November 14,2014,Chile,Venezuela,5,0,Friendly,in Chile,4,-4,1978,1683,0,-1,6,41,1974,1687,T1
4679,November 14,2014,China,New Zealand,1,1,Friendly,in China,-4,4,1561,1540,0,3,66,75,1565,1536,draw
4680,November 14,2014,Colombia,United States,2,1,Friendly,in England,5,-5,2016,1832,0,0,5,17,2011,1837,T1
4681,November 14,2014,El Salvador,Panama,1,3,Friendly,in El Salvador,-11,11,1503,1721,-2,2,85,32,1514,1710,T2
4682,November 14,2014,France,Albania,1,1,Friendly,in France,-9,9,1963,1580,0,0,7,64,1972,1571,draw
4683,November 14,2014,Georgia,Poland,0,4,European Championship qualifier,in Georgia,-26,26,1470,1729,-6,8,95,28,1496,1703,T2
4684,November 14,2014,Germany,Gibraltar,4,0,European Championship qualifier,in Germany,0,0,2126,1132,0,0,1,174,2126,1132,T1
4685,November 14,2014,Greece,Faroe Islands,0,1,European Championship qualifier,in Greece,-39,39,1691,1226,-12,12,40,150,1730,1187,T2
4686,November 14,2014,Haiti,Martinique,3,0,CONCACAF Champ qual &amp; Carib Champ,in Jamaica,40,-40,1444,1409,7,-8,103,110,1404,1449,T1
4687,November 14,2014,Hungary,Finland,1,0,European Championship qualifier,in Hungary,14,-14,1668,1630,5,-3,44,54,1654,1644,T1
4688,November 14,2014,Ivory Coast,Sierra Leone,5,1,African Nations Cup qualifier,in Ivory Coast,6,-6,1700,1352,2,-2,37,123,1694,1358,T1
4689,November 14,2014,Jamaica,Antigua and Barbuda,3,0,CONCACAF Champ qual &amp; Carib Champ,in Jamaica,11,-11,1511,1290,4,-1,84,134,1500,1301,T1
4690,November 14,2014,Japan,Honduras,6,0,Friendly,in Japan,8,-8,1723,1549,3,-3,30,70,1715,1557,T1
4691,November 14,2014,Jordan,South Korea,0,1,Friendly,in Jordan,-11,11,1544,1640,-4,3,72,51,1555,1629,T2
4692,November 14,2014,Kuwait,Iraq,1,0,Gulf Cup,in Saudi Arabia,21,-21,1558,1533,10,-10,67,79,1537,1554,T1
4693,November 14,2014,Oman,United Arab Emirates,0,0,Gulf Cup,in Saudi Arabia,3,-3,1572,1622,0,-1,65,56,1569,1625,draw
4694,November 14,2014,Paraguay,Peru,2,1,Friendly,in Paraguay,9,-9,1692,1722,2,-4,39,31,1683,1731,T1
4695,November 14,2014,Philippines,Cambodia,3,0,Friendly,in the Philippines,1,-1,1215,717,-1,0,156,216,1214,718,T1
4696,November 14,2014,Portugal,Armenia,1,0,European Championship qualifier,in Portugal,3,-3,1897,1550,0,2,12,68,1894,1553,T1
4697,November 14,2014,Romania,Northern Ireland,2,0,European Championship qualifier,in Romania,7,-7,1776,1502,0,-1,24,86,1769,1509,T1
4698,November 14,2014,Scotland,Ireland,1,0,European Championship qualifier,in Scotland,15,-15,1735,1715,5,-5,27,33,1720,1730,T1
4699,November 14,2014,Serbia,Denmark,1,3,European Championship qualifier,in Serbia,-40,40,1709,1765,-9,6,34,25,1749,1725,T2
4700,November 15,2014,Algeria,Ethiopia,3,1,African Nations Cup qualifier,in Algeria,4,-4,1713,1353,-1,0,35,122,1709,1357,T1
4701,November 15,2014,Angola,Gabon,0,0,African Nations Cup qualifier,in Angola,0,0,1426,1522,2,2,103,80,1426,1522,draw
4702,November 15,2014,Austria,Russia,1,0,European Championship qualifier,in Austria,19,-19,1719,1769,4,-2,33,24,1700,1788,T1
4703,November 15,2014,Cameroon,Democratic Republic of Congo,1,0,African Nations Cup qualifier,in Cameroon,7,-7,1640,1459,2,1,50,96,1633,1466,T1
4704,November 15,2014,Cape Verde,Niger,3,1,African Nations Cup qualifier,in Cape Verde,8,-8,1521,1281,2,-1,81,136,1513,1289,T1
4705,November 15,2014,Congo,Nigeria,0,2,African Nations Cup qualifier,in Congo,-19,19,1414,1683,-4,7,108,40,1433,1664,T2
4706,November 15,2014,Cuba,Trinidad and Tobago,0,0,CONCACAF Champ qual &amp; Carib Champ,in Jamaica,6,-6,1416,1521,3,0,106,81,1410,1527,draw
4707,November 15,2014,Egypt,Senegal,0,1,African Nations Cup qualifier,in Egypt,-28,28,1633,1635,-5,8,53,52,1661,1607,T2
4708,November 15,2014,England,Slovenia,3,1,European Championship qualifier,in England,8,-8,1912,1660,1,-3,10,47,1904,1668,T1
4709,November 15,2014,French Guiana,Curaçao,4,1,CONCACAF Champ qual &amp; Carib Champ,in Jamaica,19,-19,1274,1065,3,-3,139,182,1255,1084,T1
4710,November 15,2014,Indonesia,Syria,0,2,Friendly,in Indonesia,-10,10,1231,1477,-4,3,148,93,1241,1467,T2
4711,November 15,2014,Lesotho,Burkina Faso,0,1,African Nations Cup qualifier,in Lesotho,-10,10,1246,1554,-2,3,143,69,1256,1544,T2
4712,November 15,2014,Luxembourg,Ukraine,0,3,European Championship qualifier,in Luxembourg,-4,4,1225,1833,-3,1,152,17,1229,1829,T2
4713,November 15,2014,Macedonia,Slovakia,0,2,European Championship qualifier,in Macedonia,-20,20,1481,1747,-4,3,92,26,1501,1727,T2
4714,November 15,2014,Malawi,Mali,2,0,African Nations Cup qualifier,in Malawi,41,-41,1352,1509,6,-16,123,84,1311,1550,T1
4715,November 15,2014,Moldova,Liechtenstein,0,1,European Championship qualifier,in Moldova,-36,36,1414,1221,-7,10,108,153,1450,1185,T2
4716,November 15,2014,Montenegro,Sweden,1,1,European Championship qualifier,in Montenegro,6,-6,1597,1786,0,-1,62,22,1591,1792,draw
4717,November 15,2014,Mozambique,Zambia,0,1,African Nations Cup qualifier,in Mozambique,-21,21,1377,1498,-1,4,113,89,1398,1477,T2
4718,November 15,2014,San Marino,Estonia,0,0,European Championship qualifier,in San Marino,18,-18,890,1458,1,-3,203,97,872,1476,draw
4719,November 15,2014,South Africa,Sudan,2,1,African Nations Cup qualifier,in South Africa,5,-5,1626,1358,1,-3,56,120,1621,1363,T1
4720,November 15,2014,Spain,Belarus,3,0,European Championship qualifier,in Spain,3,-3,1962,1533,0,0,8,78,1959,1536,T1
4721,November 15,2014,Switzerland,Lithuania,4,0,European Championship qualifier,in Switzerland,6,-6,1792,1458,2,1,21,97,1786,1464,T1
4722,November 15,2014,Togo,Guinea,1,4,African Nations Cup qualifier,in Togo,-42,42,1453,1571,-11,14,100,66,1495,1529,T2
4723,November 15,2014,Uganda,Ghana,1,0,African Nations Cup qualifier,in Uganda,27,-27,1505,1675,7,-7,85,43,1478,1702,T1
4724,November 16,2014,Azerbaijan,Norway,0,1,European Championship qualifier,in Azerbaijan,-15,15,1406,1627,-5,4,110,56,1421,1612,T2
4725,November 16,2014,Belgium,Wales,0,0,European Championship qualifier,in Belgium,-17,17,1899,1621,-2,2,11,59,1916,1604,draw
4726,November 16,2014,Bulgaria,Malta,1,1,European Championship qualifier,in Bulgaria,-18,18,1606,1239,-4,8,61,145,1624,1221,draw
4727,November 16,2014,Cyprus,Andorra,5,0,European Championship qualifier,in Cyprus,4,-4,1406,976,1,-1,110,191,1402,980,T1
4728,November 16,2014,Czechia,Iceland,2,1,European Championship qualifier,in Czechia,9,-9,1805,1661,0,-3,20,47,1796,1670,T1
4729,November 16,2014,Israel,Bosnia and Herzegovina,3,0,European Championship qualifier,in Israel,35,-35,1685,1711,9,-8,40,35,1650,1746,T1
4730,November 16,2014,Italy,Croatia,1,1,European Championship qualifier,in Italy,-9,9,1884,1826,0,0,14,19,1893,1817,draw
4731,November 16,2014,Jamaica,Haiti,2,0,CONCACAF Champ qual &amp; Carib Champ,in Jamaica,17,-17,1528,1427,4,-1,79,103,1511,1444,T1
4732,November 16,2014,Martinique,Antigua and Barbuda,2,0,CONCACAF Champ qual &amp; Carib Champ,in Jamaica,20,-20,1429,1270,8,-5,102,139,1409,1290,T1
4733,November 16,2014,Netherlands,Latvia,6,0,European Championship qualifier,in the Netherlands,2,-2,2030,1445,0,1,4,100,2028,1447,T1
4734,November 16,2014,North Korea,Guam,5,1,East Asian Cup qualifier,in Taiwan,1,-1,1548,790,0,0,72,210,1547,791,T1
4735,November 16,2014,Qatar,Yemen,0,0,Gulf Cup,in Saudi Arabia,-15,15,1523,1205,-3,5,80,158,1538,1190,draw
4736,November 16,2014,Saudi Arabia,Bahrain,3,0,Gulf Cup,in Saudi Arabia,22,-22,1513,1439,6,-6,84,101,1491,1461,T1
4737,November 16,2014,Swaziland,Tanzania,1,1,Friendly,in Swaziland,3,-3,1143,1347,0,0,171,125,1140,1350,draw
4738,November 16,2014,Taiwan,Hong Kong,0,1,East Asian Cup qualifier,in Taiwan,-7,7,776,1169,-1,2,213,167,783,1162,T2
4739,November 16,2014,Turkey,Kazakhstan,3,1,European Championship qualifier,in Turkey,5,-5,1685,1354,2,-2,40,121,1680,1359,T1
4740,November 16,2014,Vietnam,Malaysia,3,1,Friendly,in Vietnam,8,-8,1241,1155,3,-1,144,169,1233,1163,T1
4741,November 17,2014,Iraq,Oman,1,1,Gulf Cup,in Saudi Arabia,2,-2,1535,1570,0,-1,77,66,1533,1572,draw
4742,November 17,2014,Kuwait,United Arab Emirates,2,2,Gulf Cup,in Saudi Arabia,4,-4,1562,1618,1,-2,67,60,1558,1622,draw
4743,November 17,2014,Singapore,Cambodia,4,2,Friendly,in Singapore,1,-1,1222,716,0,0,154,216,1221,717,T1
4744,November 18,2014,Austria,Brazil,1,2,Friendly,in Austria,-4,4,1715,2042,-1,0,33,3,1719,2038,T2
4745,November 18,2014,Belarus,Mexico,3,2,Friendly,in Belarus,17,-17,1550,1893,7,-3,71,13,1533,1910,T1
4746,November 18,2014,Bolivia,Venezuela,3,2,Friendly,in Bolivia,9,-9,1628,1674,4,-1,55,43,1619,1683,T1
4747,November 18,2014,Chile,Uruguay,1,2,Friendly,in Chile,-15,15,1963,1909,-1,2,7,11,1978,1894,T2
4748,November 18,2014,China,Honduras,0,0,Friendly,in China,-3,3,1558,1552,0,1,68,70,1561,1549,draw
4749,November 18,2014,Estonia,Jordan,1,0,Friendly,in Estonia,10,-10,1468,1534,1,-4,95,77,1458,1544,T1
4750,November 18,2014,France,Sweden,1,0,Friendly,in France,3,-3,1966,1783,1,-1,6,23,1963,1786,T1
4751,November 18,2014,Greece,Serbia,0,2,Friendly,in Greece,-18,18,1673,1727,-5,5,44,31,1691,1709,T2
4752,November 18,2014,Haiti,Cuba,2,1,Caribbean Championship,in Jamaica,19,-19,1446,1397,3,-5,100,111,1427,1416,T1
4753,November 18,2014,Hungary,Russia,1,2,Friendly,in Hungary,-10,10,1658,1779,-2,0,47,24,1668,1769,T2
4754,November 18,2014,Iran,South Korea,1,0,Friendly,in Iran,7,-7,1673,1633,2,-2,44,52,1666,1640,T1
4755,November 18,2014,Ireland,United States,4,1,Friendly,in Ireland,18,-18,1733,1814,6,-1,27,19,1715,1832,T1
4756,November 18,2014,Italy,Albania,1,0,Friendly,in Italy,2,-2,1886,1578,0,0,14,64,1884,1580,T1
4757,November 18,2014,Jamaica,Trinidad and Tobago,0,0,Caribbean Championship,in Jamaica,-6,6,1522,1527,-1,4,80,78,1528,1521,draw
4758,November 18,2014,Japan,Australia,2,1,Friendly,in Japan,6,-6,1729,1651,1,0,28,49,1723,1657,T1
4759,November 18,2014,Nicaragua,El Salvador,0,2,Friendly,in Nicaragua,-5,5,1104,1508,-1,0,176,87,1109,1503,T2
4760,November 18,2014,Panama,Canada,0,0,Friendly,in Panama,-7,7,1714,1509,-3,3,34,85,1721,1502,draw
4761,November 18,2014,Peru,Paraguay,2,1,Friendly,in Peru,6,-6,1728,1686,1,0,29,38,1722,1692,T1
4762,November 18,2014,Poland,Switzerland,2,2,Friendly,in Poland,-1,1,1728,1793,-1,0,29,21,1729,1792,draw
4763,November 18,2014,Portugal,Argentina,1,0,Friendly,in England,14,-14,1911,2050,2,0,10,2,1897,2064,T1
4764,November 18,2014,Romania,Denmark,2,0,Friendly,in Romania,10,-10,1786,1755,1,0,22,25,1776,1765,T1
4765,November 18,2014,Scotland,England,1,3,Friendly,in Scotland,-12,12,1723,1924,-5,0,32,9,1735,1912,T2
4766,November 18,2014,Slovakia,Finland,2,1,Friendly,in Slovakia,4,-4,1751,1626,0,-2,26,57,1747,1630,T1
4767,November 18,2014,Slovenia,Colombia,0,1,Friendly,in Slovenia,-4,4,1656,2020,0,0,48,5,1660,2016,T2
4768,November 18,2014,Spain,Germany,0,1,Friendly,in Spain,-8,8,1954,2134,0,0,8,1,1962,2126,T2
4769,November 18,2014,Thailand,New Zealand,2,0,Friendly,in Thailand,21,-21,1325,1519,4,-8,128,83,1304,1540,T1
4770,November 18,2014,Ukraine,Lithuania,0,0,Friendly,in Ukraine,-9,9,1824,1467,-1,0,18,96,1833,1458,draw
4771,November 19,2014,Bahrain,Qatar,0,0,Gulf Cup,in Saudi Arabia,5,-5,1444,1518,0,-4,102,83,1439,1523,draw
4772,November 19,2014,Burkina Faso,Angola,1,1,African Nations Cup qualifier,in Burkina Faso,-12,12,1542,1438,-5,1,74,103,1554,1426,draw
4773,November 19,2014,Democratic Republic of Congo,Sierra Leone,3,1,African Nations Cup qualifier,in the Democratic Republic of the Congo,14,-14,1473,1338,3,-1,94,124,1459,1352,T1
4774,November 19,2014,Ethiopia,Malawi,0,0,African Nations Cup qualifier,in Ethiopia,-6,6,1347,1358,0,4,122,119,1353,1352,draw
4775,November 19,2014,Gabon,Lesotho,4,2,African Nations Cup qualifier,in Gabon,6,-6,1528,1240,1,-1,79,144,1522,1246,T1
4776,November 19,2014,Ghana,Togo,3,1,African Nations Cup qualifier,in Ghana,8,-8,1683,1445,2,-1,40,100,1675,1453,T1
4777,November 19,2014,Guam,Hong Kong,0,0,East Asian Cup qualifier,in Taiwan,16,-16,806,1153,0,-2,210,169,790,1169,draw
4778,November 19,2014,Guinea,Uganda,2,0,African Nations Cup qualifier,in Morocco,24,-24,1595,1481,1,-3,64,91,1571,1505,T1
4779,November 19,2014,Ivory Coast,Cameroon,0,0,African Nations Cup qualifier,in Ivory Coast,-9,9,1691,1649,1,0,36,50,1700,1640,draw
4780,November 19,2014,Mali,Algeria,2,0,African Nations Cup qualifier,in Mali,39,-39,1548,1674,13,-7,72,42,1509,1713,T1
4781,November 19,2014,Niger,Mozambique,1,1,African Nations Cup qualifier,in Niger,0,0,1281,1377,0,0,135,113,1281,1377,draw
4782,November 19,2014,Nigeria,South Africa,2,2,African Nations Cup qualifier,in Nigeria,-8,8,1675,1634,0,5,41,52,1683,1626,draw
4783,November 19,2014,Saudi Arabia,Yemen,1,0,Gulf Cup,in Saudi Arabia,3,-3,1516,1202,0,-1,84,159,1513,1205,T1
4784,November 19,2014,Senegal,Botswana,3,0,African Nations Cup qualifier,in Senegal,6,-6,1641,1311,0,0,51,130,1635,1317,T1
4785,November 19,2014,Sudan,Congo,0,1,African Nations Cup qualifier,in Sudan,-23,23,1335,1437,-6,3,125,104,1358,1414,T2
4786,November 19,2014,Taiwan,North Korea,0,0,East Asian Cup qualifier,in Taiwan,19,-19,795,1529,2,-5,211,78,776,1548,draw
4787,November 19,2014,Tunisia,Egypt,2,1,African Nations Cup qualifier,in Tunisia,17,-17,1603,1616,1,-8,62,60,1586,1633,T1
4788,November 19,2014,Zambia,Cape Verde,1,0,African Nations Cup qualifier,in Zambia,16,-16,1514,1505,5,-6,85,88,1498,1521,T1
4789,November 20,2014,Oman,Kuwait,5,0,Gulf Cup,in Saudi Arabia,39,-39,1609,1523,5,-12,61,79,1570,1562,T1
4790,November 20,2014,United Arab Emirates,Iraq,2,0,Gulf Cup,in Saudi Arabia,23,-23,1641,1512,8,-9,51,85,1618,1535,T1
4791,November 22,2014,Philippines,Laos,4,1,Southeast Asian Championship,in Vietnam,8,-8,1223,850,3,0,154,207,1215,858,T1
4792,November 22,2014,Vietnam,Indonesia,2,2,Southeast Asian Championship,in Vietnam,-6,6,1235,1237,-5,3,148,146,1241,1231,draw
4793,November 23,2014,Malaysia,Myanmar,0,0,Southeast Asian Championship,in Singapore,-4,4,1151,1085,-1,0,169,179,1155,1081,draw
4794,November 23,2014,Qatar,Oman,3,1,Gulf Cup,in Saudi Arabia,38,-38,1556,1571,14,-5,68,66,1518,1609,T1
4795,November 23,2014,Saudi Arabia,United Arab Emirates,3,2,Gulf Cup,in Saudi Arabia,21,-21,1537,1620,7,-8,76,59,1516,1641,T1
4796,November 23,2014,Singapore,Thailand,1,2,Southeast Asian Championship,in Singapore,-20,20,1202,1345,-3,4,158,124,1222,1325,T2
4797,November 25,2014,Philippines,Indonesia,4,0,Southeast Asian Championship,in Vietnam,39,-39,1262,1198,14,-15,140,161,1223,1237,T1
4798,November 25,2014,United Arab Emirates,Oman,1,0,Gulf Cup,in Saudi Arabia,17,-17,1637,1554,7,-2,52,68,1620,1571,T1
4799,November 25,2014,Vietnam,Laos,3,0,Southeast Asian Championship,in Vietnam,4,-4,1239,846,3,0,145,207,1235,850,T1
4800,November 26,2014,Saudi Arabia,Qatar,1,2,Gulf Cup,in Saudi Arabia,-25,25,1512,1581,-8,2,84,65,1537,1556,T2
4801,November 26,2014,Singapore,Myanmar,4,2,Southeast Asian Championship,in Singapore,13,-13,1215,1072,1,-1,156,180,1202,1085,T1
4802,November 26,2014,Thailand,Malaysia,3,2,Southeast Asian Championship,in Singapore,10,-10,1355,1141,3,-2,121,171,1345,1151,T1
4803,November 28,2014,Indonesia,Laos,5,1,Southeast Asian Championship,in Vietnam,9,-9,1207,837,4,0,157,207,1198,846,T1
4804,November 28,2014,Vietnam,Philippines,3,1,Southeast Asian Championship,in Vietnam,23,-23,1262,1239,5,-5,140,145,1239,1262,T1
4805,November 29,2014,Singapore,Malaysia,1,3,Southeast Asian Championship,in Singapore,-44,44,1171,1185,-11,8,167,163,1215,1141,T2
4806,November 29,2014,Thailand,Myanmar,2,0,Southeast Asian Championship,in Singapore,10,-10,1365,1062,4,-4,117,184,1355,1072,T1
4807,December 6,2014,Philippines,Thailand,0,0,Southeast Asian Championship,in the Philippines,1,-1,1240,1364,1,0,144,117,1239,1365,draw
4808,December 7,2014,Malaysia,Vietnam,1,2,Southeast Asian Championship,in Malaysia,-21,21,1164,1283,-5,5,168,135,1185,1262,T2
4809,December 10,2014,Thailand,Philippines,3,0,Southeast Asian Championship,in Thailand,15,-15,1379,1225,4,-8,113,152,1364,1240,T1
4810,December 11,2014,Vietnam,Malaysia,2,4,Southeast Asian Championship,in Vietnam,-47,47,1236,1211,-12,12,147,156,1283,1164,T2
4811,December 13,2014,China,Kyrgyzstan,4,0,Friendly,in China,1,-1,1559,1100,0,0,67,177,1558,1101,T1
4812,December 13,2014,Uzbekistan,Palestine,1,0,Friendly,in the United Arab Emirates,3,-3,1636,1308,1,-2,53,132,1633,1311,T1
4813,December 17,2014,China,Kyrgyzstan,2,0,Friendly,in China,1,-1,1560,1099,0,0,67,177,1559,1100,T1
4814,December 17,2014,Thailand,Malaysia,2,0,Southeast Asian Championship,in Thailand,11,-11,1390,1200,0,-4,113,160,1379,1211,T1
4815,December 20,2014,Malaysia,Thailand,3,2,Southeast Asian Championship,in Malaysia,25,-25,1225,1365,8,-4,152,117,1200,1390,T1
4816,December 21,2014,China,Palestine,0,0,Friendly,in China,-8,8,1552,1316,-1,2,68,130,1560,1308,draw
4817,December 21,2014,Uzbekistan,Jordan,2,1,Friendly,in the United Arab Emirates,7,-7,1643,1527,2,-2,51,78,1636,1534,T1
4818,December 22,2014,Iraq,Kuwait,1,1,Friendly,in the United Arab Emirates,0,0,1512,1523,0,0,84,80,1512,1523,draw
4819,December 25,2014,Uzbekistan,Iraq,1,0,Friendly,in the United Arab Emirates,6,-6,1649,1506,1,-3,50,87,1643,1512,T1
4820,December 27,2014,Qatar,Estonia,3,0,Friendly,in Qatar,8,-8,1589,1460,0,-1,65,97,1581,1468,T1
4821,December 28,2014,Iraq,Uzbekistan,0,0,Friendly,in the United Arab Emirates,4,-4,1510,1645,2,-1,85,51,1506,1649,draw
4822,December 30,2014,Bahrain,Saudi Arabia,4,1,Friendly,in Australia,21,-21,1465,1491,5,-5,97,89,1444,1512,T1
4823,December 30,2014,United Arab Emirates,Jordan,1,0,Friendly,in Australia,7,-7,1644,1520,1,-3,52,81,1637,1527,T1
4824,January 3,2015,China,Oman,4,1,Friendly,in Australia,18,-18,1570,1537,1,-8,67,75,1552,1555,T1
4825,January 4,2015,Bahrain,Jordan,1,0,Friendly,in Australia,12,-12,1477,1508,4,-3,93,84,1465,1520,T1
4826,January 4,2015,Iran,Iraq,1,0,Friendly,in Australia,6,-6,1679,1504,3,-3,41,87,1673,1510,T1
4827,January 4,2015,South Africa,Zambia,1,0,Friendly,in South Africa,4,-4,1638,1510,-1,1,55,82,1634,1514,T1
4828,January 4,2015,South Korea,Saudi Arabia,2,0,Friendly,in Australia,9,-9,1642,1482,2,-1,53,90,1633,1491,T1
4829,January 7,2015,Cameroon,Democratic Republic of Congo,1,1,Friendly,in Cameroon,-7,7,1642,1480,-2,2,52,93,1649,1473,draw
4830,January 7,2015,Cape Verde,Equatorial Guinea,1,1,Friendly,in Portugal,-5,5,1500,1314,-2,1,88,131,1505,1309,draw
4831,January 9,2015,Australia,Kuwait,4,1,Asian Cup,in Australia,19,-19,1670,1504,3,-6,46,85,1651,1523,T1
4832,January 9,2015,Senegal,Gabon,1,0,Friendly,in Morocco,7,-7,1648,1521,4,-2,50,79,1641,1528,T1
4833,January 10,2015,Burkina Faso,Swaziland,5,1,Friendly,in South Africa,3,-3,1545,1140,1,0,72,171,1542,1143,T1
4834,January 10,2015,Cameroon,South Africa,1,1,Friendly,in Gabon,0,0,1642,1638,-1,0,54,55,1642,1638,draw
4835,January 10,2015,Cape Verde,Congo,3,2,Friendly,in Senegal,8,-8,1508,1429,5,0,83,104,1500,1437,T1
4836,January 10,2015,China,Saudi Arabia,1,0,Asian Cup,in Australia,19,-19,1589,1463,2,-7,65,97,1570,1482,T1
4837,January 10,2015,South Korea,Oman,1,0,Asian Cup,in Australia,18,-18,1660,1519,4,-3,49,78,1642,1537,T1
4838,January 10,2015,Uzbekistan,North Korea,1,0,Asian Cup,in Australia,17,-17,1662,1512,4,-4,47,80,1645,1529,T1
4839,January 11,2015,Iran,Bahrain,2,0,Asian Cup,in Australia,18,-18,1697,1459,5,-5,36,98,1679,1477,T1
4840,January 11,2015,Tunisia,Algeria,1,1,Friendly,in Tunisia,-1,1,1602,1675,0,0,62,43,1603,1674,draw
4841,January 11,2015,United Arab Emirates,Qatar,4,1,Asian Cup,in Australia,37,-37,1681,1551,11,-2,42,68,1644,1588,T1
4842,January 12,2015,Iraq,Jordan,1,0,Asian Cup,in Australia,25,-25,1529,1483,11,-5,75,88,1504,1508,T1
4843,January 12,2015,Japan,Palestine,4,0,Asian Cup,in Australia,8,-8,1737,1308,1,-2,27,132,1729,1316,T1
4844,January 13,2015,Australia,Oman,4,0,Asian Cup,in Australia,18,-18,1688,1501,9,-7,38,86,1670,1519,T1
4845,January 13,2015,Senegal,Guinea,5,2,Friendly,in Morocco,15,-15,1663,1580,4,-1,49,65,1648,1595,T1
4846,January 13,2015,South Korea,Kuwait,1,0,Asian Cup,in Australia,14,-14,1674,1490,4,-1,46,87,1660,1504,T1
4847,January 14,2015,China,Uzbekistan,2,1,Asian Cup,in Australia,30,-30,1619,1632,4,-5,60,55,1589,1662,T1
4848,January 14,2015,Saudi Arabia,North Korea,4,1,Asian Cup,in Australia,50,-50,1513,1462,16,-16,80,96,1463,1512,T1
4849,January 14,2015,South Africa,Mali,3,0,Friendly,in Gabon,13,-13,1651,1535,2,-3,53,74,1638,1548,T1
4850,January 15,2015,Iran,Qatar,1,0,Asian Cup,in Australia,15,-15,1712,1536,1,-5,35,73,1697,1551,T1
4851,January 15,2015,Sweden,Ivory Coast,2,0,Friendly,in the United Arab Emirates,11,-11,1794,1680,2,-6,21,43,1783,1691,T1
4852,January 15,2015,United Arab Emirates,Bahrain,2,1,Asian Cup,in Australia,11,-11,1692,1448,6,-1,37,99,1681,1459,T1
4853,January 16,2015,Iceland,Canada,2,1,Friendly,in the United States,6,-6,1667,1503,1,-3,49,85,1661,1509,T1
4854,January 16,2015,Japan,Iraq,1,0,Asian Cup,in Australia,12,-12,1749,1517,0,-4,27,79,1737,1529,T1
4855,January 16,2015,Jordan,Palestine,5,1,Asian Cup,in Australia,25,-25,1508,1283,6,-2,82,134,1483,1308,T1
4856,January 17,2015,Australia,South Korea,0,1,Asian Cup,in Australia,-33,33,1655,1707,-14,9,52,37,1688,1674,T2
4857,January 17,2015,Equatorial Guinea,Congo,1,1,African Nations Cup,in Equatorial Guinea,1,-1,1315,1428,0,-1,130,105,1314,1429,draw
4858,January 17,2015,Gabon,Burkina Faso,2,0,African Nations Cup,in Equatorial Guinea,40,-40,1561,1505,10,-15,67,85,1521,1545,T1
4859,January 17,2015,Oman,Kuwait,1,0,Asian Cup,in Australia,24,-24,1525,1466,11,-7,76,95,1501,1490,T1
4860,January 18,2015,Cape Verde,Tunisia,1,1,African Nations Cup,in Equatorial Guinea,7,-7,1515,1595,2,-1,80,64,1508,1602,draw
4861,January 18,2015,China,North Korea,2,1,Asian Cup,in Australia,14,-14,1633,1448,4,-2,56,98,1619,1462,T1
4862,January 18,2015,Democratic Republic of Congo,Zambia,1,1,African Nations Cup,in Equatorial Guinea,2,-2,1482,1508,2,0,89,81,1480,1510,draw
4863,January 18,2015,Uzbekistan,Saudi Arabia,3,1,Asian Cup,in Australia,25,-25,1657,1488,4,-7,51,87,1632,1513,T1
4864,January 19,2015,Algeria,South Africa,3,1,African Nations Cup,in Equatorial Guinea,35,-35,1710,1616,7,-6,37,60,1675,1651,T1
4865,January 19,2015,Bahrain,Qatar,2,1,Asian Cup,in Australia,31,-31,1479,1505,6,-11,92,84,1448,1536,T1
4866,January 19,2015,Canada,Iceland,1,1,Friendly,in the United States,4,-4,1507,1663,2,0,83,48,1503,1667,draw
4867,January 19,2015,Finland,Sweden,1,0,Friendly,in the United Arab Emirates,14,-14,1640,1780,4,-2,55,23,1626,1794,T1
4868,January 19,2015,Iran,United Arab Emirates,1,0,Asian Cup,in Australia,24,-24,1736,1668,7,-9,28,47,1712,1692,T1
4869,January 19,2015,Senegal,Ghana,2,1,African Nations Cup,in Equatorial Guinea,26,-26,1689,1657,10,-8,39,50,1663,1683,T1
4870,January 20,2015,Cameroon,Mali,1,1,African Nations Cup,in Equatorial Guinea,-7,7,1635,1542,-1,1,55,72,1642,1535,draw
4871,January 20,2015,Guinea,Ivory Coast,1,1,African Nations Cup,in Equatorial Guinea,7,-7,1587,1673,0,-2,65,45,1580,1680,draw
4872,January 20,2015,Iraq,Palestine,2,0,Asian Cup,in Australia,15,-15,1532,1268,4,-5,74,139,1517,1283,T1
4873,January 20,2015,Japan,Jordan,2,0,Asian Cup,in Australia,15,-15,1764,1493,2,-6,25,86,1749,1508,T1
4874,January 21,2015,Congo,Gabon,1,0,African Nations Cup,in Equatorial Guinea,34,-34,1462,1527,8,-7,97,74,1428,1561,T1
4875,January 21,2015,Equatorial Guinea,Burkina Faso,0,0,African Nations Cup,in Equatorial Guinea,6,-6,1321,1499,0,-2,130,85,1315,1505,draw
4876,January 22,2015,Australia,China,2,0,Asian Cup,in Australia,25,-25,1680,1608,10,-6,43,62,1655,1633,T1
4877,January 22,2015,Cape Verde,Democratic Republic of Congo,0,0,African Nations Cup,in Equatorial Guinea,-2,2,1513,1484,0,1,79,88,1515,1482,draw
4878,January 22,2015,Finland,Yemen,0,0,Friendly,in the United Arab Emirates,-9,9,1631,1211,0,2,54,157,1640,1202,draw
4879,January 22,2015,South Korea,Uzbekistan,2,0,Asian Cup,in Australia,32,-32,1739,1625,10,-7,28,57,1707,1657,T1
4880,January 22,2015,Tunisia,Zambia,2,1,African Nations Cup,in Equatorial Guinea,19,-19,1614,1489,3,-6,61,86,1595,1508,T1
4881,January 23,2015,Ghana,Algeria,1,0,African Nations Cup,in Equatorial Guinea,29,-29,1686,1681,13,-5,38,43,1657,1710,T1
4882,January 23,2015,Iran,Iraq,3,3,Asian Cup,in Australia,-13,13,1723,1545,-4,3,33,70,1736,1532,draw
4883,January 23,2015,Japan,United Arab Emirates,1,1,Asian Cup,in Australia,-7,7,1757,1675,0,3,25,45,1764,1668,draw
4884,January 23,2015,Senegal,South Africa,1,1,African Nations Cup,in Equatorial Guinea,-5,5,1684,1621,-3,1,42,58,1689,1616,draw
4885,January 24,2015,Cameroon,Guinea,1,1,African Nations Cup,in Equatorial Guinea,-3,3,1632,1590,0,0,53,65,1635,1587,draw
4886,January 24,2015,Ivory Coast,Mali,1,1,African Nations Cup,in Equatorial Guinea,-9,9,1664,1551,-1,4,49,68,1673,1542,draw
4887,January 25,2015,Congo,Burkina Faso,2,1,African Nations Cup,in Equatorial Guinea,28,-28,1490,1471,13,-10,84,94,1462,1499,T1
4888,January 25,2015,Equatorial Guinea,Gabon,2,0,African Nations Cup,in Equatorial Guinea,49,-49,1370,1478,13,-18,117,92,1321,1527,T1
4889,January 26,2015,Cape Verde,Zambia,0,0,African Nations Cup,in Equatorial Guinea,-2,2,1511,1491,0,0,78,85,1513,1489,draw
4890,January 26,2015,Democratic Republic of Congo,Tunisia,1,1,African Nations Cup,in Equatorial Guinea,9,-9,1493,1605,4,-2,83,63,1484,1614,draw
4891,January 26,2015,South Korea,Iraq,2,0,Asian Cup,in Australia,18,-18,1757,1527,3,-2,25,73,1739,1545,T1
4892,January 27,2015,Algeria,Senegal,2,0,African Nations Cup,in Equatorial Guinea,38,-38,1719,1646,8,-10,35,52,1681,1684,T1
4893,January 27,2015,Australia,United Arab Emirates,2,0,Asian Cup,in Australia,26,-26,1706,1649,5,-6,39,51,1680,1675,T1
4894,January 27,2015,Ghana,South Africa,2,1,African Nations Cup,in Equatorial Guinea,20,-20,1706,1601,-1,-5,39,63,1686,1621,T1
4895,January 28,2015,Chile,United States,3,2,Friendly,in Chile,4,-4,1967,1810,1,0,6,19,1963,1814,T1
4896,January 28,2015,Guinea,Mali,1,1,African Nations Cup,in Equatorial Guinea,-3,3,1587,1554,0,1,65,67,1590,1551,draw
4897,January 28,2015,Ivory Coast,Cameroon,1,0,African Nations Cup,in Equatorial Guinea,23,-23,1687,1609,6,-6,41,59,1664,1632,T1
4898,January 30,2015,Aruba,Curaçao,0,0,Friendly tournament,in Suriname,5,-5,952,1060,1,-4,194,185,947,1065,draw
4899,January 30,2015,Suriname,Bonaire,3,0,Friendly tournament,in Suriname,6,-6,1232,966,0,0,149,192,1226,972,T1
4900,January 30,2015,United Arab Emirates,Iraq,3,2,Asian Cup,in Australia,17,-17,1666,1510,3,-5,48,78,1649,1527,T1
4901,January 31,2015,Australia,South Korea,2,1,Asian Cup,in Australia,21,-21,1727,1736,7,-3,32,28,1706,1757,T1
4902,January 31,2015,Democratic Republic of Congo,Congo,4,2,African Nations Cup,in Equatorial Guinea,37,-37,1530,1453,10,-13,73,99,1493,1490,T1
4903,January 31,2015,Equatorial Guinea,Tunisia,2,1,African Nations Cup,in Equatorial Guinea,34,-34,1404,1571,6,-4,111,66,1370,1605,T1
4904,February 1,2015,Barbados,Guyana,2,2,Friendly,in Barbados,-1,1,1144,1222,0,0,170,155,1145,1221,draw
4905,February 1,2015,Curaçao,Bonaire,4,1,Friendly tournament,in Suriname,19,-19,1079,947,5,-3,180,195,1060,966,T1
4906,February 1,2015,Ghana,Guinea,3,0,African Nations Cup,in Equatorial Guinea,29,-29,1735,1558,11,-2,29,66,1706,1587,T1
4907,February 1,2015,Ivory Coast,Algeria,3,1,African Nations Cup,in Equatorial Guinea,41,-41,1728,1678,10,-8,31,44,1687,1719,T1
4908,February 1,2015,Suriname,Aruba,1,0,Friendly tournament,in Suriname,3,-3,1235,949,1,1,148,193,1232,952,T1
4909,February 2,2015,Bangladesh,Sri Lanka,1,0,Friendly tournament,in Bangladesh,7,-7,956,829,1,0,192,208,949,836,T1
4910,February 4,2015,Honduras,Venezuela,2,3,Friendly,in Honduras,-9,9,1543,1683,-3,2,71,44,1552,1674,T2
4911,February 4,2015,Ivory Coast,Democratic Republic of Congo,3,1,African Nations Cup,in Equatorial Guinea,18,-18,1746,1512,3,-4,28,77,1728,1530,T1
4912,February 5,2015,Equatorial Guinea,Ghana,0,3,African Nations Cup,in Equatorial Guinea,-18,18,1386,1753,-2,3,113,27,1404,1735,T2
4913,February 6,2015,Pakistan,Afghanistan,2,1,Friendly,in Pakistan,12,-12,944,1084,1,0,197,178,932,1096,T1
4914,February 7,2015,Equatorial Guinea,Democratic Republic of Congo,0,0,African Nations Cup,in Equatorial Guinea,2,-2,1388,1510,0,-1,113,78,1386,1512,draw
4915,February 8,2015,Ghana,Ivory Coast,0,0,African Nations Cup,in Equatorial Guinea,-1,1,1752,1747,0,0,27,29,1753,1746,draw
4916,February 8,2015,United States,Panama,2,0,Friendly,in the United States,7,-7,1817,1707,0,-1,19,40,1810,1714,T1
4917,February 11,2015,Venezuela,Honduras,2,1,Friendly,in Venezuela,4,-4,1687,1539,3,-1,41,72,1683,1543,T1
4918,February 18,2015,Kazakhstan,Moldova,1,1,Friendly,in Turkey,2,-2,1356,1412,0,0,123,108,1354,1414,draw
4919,February 28,2015,Anguilla,British Virgin Islands,1,0,Friendly,in Anguilla,9,-9,567,626,1,-1,232,228,558,635,T1
4920,March 1,2015,Anguilla,British Virgin Islands,3,1,Friendly,in Anguilla,13,-13,580,613,0,-1,232,229,567,626,T1
4921,March 6,2015,Barbados,Saint Vincent and the Grenadines,3,1,Friendly,in Barbados,12,-12,1156,1160,1,-2,169,168,1144,1172,T1
4922,March 6,2015,Bermuda,Grenada,2,2,Friendly,in Bermuda,-4,4,1198,1170,-1,1,161,167,1202,1166,draw
4923,March 8,2015,Antigua and Barbuda,US Virgin Islands,2,0,Friendly,in Antigua and Barbuda,1,-1,1271,678,0,0,138,222,1270,679,T1
4924,March 8,2015,Barbados,Saint Vincent and the Grenadines,2,2,Friendly,in Barbados,-3,3,1153,1163,0,1,169,167,1156,1160,draw
4925,March 8,2015,Bermuda,Grenada,2,0,Friendly,in Bermuda,10,-10,1208,1160,3,-1,158,168,1198,1170,T1
4926,March 12,2015,Cambodia,Macao,3,0,World Cup and Asian Cup qualifier,in Cambodia,18,-18,734,619,2,-2,214,228,716,637,T1
4927,March 12,2015,East Timor,Mongolia,4,1,World Cup and Asian Cup qualifier,in East Timor,34,-34,673,700,0,-3,225,217,639,734,T1
4928,March 12,2015,India,Nepal,2,0,World Cup and Asian Cup qualifier,in India,10,-10,1079,875,1,0,180,204,1069,885,T1
4929,March 12,2015,Sri Lanka,Bhutan,0,1,World Cup and Asian Cup qualifier,in Sri Lanka,-36,36,793,559,-2,1,210,234,829,523,T2
4930,March 12,2015,Taiwan,Brunei,0,1,World Cup and Asian Cup qualifier,in Taiwan,-34,34,761,641,-2,4,213,226,795,607,T2
4931,March 12,2015,Yemen,Pakistan,3,1,World Cup and Asian Cup qualifier,in Qatar,11,-11,1222,933,2,-1,155,198,1211,944,T1
4932,March 15,2015,Antigua and Barbuda,Dominica,1,0,Friendly,in Antigua and Barbuda,2,-2,1273,951,0,0,138,193,1271,953,T1
4933,March 17,2015,Bhutan,Sri Lanka,2,1,World Cup and Asian Cup qualifier,in Bhutan,27,-27,586,766,2,-3,232,213,559,793,T1
4934,March 17,2015,Brunei,Taiwan,0,2,World Cup and Asian Cup qualifier,in Brunei,-28,28,613,789,-3,3,229,210,641,761,T2
4935,March 17,2015,Macao,Cambodia,1,1,World Cup and Asian Cup qualifier,in Macao,1,-1,620,733,1,0,227,214,619,734,draw
4936,March 17,2015,Mongolia,East Timor,0,1,World Cup and Asian Cup qualifier,in Mongolia,-27,27,673,700,-8,8,225,217,700,673,T2
4937,March 17,2015,Nepal,India,0,0,World Cup and Asian Cup qualifier,in Nepal,6,-6,881,1073,0,-1,204,181,875,1079,draw
4938,March 22,2015,Antigua and Barbuda,British Virgin Islands,1,0,Friendly,in Antigua and Barbuda,0,0,1273,613,0,0,138,229,1273,613,T1
4939,March 22,2015,Barbados,US Virgin Islands,0,1,World Cup qualifier,in Barbados,-39,39,1114,717,-5,6,174,216,1153,678,T2
4940,March 22,2015,Guyana,Saint Lucia,2,0,Friendly,in Guyana,8,-8,1230,1126,5,0,150,173,1222,1134,T1
4941,March 23,2015,Nicaragua,Anguilla,5,0,World Cup qualifier,in Nicaragua,2,-2,1106,578,0,0,176,233,1104,580,T1
4942,March 23,2015,Pakistan,Yemen,0,0,World Cup and Asian Cup qualifier,in Bahrain,14,-14,947,1208,3,-1,195,157,933,1222,draw
4943,March 23,2015,Saint Kitts and Nevis,Turks and Caicos,6,2,World Cup qualifier,in Saint Kitts and Nevis,3,-3,1207,774,1,0,159,212,1204,777,T1
4944,March 25,2015,Bahamas,Bermuda,0,5,World Cup qualifier,in the Bahamas,-21,21,911,1229,-1,7,200,150,932,1208,T2
4945,March 25,2015,Belize,Cayman Islands,0,0,World Cup qualifier,in Belize,-14,14,1122,951,-2,5,173,193,1136,937,draw
4946,March 25,2015,Denmark,United States,3,2,Friendly,in Denmark,9,-9,1764,1808,1,0,25,19,1755,1817,T1
4947,March 25,2015,Dominican Republic,Cuba,0,3,Friendly,in the Dominican Republic,-15,15,1222,1412,-10,3,156,108,1237,1397,T2
4948,March 25,2015,French Guiana,Honduras,3,1,CONCACAF Championship qualifier,in French Guiana,43,-43,1317,1496,7,-12,130,84,1274,1539,T1
4949,March 25,2015,Gabon,Mali,4,3,Friendly,in France,12,-12,1490,1542,4,-3,87,70,1478,1554,T1
4950,March 25,2015,Georgia,Malta,2,0,Friendly,in Georgia,4,-4,1474,1235,1,-2,93,146,1470,1239,T1
4951,March 25,2015,Germany,Australia,2,2,Friendly,in Germany,-9,9,2125,1736,0,4,1,30,2134,1727,draw
4952,March 25,2015,Indonesia,Cameroon,0,1,Friendly,in Indonesia,-3,3,1204,1612,-1,0,160,59,1207,1609,T2
4953,March 25,2015,Mauritius,Burundi,2,2,Friendly,in Mauritius,5,-5,1025,1317,0,0,187,130,1020,1322,draw
4954,March 25,2015,Nigeria,Uganda,0,1,Friendly,in Nigeria,-17,17,1658,1498,-3,5,49,83,1675,1481,T2
4955,March 25,2015,Scotland,Northern Ireland,1,0,Friendly,in Scotland,3,-3,1726,1499,0,1,36,82,1723,1502,T1
4956,March 25,2015,Swaziland,South Africa,1,3,Friendly,in Swaziland,-3,3,1137,1604,0,0,170,62,1140,1601,T2
4957,March 26,2015,Bahrain,Colombia,0,6,Friendly,in Bahrain,-3,3,1476,2023,-1,0,92,5,1479,2020,T2
4958,March 26,2015,Costa Rica,Paraguay,0,0,Friendly,in Costa Rica,-7,7,1861,1693,0,1,15,41,1868,1686,draw
4959,March 26,2015,Dominica,British Virgin Islands,3,2,World Cup qualifier,in Dominica,3,-3,954,610,0,-1,193,230,951,613,T1
4960,March 26,2015,Egypt,Equatorial Guinea,2,0,Friendly,in Egypt,4,-4,1620,1384,0,0,58,113,1616,1388,T1
4961,March 26,2015,France,Brazil,1,3,Friendly,in France,-16,16,1950,2058,0,1,7,2,1966,2042,T2
4962,March 26,2015,Iran,Chile,2,0,Friendly,in Austria,24,-24,1747,1943,7,-2,30,8,1723,1967,T1
4963,March 26,2015,Ivory Coast,Angola,2,0,Friendly,in Ivory Coast,3,-3,1750,1435,0,0,29,104,1747,1438,T1
4964,March 26,2015,Jordan,Syria,0,1,Friendly,in Jordan,-13,13,1480,1490,-6,6,91,86,1493,1477,T2
4965,March 26,2015,Maldives,Tajikistan,0,2,Friendly,in the Maldives,-11,11,1053,1273,-4,2,186,138,1064,1262,T2
4966,March 26,2015,Oman,Malaysia,6,0,Friendly,in Oman,4,-4,1529,1221,1,-3,72,156,1525,1225,T1
4967,March 26,2015,Qatar,Algeria,1,0,Friendly,in Qatar,12,-12,1517,1666,5,-1,76,46,1505,1678,T1
4968,March 26,2015,Thailand,Singapore,2,0,Friendly,in Thailand,5,-5,1370,1166,0,0,118,166,1365,1171,T1
4969,March 26,2015,Turks and Caicos,Saint Kitts and Nevis,2,6,World Cup qualifier,in Turks and Caicos,-10,10,764,1217,-1,1,213,158,774,1207,T2
4970,March 26,2015,US Virgin Islands,Barbados,0,4,World Cup qualifier,in the US Virgin Islands,-11,11,706,1125,0,1,216,173,717,1114,T2
4971,March 27,2015,Canada,Guatemala,1,0,Friendly,in the United States,11,-11,1518,1529,5,-1,76,72,1507,1540,T1
4972,March 27,2015,China,Haiti,2,2,Friendly,in China,-6,6,1602,1452,-2,1,62,100,1608,1446,draw
4973,March 27,2015,Curaçao,Montserrat,2,1,World Cup qualifier,in Curaçao,2,-2,1081,616,1,0,179,228,1079,618,T1
4974,March 27,2015,England,Lithuania,4,0,European Championship qualifier,in England,3,-3,1927,1464,0,0,9,95,1924,1467,T1
4975,March 27,2015,Gambia,Mauritania,1,0,Friendly,in The Gambia,4,-4,1338,1192,2,0,126,162,1334,1196,T1
4976,March 27,2015,Jamaica,Venezuela,2,1,Friendly,in Jamaica,12,-12,1534,1675,3,-2,71,44,1522,1687,T1
4977,March 27,2015,Japan,Tunisia,2,0,Friendly,in Japan,5,-5,1762,1566,0,-1,26,66,1757,1571,T1
4978,March 27,2015,Liechtenstein,Austria,0,5,European Championship qualifier,in Liechtenstein,-8,8,1213,1723,-2,0,158,38,1221,1715,T2
4979,March 27,2015,Macedonia,Belarus,1,2,European Championship qualifier,in Macedonia,-22,22,1459,1572,-6,2,96,65,1481,1550,T2
4980,March 27,2015,Moldova,Sweden,0,2,European Championship qualifier,in Moldova,-11,11,1401,1791,-3,1,111,22,1412,1780,T2
4981,March 27,2015,Montenegro,Russia,0,0,European Championship qualifier,in Montenegro,5,-5,1602,1774,1,0,62,24,1597,1779,draw
4982,March 27,2015,Slovakia,Luxembourg,3,0,European Championship qualifier,in Slovakia,2,-2,1753,1223,1,-1,27,154,1751,1225,T1
4983,March 27,2015,Slovenia,San Marino,6,0,European Championship qualifier,in Slovenia,1,-1,1657,889,0,0,51,203,1656,890,T1
4984,March 27,2015,South Korea,Uzbekistan,1,1,Friendly,in South Korea,-5,5,1731,1630,-2,2,33,54,1736,1625,draw
4985,March 27,2015,Spain,Ukraine,1,0,European Championship qualifier,in Spain,8,-8,1962,1816,0,0,6,18,1954,1824,T1
4986,March 27,2015,Switzerland,Estonia,3,0,European Championship qualifier,in Switzerland,5,-5,1798,1455,0,0,21,97,1793,1460,T1
4987,March 27,2015,Trinidad and Tobago,Panama,0,1,Friendly,in Trinidad and Tobago,-8,8,1519,1715,-1,1,74,39,1527,1707,T2
4988,March 28,2015,Andorra,Bosnia and Herzegovina,0,3,European Championship qualifier,in Andorra,-2,2,974,1713,0,0,191,40,976,1711,T2
4989,March 28,2015,Argentina,El Salvador,2,0,Friendly,in the United States,1,-1,2051,1507,0,1,3,80,2050,1508,T1
4990,March 28,2015,Azerbaijan,Malta,2,0,European Championship qualifier,in Azerbaijan,10,-10,1416,1225,2,-6,107,152,1406,1235,T1
4991,March 28,2015,Belgium,Cyprus,5,0,European Championship qualifier,in Belgium,3,-3,1902,1403,0,-1,12,110,1899,1406,T1
4992,March 28,2015,Bulgaria,Italy,2,2,European Championship qualifier,in Bulgaria,10,-10,1616,1876,2,0,58,14,1606,1886,draw
4993,March 28,2015,Croatia,Norway,5,1,European Championship qualifier,in Croatia,11,-11,1837,1616,0,-2,17,58,1826,1627,T1
4994,March 28,2015,Czechia,Latvia,1,1,European Championship qualifier,in Czechia,-17,17,1788,1462,-2,6,22,96,1805,1445,draw
4995,March 28,2015,Hong Kong,Guam,1,0,Friendly,in Hong Kong,1,-1,1154,805,0,0,169,209,1153,806,T1
4996,March 28,2015,Iraq,Democratic Republic of Congo,2,1,Friendly,in the United Arab Emirates,10,-10,1520,1500,5,-2,74,81,1510,1510,T1
4997,March 28,2015,Israel,Wales,0,3,European Championship qualifier,in Israel,-50,50,1635,1671,-11,11,53,46,1685,1621,T2
4998,March 28,2015,Kazakhstan,Iceland,0,3,European Championship qualifier,in Kazakhstan,-16,16,1340,1679,-2,5,125,43,1356,1663,T2
4999,March 28,2015,Mauritius,Togo,1,1,Friendly,in Mauritius,7,-7,1032,1438,0,-1,187,103,1025,1445,draw
5000,March 28,2015,Mexico,Ecuador,1,0,Friendly,in the United States,9,-9,1902,1838,1,0,12,16,1893,1847,T1
5001,March 28,2015,Morocco,Uruguay,0,1,Friendly,in Morocco,-4,4,1540,1913,-1,1,70,10,1544,1909,T2
5002,March 28,2015,Netherlands,Turkey,1,1,European Championship qualifier,in the Netherlands,-17,17,2013,1702,-1,1,5,41,2030,1685,draw
5003,March 28,2015,Senegal,Ghana,2,1,Friendly,in France,13,-13,1659,1739,3,-2,49,30,1646,1752,T1
5004,March 29,2015,Albania,Armenia,2,1,European Championship qualifier,in Albania,13,-13,1591,1537,0,-2,64,70,1578,1550,T1
5005,March 29,2015,Anguilla,Nicaragua,0,3,World Cup qualifier,in Anguilla,-5,5,573,1111,0,1,233,175,578,1106,T2
5006,March 29,2015,Bermuda,Bahamas,3,0,World Cup qualifier,in Bermuda,6,-6,1235,905,2,-1,147,201,1229,911,T1
5007,March 29,2015,Botswana,Mozambique,1,2,Friendly,in Botswana,-11,11,1300,1388,0,1,132,113,1311,1377,T2
5008,March 29,2015,Brazil,Chile,1,0,Friendly,in England,7,-7,2065,1936,0,0,2,8,2058,1943,T1
5009,March 29,2015,Cayman Islands,Belize,1,1,World Cup qualifier,in the Cayman Islands,4,-4,955,1118,1,0,193,174,951,1122,draw
5010,March 29,2015,Dominica,British Virgin Islands,0,0,World Cup qualifier,in Dominica,-17,17,937,627,-5,3,198,227,954,610,draw
5011,March 29,2015,France,Denmark,2,0,Friendly,in France,5,-5,1955,1759,0,-1,7,26,1950,1764,T1
5012,March 29,2015,Georgia,Germany,0,2,European Championship qualifier,in Georgia,-2,2,1472,2127,0,0,92,1,1474,2125,T2
5013,March 29,2015,Guyana,Grenada,2,0,Friendly,in Guyana,8,-8,1238,1152,4,-1,144,169,1230,1160,T1
5014,March 29,2015,Honduras,French Guiana,3,0,CONCACAF Championship qualifier,in Honduras,12,-12,1508,1305,3,-1,81,131,1496,1317,T1
5015,March 29,2015,Hungary,Greece,0,0,European Championship qualifier,in Hungary,-5,5,1653,1678,-2,1,52,44,1658,1673,draw
5016,March 29,2015,Ireland,Poland,1,1,European Championship qualifier,in Ireland,-6,6,1727,1734,-3,2,35,32,1733,1728,draw
5017,March 29,2015,Ivory Coast,Equatorial Guinea,1,1,Friendly,in Ivory Coast,-9,9,1741,1393,-1,1,29,112,1750,1384,draw
5018,March 29,2015,Northern Ireland,Finland,2,1,European Championship qualifier,in Northern Ireland,22,-22,1521,1609,8,-6,74,60,1499,1631,T1
5019,March 29,2015,Portugal,Serbia,2,1,European Championship qualifier,in Portugal,7,-7,1918,1720,1,-2,10,38,1911,1727,T1
5020,March 29,2015,Romania,Faroe Islands,1,0,European Championship qualifier,in Romania,1,-1,1787,1225,0,-1,23,151,1786,1226,T1
5021,March 29,2015,Scotland,Gibraltar,6,1,European Championship qualifier,in Scotland,1,-1,1727,1131,2,0,35,171,1726,1132,T1
5022,March 29,2015,South Africa,Nigeria,1,1,Friendly,in South Africa,-1,1,1603,1659,0,1,61,49,1604,1658,draw
5023,March 29,2015,Tanzania,Malawi,1,1,Friendly,in Tanzania,-3,3,1344,1361,-1,1,124,120,1347,1358,draw
5024,March 29,2015,Zambia,Rwanda,2,0,Friendly,in Zambia,7,-7,1498,1386,1,-2,84,114,1491,1393,T1
5025,March 30,2015,Algeria,Oman,4,1,Friendly,in Qatar,11,-11,1677,1518,2,-7,45,79,1666,1529,T1
5026,March 30,2015,Bahrain,Philippines,2,1,Friendly,in Bahrain,2,-2,1478,1223,1,-2,90,153,1476,1225,T1
5027,March 30,2015,Belarus,Gabon,0,0,Friendly,in Turkey,-2,2,1570,1492,0,-1,65,87,1572,1490,draw
5028,March 30,2015,Colombia,Kuwait,3,1,Friendly,in the United Arab Emirates,1,-1,2024,1465,0,0,4,94,2023,1466,T1
5029,March 30,2015,Indonesia,Myanmar,2,1,Friendly,in Indonesia,4,-4,1208,1058,1,0,159,183,1204,1062,T1
5030,March 30,2015,Jamaica,Cuba,3,0,Friendly,in Jamaica,8,-8,1542,1404,3,0,68,109,1534,1412,T1
5031,March 30,2015,Macedonia,Australia,0,0,Friendly,in Macedonia,5,-5,1464,1731,2,-1,95,32,1459,1736,draw
5032,March 30,2015,Puerto Rico,Canada,0,3,Friendly,in Puerto Rico,-4,4,1057,1522,0,4,184,74,1061,1518,T2
5033,March 30,2015,Qatar,Slovenia,1,0,Friendly,in Qatar,11,-11,1528,1646,6,-1,73,52,1517,1657,T1
5034,March 30,2015,Saudi Arabia,Jordan,2,1,Friendly,in Saudi Arabia,7,-7,1495,1473,2,-1,86,91,1488,1480,T1
5035,March 30,2015,Thailand,Cameroon,2,3,Friendly,in Thailand,-6,6,1364,1618,0,2,118,57,1370,1612,T2
5036,March 31,2015,Argentina,Ecuador,2,1,Friendly,in the United States,5,-5,2056,1833,0,-1,3,17,2051,1838,T1
5037,March 31,2015,Austria,Bosnia and Herzegovina,1,1,Friendly,in Austria,-3,3,1720,1716,0,1,37,39,1723,1713,draw
5038,March 31,2015,China,Tunisia,1,1,Friendly,in China,-4,4,1598,1570,-1,1,63,65,1602,1566,draw
5039,March 31,2015,El Salvador,Guatemala,0,0,Friendly,in the United States,1,-1,1508,1528,1,-2,81,74,1507,1529,draw
5040,March 31,2015,Estonia,Iceland,1,1,Friendly,in Estonia,3,-3,1458,1676,0,-3,98,46,1455,1679,draw
5041,March 31,2015,Ghana,Mali,1,1,Friendly,in France,-5,5,1734,1547,0,0,30,68,1739,1542,draw
5042,March 31,2015,Iraq,Democratic Republic of Congo,1,0,Friendly,in the United Arab Emirates,9,-9,1529,1491,3,-5,73,88,1520,1500,T1
5043,March 31,2015,Israel,Belgium,0,1,European Championship qualifier,in Israel,-11,11,1624,1913,-1,2,54,10,1635,1902,T2
5044,March 31,2015,Italy,England,1,1,Friendly,in Italy,-1,1,1875,1928,0,0,14,9,1876,1927,draw
5045,March 31,2015,Japan,Uzbekistan,5,1,Friendly,in Japan,8,-8,1770,1622,1,-1,24,55,1762,1630,T1
5046,March 31,2015,Liechtenstein,San Marino,1,0,Friendly,in Liechtenstein,2,-2,1215,887,0,0,158,203,1213,889,T1
5047,March 31,2015,Luxembourg,Turkey,1,2,Friendly,in Luxembourg,-2,2,1221,1704,-2,0,155,41,1223,1702,T2
5048,March 31,2015,Mauritania,Niger,2,0,Friendly,in Mauritania,15,-15,1207,1266,1,-4,161,139,1192,1281,T1
5049,March 31,2015,Mexico,Paraguay,1,0,Friendly,in the United States,5,-5,1907,1688,0,0,12,42,1902,1693,T1
5050,March 31,2015,Montserrat,Curaçao,2,2,World Cup qualifier,in Montserrat,16,-16,632,1065,3,-2,226,181,616,1081,draw
5051,March 31,2015,Netherlands,Spain,2,0,Friendly,in the Netherlands,9,-9,2022,1953,0,-1,5,7,2013,1962,T1
5052,March 31,2015,Panama,Costa Rica,2,1,Friendly,in Panama,11,-11,1726,1850,3,0,36,15,1715,1861,T1
5053,March 31,2015,Portugal,Cape Verde,0,2,Friendly,in Portugal,-28,28,1890,1539,-3,9,13,71,1918,1511,T2
5054,March 31,2015,Russia,Kazakhstan,0,0,Friendly,in Russia,-9,9,1765,1349,-1,2,25,123,1774,1340,draw
5055,March 31,2015,Singapore,Guam,2,2,Friendly,in Singapore,-9,9,1157,814,-1,1,167,208,1166,805,draw
5056,March 31,2015,Slovakia,Czechia,1,0,Friendly,in Slovakia,8,-8,1761,1780,1,-1,26,23,1753,1788,T1
5057,March 31,2015,South Korea,New Zealand,1,0,Friendly,in South Korea,3,-3,1734,1516,2,-3,30,80,1731,1519,T1
5058,March 31,2015,Sweden,Iran,3,1,Friendly,in Sweden,9,-9,1800,1738,1,-1,20,29,1791,1747,T1
5059,March 31,2015,Switzerland,United States,1,1,Friendly,in Switzerland,-3,3,1795,1811,-1,1,21,18,1798,1808,draw
5060,March 31,2015,Tajikistan,Syria,2,3,Friendly,in Tajikistan,-7,7,1266,1497,-1,3,139,85,1273,1490,T2
5061,March 31,2015,Ukraine,Latvia,1,1,Friendly,in Ukraine,-9,9,1807,1471,-1,4,19,93,1816,1462,draw
5062,March 31,2015,Venezuela,Peru,1,0,Friendly,in the United States,12,-12,1687,1716,3,-5,43,39,1675,1728,T1
5063,April 15,2015,United States,Mexico,2,0,Friendly,in the United States,15,-15,1826,1892,0,0,18,12,1811,1907,T1
5064,April 30,2015,Suriname,Guyana,1,0,Friendly,in Suriname,7,-7,1242,1231,4,-5,143,149,1235,1238,T1
5065,May 10,2015,Barbados,Saint Kitts and Nevis,1,3,Friendly,in Barbados,-15,15,1110,1232,-2,8,175,149,1125,1217,T2
5066,May 10,2015,Zambia,Malawi,2,0,Friendly,in Zambia,6,-6,1504,1355,0,-2,83,122,1498,1361,T1
5067,May 12,2015,Kazakhstan,Burkina Faso,0,0,Friendly,in Kazakhstan,1,-1,1350,1470,0,-1,123,94,1349,1471,draw
5068,May 12,2015,Saint Lucia,Dominica,1,1,Windward Islands Championship,in Saint Lucia,-10,10,1116,947,-1,3,173,195,1126,937,draw
5069,May 12,2015,Saint Vincent and the Grenadines,Grenada,3,2,Windward Islands Championship,in Saint Lucia,15,-15,1178,1137,2,0,164,169,1163,1152,T1
5070,May 13,2015,Dominican Republic,Cayman Islands,6,0,Friendly,in the Dominican Republic,5,-5,1227,950,4,0,151,193,1222,955,T1
5071,May 14,2015,Dominica,Grenada,2,1,Windward Islands Championship,in Saint Lucia,22,-22,969,1115,3,-3,192,172,947,1137,T1
5072,May 14,2015,Lesotho,South Africa,0,0,Friendly,in Lesotho,6,-6,1246,1597,1,-2,143,63,1240,1603,draw
5073,May 14,2015,Saint Lucia,Saint Vincent and the Grenadines,1,2,Windward Islands Championship,in Saint Lucia,-17,17,1099,1195,-3,1,176,163,1116,1178,T2
5074,May 16,2015,Lesotho,South Africa,1,1,Friendly,in Lesotho,6,-6,1252,1591,1,0,142,63,1246,1597,draw
5075,May 16,2015,Saint Lucia,Grenada,0,2,Windward Islands Championship,in Saint Lucia,-28,28,1071,1143,-4,3,180,169,1099,1115,T2
5076,May 16,2015,Saint Vincent and the Grenadines,Dominica,1,0,Windward Islands Championship,in Saint Lucia,6,-6,1201,963,1,0,162,192,1195,969,T1
5077,May 17,2015,Namibia,Seychelles,0,0,COSAFA Cup,in South Africa,-14,14,1271,993,-3,1,137,189,1285,979,draw
5078,May 17,2015,Vietnam,North Korea,1,1,Friendly,in Vietnam,3,-3,1239,1445,1,0,145,102,1236,1448,draw
5079,May 17,2015,Zimbabwe,Mauritius,2,0,COSAFA Cup,in South Africa,8,-8,1368,1024,2,0,118,187,1360,1032,T1
5080,May 18,2015,Madagascar,Lesotho,2,1,COSAFA Cup,in South Africa,23,-23,1215,1229,6,-8,158,150,1192,1252,T1
5081,May 18,2015,Swaziland,Tanzania,1,0,COSAFA Cup,in South Africa,31,-31,1168,1313,3,-5,167,130,1137,1344,T1
5082,May 19,2015,Namibia,Mauritius,2,0,COSAFA Cup,in South Africa,12,-12,1283,1012,3,0,134,187,1271,1024,T1
5083,May 19,2015,Zimbabwe,Seychelles,1,0,COSAFA Cup,in South Africa,4,-4,1372,989,0,-1,118,190,1368,993,T1
5084,May 20,2015,Curaçao,Suriname,3,2,Friendly,in the Netherlands,15,-15,1080,1227,2,-7,179,150,1065,1242,T1
5085,May 20,2015,Madagascar,Tanzania,2,0,COSAFA Cup,in South Africa,38,-38,1253,1275,16,-6,142,136,1215,1313,T1
5086,May 20,2015,Swaziland,Lesotho,2,0,COSAFA Cup,in South Africa,35,-35,1203,1194,5,-15,162,165,1168,1229,T1
5087,May 20,2015,Thailand,North Korea,0,1,Friendly,in Thailand,-11,11,1353,1456,-3,3,122,99,1364,1445,T2
5088,May 21,2015,Mauritius,Seychelles,1,0,COSAFA Cup,in South Africa,19,-19,1031,970,0,-1,187,191,1012,989,T1
5089,May 21,2015,Namibia,Zimbabwe,4,1,COSAFA Cup,in South Africa,44,-44,1327,1328,5,-9,128,127,1283,1372,T1
5090,May 22,2015,Lesotho,Tanzania,1,0,COSAFA Cup,in South Africa,25,-25,1219,1250,7,-5,158,141,1194,1275,T1
5091,May 22,2015,Madagascar,Swaziland,1,1,COSAFA Cup,in South Africa,-3,3,1250,1206,1,-1,141,163,1253,1203,draw
5092,May 22,2015,South Africa,Malawi,2,1,Friendly,in South Africa,3,-3,1594,1352,0,-1,63,121,1591,1355,T1
5093,May 24,2015,Lebanon,Syria,2,2,Friendly,in Lebanon,-1,1,1414,1498,0,2,108,83,1415,1497,draw
5094,May 24,2015,Namibia,Zambia,0,0,COSAFA Cup,in South Africa,9,-9,1336,1495,2,-2,126,85,1327,1504,draw
5095,May 24,2015,South Africa,Botswana,0,0,COSAFA Cup,in South Africa,-16,16,1578,1316,-1,1,64,131,1594,1300,draw
5096,May 24,2015,Thailand,Vietnam,1,0,World Cup and Asian Cup qualifier,in Thailand,9,-9,1362,1230,2,-5,118,149,1353,1239,T1
5097,May 25,2015,Madagascar,Ghana,2,1,COSAFA Cup,in South Africa,38,-38,1288,1696,7,-11,134,41,1250,1734,T1
5098,May 25,2015,Malawi,Mozambique,2,2,COSAFA Cup,in South Africa,2,-2,1354,1386,0,0,121,113,1352,1388,draw
5099,May 27,2015,South Africa,Malawi,0,0,COSAFA Cup,in South Africa,-15,15,1563,1369,-2,3,66,118,1578,1354,draw
5100,May 27,2015,Zambia,Ghana,3,0,COSAFA Cup,in South Africa,53,-53,1548,1643,17,-11,68,52,1495,1696,T1
5101,May 28,2015,Mozambique,Botswana,2,1,COSAFA Cup,in South Africa,16,-16,1402,1300,2,-1,111,132,1386,1316,T1
5102,May 28,2015,Namibia,Madagascar,3,2,COSAFA Cup,in South Africa,17,-17,1353,1271,4,-3,122,137,1336,1288,T1
5103,May 29,2015,Laos,Afghanistan,0,2,Friendly,in Laos,-9,9,828,1093,0,0,207,177,837,1084,T2
5104,May 29,2015,Malawi,Zambia,1,0,COSAFA Cup,in South Africa,29,-29,1398,1519,5,-10,113,78,1369,1548,T1
5105,May 30,2015,Bahrain,Oman,0,0,Friendly,in Bahrain,-2,2,1476,1520,0,2,90,78,1478,1518,draw
5106,May 30,2015,Bangladesh,Singapore,1,2,Friendly,in Bangladesh,-7,7,949,1164,-1,0,194,168,956,1157,T2
5107,May 30,2015,Jordan,Lebanon,0,0,Friendly,in Jordan,-4,4,1469,1418,-3,1,94,107,1473,1414,draw
5108,May 30,2015,Madagascar,Botswana,2,1,COSAFA Cup,in South Africa,22,-22,1293,1278,5,-3,132,135,1271,1300,T1
5109,May 30,2015,Mexico,Guatemala,3,0,Friendly,in Mexico,2,-2,1894,1526,0,-1,12,75,1892,1528,T1
5110,May 30,2015,Namibia,Mozambique,2,0,COSAFA Cup,in South Africa,34,-34,1387,1368,8,-8,114,119,1353,1402,T1
5111,May 31,2015,Honduras,El Salvador,2,0,Friendly,in the United States,15,-15,1523,1493,6,-4,76,86,1508,1508,T1
5112,May 31,2015,Northern Ireland,Qatar,1,1,Friendly,in England,0,0,1521,1528,-1,0,78,74,1521,1528,draw
5113,June 2,2015,Bangladesh,Afghanistan,1,1,Friendly,in Bangladesh,1,-1,950,1092,1,0,193,177,949,1093,draw
5114,June 2,2015,Cambodia,Laos,1,1,Friendly,in Cambodia,0,0,733,828,0,0,214,207,733,828,draw
5115,June 3,2015,Panama,Ecuador,1,1,Friendly,in Panama,0,0,1726,1833,0,0,35,17,1726,1833,draw
5116,June 3,2015,Peru,Mexico,1,1,Friendly,in Peru,2,-2,1718,1892,0,0,38,12,1716,1894,draw
5117,June 4,2015,Ireland,Northern Ireland,0,0,Friendly,in Ireland,-7,7,1720,1528,-2,4,35,74,1727,1521,draw
5118,June 5,2015,Bermuda,Puerto Rico,1,1,Friendly,in Bermuda,-7,7,1228,1064,-4,2,149,182,1235,1057,draw
5119,June 5,2015,Cambodia,Myanmar,1,0,Friendly,in Thailand,17,-17,750,1041,0,-3,214,186,733,1058,T1
5120,June 5,2015,Chile,El Salvador,1,0,Friendly,in Chile,1,-1,1937,1492,0,0,8,86,1936,1493,T1
5121,June 5,2015,Curaçao,Trinidad and Tobago,1,0,Friendly,in Curaçao,18,-18,1098,1501,2,-3,177,83,1080,1519,T1
5122,June 5,2015,Hungary,Lithuania,4,0,Friendly,in Hungary,6,-6,1659,1458,2,-1,48,97,1653,1464,T1
5123,June 5,2015,Jordan,Kuwait,2,2,Friendly,in Turkey,0,0,1469,1465,0,0,94,95,1469,1465,draw
5124,June 5,2015,Netherlands,United States,3,4,Friendly,in the Netherlands,-17,17,2005,1843,0,2,5,16,2022,1826,T2
5125,June 5,2015,Oman,Syria,1,2,Friendly,in Oman,-13,13,1507,1511,-3,2,82,81,1520,1498,T2
5126,June 5,2015,Scotland,Qatar,1,0,Friendly,in Scotland,3,-3,1730,1525,0,-2,33,76,1727,1528,T1
5127,June 5,2015,Thailand,Bahrain,1,1,Friendly,in Thailand,0,0,1362,1476,0,0,120,90,1362,1476,draw
5128,June 6,2015,Andorra,Equatorial Guinea,0,1,Friendly,in Andorra,-3,3,971,1396,0,0,190,113,974,1393,T2
5129,June 6,2015,Argentina,Bolivia,5,0,Friendly tournament,in Argentina,3,-3,2059,1625,0,0,3,53,2056,1628,T1
5130,June 6,2015,Cameroon,Burkina Faso,3,2,Friendly,in France,6,-6,1624,1464,3,-2,54,95,1618,1470,T1
5131,June 6,2015,Chad,Guinea,2,1,Friendly,in France,17,-17,1264,1541,2,-2,141,69,1247,1558,T1
5132,June 6,2015,Colombia,Costa Rica,1,0,Friendly,in Argentina,5,-5,2029,1845,0,0,4,15,2024,1850,T1
5133,June 6,2015,Ecuador,Panama,4,0,Friendly,in Ecuador,9,-9,1842,1717,1,-4,17,38,1833,1726,T1
5134,June 6,2015,Libya,Mali,2,2,Friendly,in Morocco,2,-2,1485,1545,1,1,88,67,1483,1547,draw
5135,June 6,2015,Malaysia,Hong Kong,0,0,Friendly,in Malaysia,-4,4,1217,1158,-2,0,158,169,1221,1154,draw
5136,June 6,2015,Niger,Gabon,2,1,Friendly,in Niger,13,-13,1279,1479,4,-3,135,89,1266,1492,T1
5137,June 6,2015,Paraguay,Honduras,2,2,Friendly,in Paraguay,-6,6,1682,1529,-1,4,42,73,1688,1523,draw
5138,June 6,2015,Rwanda,Kenya,0,0,Friendly tournament,in Rwanda,-5,5,1381,1379,0,1,115,116,1386,1374,draw
5139,June 6,2015,Singapore,Brunei,5,1,Friendly,in Singapore,1,-1,1165,612,0,0,168,230,1164,613,T1
5140,June 6,2015,Uruguay,Guatemala,5,1,Friendly,in Uruguay,2,-2,1915,1524,0,-2,10,77,1913,1526,T1
5141,June 7,2015,Brazil,Mexico,2,0,Friendly,in Brazil,5,-5,2070,1887,0,-1,2,13,2065,1892,T1
5142,June 7,2015,Croatia,Gibraltar,4,0,Friendly,in Croatia,0,0,1837,1131,0,-1,18,172,1837,1131,T1
5143,June 7,2015,Ethiopia,Zambia,0,1,Friendly,in Ethiopia,-8,8,1339,1527,0,3,124,76,1347,1519,T2
5144,June 7,2015,France,Belgium,3,4,Friendly,in France,-14,14,1941,1927,-1,2,7,9,1955,1913,T2
5145,June 7,2015,Ireland,England,0,0,Friendly,in Ireland,3,-3,1723,1925,-1,-1,35,10,1720,1928,draw
5146,June 7,2015,Kenya,South Sudan,2,0,Friendly tournament,in Rwanda,6,-6,1385,1058,1,-1,115,183,1379,1064,T1
5147,June 7,2015,Nicaragua,Suriname,1,0,World Cup qualifier,in Nicaragua,21,-21,1132,1206,2,-12,171,162,1111,1227,T1
5148,June 7,2015,Russia,Belarus,4,2,Friendly,in Russia,5,-5,1770,1565,1,-1,24,65,1765,1570,T1
5149,June 7,2015,Serbia,Azerbaijan,4,1,Friendly,in Austria,5,-5,1725,1411,0,0,34,108,1720,1416,T1
5150,June 8,2015,Denmark,Montenegro,2,1,Friendly,in Denmark,4,-4,1763,1598,1,0,26,61,1759,1602,T1
5151,June 8,2015,Egypt,Malawi,2,1,Friendly,in Egypt,3,-3,1623,1395,1,-1,56,113,1620,1398,T1
5152,June 8,2015,Ghana,Togo,1,0,Friendly,in Ghana,3,-3,1646,1435,1,0,51,103,1643,1438,T1
5153,June 8,2015,Malta,Lithuania,2,0,Friendly,in Malta,20,-20,1245,1438,8,-5,144,102,1225,1458,T1
5154,June 8,2015,Norway,Sweden,0,0,Friendly,in Norway,2,-2,1618,1798,0,0,58,20,1616,1800,draw
5155,June 8,2015,Turkey,Bulgaria,4,0,Friendly,in Turkey,9,-9,1713,1607,0,-2,40,60,1704,1616,T1
5156,June 9,2015,Cameroon,Democratic Republic of Congo,1,1,Friendly,in Belgium,-4,4,1620,1495,-3,3,57,84,1624,1491,draw
5157,June 9,2015,Finland,Estonia,0,2,Friendly,in Finland,-24,24,1585,1482,-4,8,63,89,1609,1458,T2
5158,June 9,2015,Luxembourg,Moldova,0,0,Friendly,in Luxembourg,2,-2,1223,1399,1,0,154,111,1221,1401,draw
5159,June 9,2015,Uganda,Gambia,1,1,Friendly,in Uganda,-6,6,1492,1344,-2,1,86,124,1498,1338,draw
5160,June 9,2015,Ukraine,Georgia,2,1,Friendly,in Austria,3,-3,1810,1469,0,-2,19,93,1807,1472,T1
5161,June 10,2015,Antigua and Barbuda,Saint Lucia,1,3,World Cup qualifier,in Antigua and Barbuda,-51,51,1222,1122,-17,7,155,174,1273,1071,T2
5162,June 10,2015,Aruba,Barbados,0,2,World Cup qualifier,in Aruba,-25,25,924,1135,-4,3,199,171,949,1110,T2
5163,June 10,2015,Brazil,Honduras,1,0,Friendly,in Brazil,0,0,2070,1529,0,0,2,73,2070,1529,T1
5164,June 10,2015,Curaçao,Cuba,0,0,World Cup qualifier,in Curaçao,11,-11,1109,1393,1,-4,176,113,1098,1404,draw
5165,June 10,2015,Germany,United States,1,2,Friendly,in Germany,-18,18,2109,1861,0,1,1,15,2127,1843,T2
5166,June 10,2015,Saint Vincent and the Grenadines,Guyana,2,2,World Cup qualifier,in Saint Vincent and the Grenadines,-4,4,1197,1235,-1,3,165,145,1201,1231,draw
5167,June 10,2015,Switzerland,Liechtenstein,3,0,Friendly,in Switzerland,1,-1,1796,1214,0,0,21,158,1795,1215,T1
5168,June 11,2015,Bangladesh,Kyrgyzstan,1,3,World Cup and Asian Cup qualifier,in Bangladesh,-26,26,924,1125,-5,3,198,175,950,1099,T2
5169,June 11,2015,Cambodia,Singapore,0,4,World Cup and Asian Cup qualifier,in Cambodia,-11,11,739,1176,0,2,214,166,750,1165,T2
5170,June 11,2015,Chile,Ecuador,2,0,Copa América,in Chile,18,-18,1955,1824,1,-1,7,18,1937,1842,T1
5171,June 11,2015,Dominica,Canada,0,2,World Cup qualifier,in Dominica,-4,4,959,1526,0,2,192,77,963,1522,T2
5172,June 11,2015,Dominican Republic,Belize,1,2,World Cup qualifier,in the Dominican Republic,-31,31,1196,1149,-15,5,165,170,1227,1118,T2
5173,June 11,2015,Guam,Turkmenistan,1,0,World Cup and Asian Cup qualifier,in Guam,35,-35,849,1227,1,-9,207,150,814,1262,T1
5174,June 11,2015,Hong Kong,Bhutan,7,0,World Cup and Asian Cup qualifier,in Hong Kong,2,-2,1160,584,0,0,169,232,1158,586,T1
5175,June 11,2015,India,Oman,1,2,World Cup and Asian Cup qualifier,in India,-5,5,1068,1512,0,0,181,82,1073,1507,T2
5176,June 11,2015,Japan,Iraq,4,0,Friendly,in Japan,5,-5,1775,1524,0,-5,24,78,1770,1529,T1
5177,June 11,2015,Laos,Myanmar,2,2,World Cup and Asian Cup qualifier,in Laos,6,-6,834,1035,-1,0,208,186,828,1041,draw
5178,June 11,2015,Lebanon,Kuwait,0,1,World Cup and Asian Cup qualifier,in Lebanon,-23,23,1395,1488,-4,7,111,88,1418,1465,T2
5179,June 11,2015,Malaysia,East Timor,1,1,World Cup and Asian Cup qualifier,in Malaysia,-19,19,1198,719,-6,2,163,216,1217,700,draw
5180,June 11,2015,Maldives,Qatar,0,1,World Cup and Asian Cup qualifier,in the Maldives,-4,4,1049,1529,0,4,185,73,1053,1525,T2
5181,June 11,2015,North Korea,Yemen,1,0,World Cup and Asian Cup qualifier,in Qatar,8,-8,1464,1200,3,-2,95,161,1456,1208,T1
5182,June 11,2015,Philippines,Bahrain,2,1,World Cup and Asian Cup qualifier,in the Philippines,28,-28,1251,1448,13,-10,140,101,1223,1476,T1
5183,June 11,2015,Saudi Arabia,Palestine,3,2,World Cup and Asian Cup qualifier,in Saudi Arabia,5,-5,1500,1263,0,-1,84,139,1495,1268,T1
5184,June 11,2015,South Korea,United Arab Emirates,3,0,Friendly,in Malaysia,14,-14,1748,1652,2,-3,28,50,1734,1666,T1
5185,June 11,2015,Spain,Costa Rica,2,1,Friendly,in Spain,5,-5,1958,1840,0,0,6,16,1953,1845,T1
5186,June 11,2015,Saint Kitts and Nevis,El Salvador,2,2,World Cup qualifier,in Saint Kitts and Nevis,9,-9,1241,1483,3,-4,144,90,1232,1492,draw
5187,June 11,2015,Syria,Afghanistan,6,0,World Cup and Asian Cup qualifier,in Iran,7,-7,1518,1085,1,0,80,179,1511,1092,T1
5188,June 11,2015,Tajikistan,Jordan,1,3,World Cup and Asian Cup qualifier,in Tajikistan,-21,21,1245,1490,-3,6,142,87,1266,1469,T2
5189,June 11,2015,Uzbekistan,Iran,0,1,Friendly,in Uzbekistan,-10,10,1612,1748,-2,1,58,28,1622,1738,T2
5190,June 12,2015,Andorra,Cyprus,1,3,European Championship qualifier,in Andorra,-8,8,963,1411,-1,0,191,108,971,1403,T2
5191,June 12,2015,Bolivia,Mexico,0,0,Copa América,in Chile,16,-16,1641,1871,0,-1,53,14,1625,1887,draw
5192,June 12,2015,Bosnia and Herzegovina,Israel,3,1,European Championship qualifier,in Bosnia and Herzegovina,15,-15,1731,1609,7,-4,32,58,1716,1624,T1
5193,June 12,2015,Croatia,Italy,1,1,European Championship qualifier,in Croatia,-4,4,1833,1879,0,1,17,13,1837,1875,draw
5194,June 12,2015,Guatemala,Bermuda,0,0,World Cup qualifier,in Guatemala,-16,16,1508,1244,-3,6,81,143,1524,1228,draw
5195,June 12,2015,Iceland,Czechia,2,1,European Championship qualifier,in Iceland,20,-20,1696,1760,3,-4,42,27,1676,1780,T1
5196,June 12,2015,Kazakhstan,Turkey,0,1,European Championship qualifier,in Kazakhstan,-7,7,1343,1720,-1,3,124,37,1350,1713,T2
5197,June 12,2015,Latvia,Netherlands,0,2,European Championship qualifier,in Latvia,-5,5,1466,2010,-1,0,94,5,1471,2005,T2
5198,June 12,2015,Malta,Bulgaria,0,1,European Championship qualifier,in Malta,-7,7,1238,1614,-4,3,146,56,1245,1607,T2
5199,June 12,2015,Morocco,Libya,1,0,African Nations Cup qualifier,in Morocco,12,-12,1552,1473,3,-3,67,92,1540,1485,T1
5200,June 12,2015,Norway,Azerbaijan,0,0,European Championship qualifier,in Norway,-14,14,1604,1425,-2,1,59,106,1618,1411,draw
5201,June 12,2015,Puerto Rico,Grenada,1,0,World Cup qualifier,in Puerto Rico,19,-19,1083,1124,2,-4,180,175,1064,1143,T1
5202,June 12,2015,Swaziland,Guinea,2,1,African Nations Cup qualifier,in Morocco,35,-35,1241,1506,15,-13,144,82,1206,1541,T1
5203,June 12,2015,Tunisia,Djibouti,8,1,African Nations Cup qualifier,in Tunisia,1,-1,1571,787,0,0,64,211,1570,788,T1
5204,June 12,2015,Wales,Belgium,1,0,European Championship qualifier,in Wales,28,-28,1699,1899,5,-2,41,11,1671,1927,T1
5205,June 13,2015,Albania,France,1,0,Friendly,in Albania,16,-16,1607,1925,3,0,59,8,1591,1941,T1
5206,June 13,2015,Algeria,Seychelles,4,0,African Nations Cup qualifier,in Algeria,1,-1,1678,969,0,0,46,190,1677,970,T1
5207,June 13,2015,Angola,Central African Republic,4,0,African Nations Cup qualifier,in Angola,11,-11,1446,1227,1,-5,102,151,1435,1238,T1
5208,June 13,2015,Argentina,Paraguay,2,2,Copa América,in Chile,-20,20,2039,1702,0,3,3,41,2059,1682,draw
5209,June 13,2015,Armenia,Portugal,2,3,European Championship qualifier,in Armenia,-8,8,1529,1898,-1,0,72,12,1537,1890,T2
5210,June 13,2015,Burkina Faso,Comoros,2,0,African Nations Cup qualifier,in Burkina Faso,1,-1,1465,894,1,0,94,202,1464,895,T1
5211,June 13,2015,Cape Verde,São Tomé and Príncipe,7,1,African Nations Cup qualifier,in Cape Verde,3,-3,1542,1078,1,0,69,181,1539,1081,T1
5212,June 13,2015,Denmark,Serbia,2,0,European Championship qualifier,in Denmark,19,-19,1782,1706,3,-5,22,40,1763,1725,T1
5213,June 13,2015,Faroe Islands,Greece,2,1,European Championship qualifier,in the Faroe Islands,35,-35,1260,1643,13,-7,140,52,1225,1678,T1
5214,June 13,2015,Finland,Hungary,0,1,European Championship qualifier,in Finland,-21,21,1564,1680,-2,2,65,45,1585,1659,T2
5215,June 13,2015,Germany,Gibraltar,7,0,European Championship qualifier,in Portugal,0,0,2109,1131,0,0,1,173,2109,1131,T1
5216,June 13,2015,Ireland,Scotland,1,1,European Championship qualifier,in Ireland,-5,5,1718,1735,-1,2,37,32,1723,1730,draw
5217,June 13,2015,Malawi,Zimbabwe,1,2,African Nations Cup qualifier,in Malawi,-29,29,1366,1357,-8,4,119,124,1395,1328,T2
5218,June 13,2015,Mali,South Sudan,2,0,African Nations Cup qualifier,in Mali,2,-2,1547,1056,0,0,68,183,1545,1058,T1
5219,June 13,2015,Nigeria,Chad,2,0,African Nations Cup qualifier,in Nigeria,3,-3,1662,1261,-1,-1,48,139,1659,1264,T1
5220,June 13,2015,Northern Ireland,Romania,0,0,European Championship qualifier,in Northern Ireland,9,-9,1537,1778,4,-1,70,23,1528,1787,draw
5221,June 13,2015,Poland,Georgia,4,0,European Championship qualifier,in Poland,8,-8,1742,1461,1,-4,30,97,1734,1469,T1
5222,June 13,2015,Senegal,Burundi,3,1,African Nations Cup qualifier,in Senegal,4,-4,1663,1313,0,0,47,130,1659,1317,T1
5223,June 13,2015,South Africa,Gambia,0,0,African Nations Cup qualifier,in South Africa,-15,15,1548,1359,-1,1,67,122,1563,1344,draw
5224,June 13,2015,Uganda,Botswana,2,0,African Nations Cup qualifier,in Uganda,8,-8,1500,1270,2,-1,84,137,1492,1278,T1
5225,June 13,2015,Uruguay,Jamaica,1,0,Copa América,in Chile,5,-5,1920,1537,0,-1,10,70,1915,1542,T1
5226,June 13,2015,Zambia,Guinea-Bissau,0,0,African Nations Cup qualifier,in Zambia,-16,16,1511,1250,-5,7,80,142,1527,1234,draw
5227,June 14,2015,Antigua and Barbuda,Saint Lucia,4,1,World Cup qualifier,in Antigua and Barbuda,17,-17,1239,1105,7,-2,148,178,1222,1122,T1
5228,June 14,2015,Barbados,Aruba,1,0,World Cup qualifier,in Barbados,6,-6,1141,918,0,-1,171,199,1135,924,T1
5229,June 14,2015,Belarus,Spain,0,1,European Championship qualifier,in Belarus,-6,6,1559,1964,-1,0,65,6,1565,1958,T2
5230,June 14,2015,Belize,Dominican Republic,3,0,World Cup qualifier,in Belize,30,-30,1179,1166,5,-4,165,169,1149,1196,T1
5231,June 14,2015,Brazil,Peru,2,1,Copa América,in Chile,6,-6,2076,1712,0,-3,2,40,2070,1718,T1
5232,June 14,2015,Cameroon,Mauritania,1,0,African Nations Cup qualifier,in Cameroon,2,-2,1622,1205,0,-1,55,160,1620,1207,T1
5233,June 14,2015,Congo,Kenya,1,1,African Nations Cup qualifier,in Congo,-9,9,1444,1394,-3,3,102,111,1453,1385,draw
5234,June 14,2015,Cuba,Curaçao,1,1,World Cup qualifier,in Cuba,-16,16,1377,1125,-3,3,115,174,1393,1109,draw
5235,June 14,2015,Democratic Republic of Congo,Madagascar,2,1,African Nations Cup qualifier,in the Democratic Republic of the Congo,6,-6,1501,1287,3,-1,83,133,1495,1293,T1
5236,June 14,2015,Egypt,Tanzania,3,0,African Nations Cup qualifier,in Egypt,4,-4,1627,1246,0,-1,54,143,1623,1250,T1
5237,June 14,2015,Equatorial Guinea,Benin,1,1,African Nations Cup qualifier,in Equatorial Guinea,-7,7,1389,1380,-3,3,113,114,1396,1373,draw
5238,June 14,2015,Estonia,San Marino,2,0,European Championship qualifier,in Estonia,1,-1,1483,886,1,0,89,203,1482,887,T1
5239,June 14,2015,Ethiopia,Lesotho,2,1,African Nations Cup qualifier,in Ethiopia,9,-9,1348,1210,1,-1,125,157,1339,1219,T1
5240,June 14,2015,Gabon,Ivory Coast,0,0,Friendly,in Gabon,4,-4,1483,1737,2,-1,89,32,1479,1741,draw
5241,June 14,2015,Ghana,Mauritius,7,1,African Nations Cup qualifier,in Ghana,1,-1,1647,1030,0,0,50,187,1646,1031,T1
5242,June 14,2015,Guyana,Saint Vincent and the Grenadines,4,4,World Cup qualifier,in Guyana,-8,8,1227,1205,-2,4,151,160,1235,1197,draw
5243,June 14,2015,Liechtenstein,Moldova,1,1,European Championship qualifier,in Liechtenstein,5,-5,1219,1394,1,-2,156,111,1214,1399,draw
5244,June 14,2015,Lithuania,Switzerland,1,2,European Championship qualifier,in Lithuania,-7,7,1431,1803,-1,0,104,21,1438,1796,T2
5245,June 14,2015,Mozambique,Rwanda,0,1,African Nations Cup qualifier,in Mozambique,-25,25,1343,1406,-8,6,126,109,1368,1381,T2
5246,June 14,2015,Niger,Namibia,1,0,African Nations Cup qualifier,in Niger,20,-20,1299,1367,3,-4,132,117,1279,1387,T1
5247,June 14,2015,Russia,Austria,0,1,European Championship qualifier,in Russia,-28,28,1742,1748,-5,8,30,27,1770,1720,T2
5248,June 14,2015,Slovakia,Macedonia,2,1,European Championship qualifier,in Slovakia,4,-4,1765,1460,1,-2,25,97,1761,1464,T1
5249,June 14,2015,Slovenia,England,2,3,European Championship qualifier,in Slovenia,-11,11,1635,1936,-3,0,53,8,1646,1925,T2
5250,June 14,2015,Sudan,Sierra Leone,1,0,African Nations Cup qualifier,in Sudan,15,-15,1350,1323,4,-2,124,129,1335,1338,T1
5251,June 14,2015,Sweden,Montenegro,3,1,European Championship qualifier,in Sweden,9,-9,1807,1589,0,-1,20,62,1798,1598,T1
5252,June 14,2015,Togo,Liberia,2,1,African Nations Cup qualifier,in Togo,8,-8,1443,1284,1,-1,103,134,1435,1292,T1
5253,June 14,2015,Ukraine,Luxembourg,3,0,European Championship qualifier,in Ukraine,1,-1,1811,1222,0,-1,19,155,1810,1223,T1
5254,June 14,2015,Venezuela,Colombia,1,0,Copa América,in Chile,44,-44,1731,1985,10,-1,34,5,1687,2029,T1
5255,June 15,2015,Bermuda,Guatemala,0,1,World Cup qualifier,in Bermuda,-11,11,1233,1519,-4,4,149,77,1244,1508,T2
5256,June 15,2015,Bolivia,Ecuador,3,2,Copa América,in Chile,37,-37,1678,1787,6,-3,46,21,1641,1824,T1
5257,June 15,2015,Chile,Mexico,3,3,Copa América,in Chile,-12,12,1943,1883,0,1,7,13,1955,1871,draw
5258,June 16,2015,Argentina,Uruguay,1,0,Copa América,in Chile,17,-17,2056,1903,0,-1,3,11,2039,1920,T1
5259,June 16,2015,Bangladesh,Tajikistan,1,1,World Cup and Asian Cup qualifier,in Bangladesh,11,-11,935,1234,1,-4,197,148,924,1245,draw
5260,June 16,2015,Bhutan,China,0,6,World Cup and Asian Cup qualifier,in Bhutan,0,0,584,1598,0,1,232,60,584,1598,T2
5261,June 16,2015,Cambodia,Afghanistan,0,1,World Cup and Asian Cup qualifier,in Cambodia,-8,8,731,1093,0,0,214,179,739,1085,T2
5262,June 16,2015,Canada,Dominica,4,0,World Cup qualifier,in Canada,2,-2,1528,957,1,0,74,192,1526,959,T1
5263,June 16,2015,East Timor,United Arab Emirates,0,1,World Cup and Asian Cup qualifier,in East Timor,0,0,719,1652,0,0,216,50,719,1652,T2
5264,June 16,2015,El Salvador,Saint Kitts and Nevis,4,1,World Cup qualifier,in El Salvador,9,-9,1492,1232,1,-5,88,150,1483,1241,T1
5265,June 16,2015,Grenada,Puerto Rico,2,0,World Cup qualifier,in Grenada,18,-18,1142,1065,4,-1,172,181,1124,1083,T1
5266,June 16,2015,Guam,India,2,1,World Cup and Asian Cup qualifier,in Guam,27,-27,876,1041,2,-2,205,184,849,1068,T1
5267,June 16,2015,Hong Kong,Maldives,2,0,World Cup and Asian Cup qualifier,in Hong Kong,14,-14,1174,1035,4,0,166,185,1160,1049,T1
5268,June 16,2015,Japan,Singapore,0,0,World Cup and Asian Cup qualifier,in Japan,-19,19,1756,1195,-2,4,26,162,1775,1176,draw
5269,June 16,2015,Jordan,Trinidad and Tobago,3,0,Friendly,in Jordan,13,-13,1503,1488,4,-6,83,89,1490,1501,T1
5270,June 16,2015,Kyrgyzstan,Australia,1,2,World Cup and Asian Cup qualifier,in Kyrgyzstan,-2,2,1123,1733,-2,1,176,33,1125,1731,T2
5271,June 16,2015,Laos,Lebanon,0,2,World Cup and Asian Cup qualifier,in Laos,-4,4,830,1399,0,0,208,110,834,1395,T2
5272,June 16,2015,Malaysia,Palestine,0,6,World Cup and Asian Cup qualifier,in Malaysia,-47,47,1151,1310,-7,7,171,131,1198,1263,T2
5273,June 16,2015,North Korea,Uzbekistan,4,2,World Cup and Asian Cup qualifier,in North Korea,34,-34,1498,1578,8,-5,87,62,1464,1612,T1
5274,June 16,2015,Paraguay,Jamaica,1,0,Copa América,in Chile,14,-14,1716,1523,2,-6,40,76,1702,1537,T1
5275,June 16,2015,Philippines,Yemen,2,0,World Cup and Asian Cup qualifier,in Qatar,26,-26,1277,1174,4,-4,137,166,1251,1200,T1
5276,June 16,2015,Poland,Greece,0,0,Friendly,in Poland,-5,5,1737,1648,0,1,30,51,1742,1643,draw
5277,June 16,2015,Portugal,Italy,1,0,Friendly,in Switzerland,9,-9,1907,1870,2,0,10,14,1898,1879,T1
5278,June 16,2015,South Africa,Angola,2,1,Friendly,in South Africa,5,-5,1553,1441,1,-2,66,103,1548,1446,T1
5279,June 16,2015,South Korea,Myanmar,2,0,World Cup and Asian Cup qualifier,in Thailand,1,-1,1749,1034,0,0,27,186,1748,1035,T1
5280,June 16,2015,Suriname,Nicaragua,1,3,World Cup qualifier,in Suriname,-44,44,1162,1176,-11,8,170,164,1206,1132,T2
5281,June 16,2015,Taiwan,Thailand,0,2,World Cup and Asian Cup qualifier,in Taiwan,-4,4,785,1366,-1,1,211,118,789,1362,T2
5282,June 16,2015,Turkmenistan,Iran,1,1,World Cup and Asian Cup qualifier,in Turkmenistan,17,-17,1244,1731,7,-7,144,34,1227,1748,draw
5283,June 17,2015,Colombia,Brazil,1,0,Copa América,in Chile,31,-31,2016,2045,1,-1,4,3,1985,2076,T1
5284,June 18,2015,Peru,Venezuela,1,0,Copa América,in Chile,26,-26,1738,1705,11,-8,30,42,1712,1731,T1
5285,June 19,2015,Chile,Bolivia,5,0,Copa América,in Chile,11,-11,1954,1667,0,-1,7,47,1943,1678,T1
5286,June 19,2015,Ecuador,Mexico,2,1,Copa América,in Chile,32,-32,1819,1851,3,-2,18,15,1787,1883,T1
5287,June 20,2015,Argentina,Jamaica,1,0,Copa América,in Chile,2,-2,2058,1521,0,0,2,76,2056,1523,T1
5288,June 20,2015,Paraguay,Uruguay,1,1,Copa América,in Chile,12,-12,1728,1891,3,-1,37,12,1716,1903,draw
5289,June 21,2015,Brazil,Venezuela,2,1,Copa América,in Chile,6,-6,2051,1699,0,0,3,42,2045,1705,T1
5290,June 21,2015,Colombia,Peru,0,0,Copa América,in Chile,-17,17,1999,1755,-1,3,5,27,2016,1738,draw
5291,June 24,2015,Chile,Uruguay,1,0,Copa América,in Chile,14,-14,1968,1877,1,0,6,12,1954,1891,T1
5292,June 25,2015,Peru,Bolivia,3,1,Copa América,in Chile,28,-28,1783,1639,5,-5,22,52,1755,1667,T1
5293,June 26,2015,Argentina,Colombia,0,0,Copa América,in Chile,-4,4,2054,2003,0,0,2,5,2058,1999,draw
5294,June 27,2015,Brazil,Paraguay,1,1,Copa América,in Chile,-18,18,2033,1746,0,7,3,30,2051,1728,draw
5295,June 27,2015,Costa Rica,Mexico,2,2,Friendly,in the United States,0,0,1840,1851,0,0,16,15,1840,1851,draw
5296,June 29,2015,Chile,Peru,2,1,Copa América,in Chile,8,-8,1976,1775,0,-2,6,24,1968,1783,T1
5297,June 30,2015,Argentina,Paraguay,6,1,Copa América,in Chile,15,-15,2069,1731,0,-5,2,35,2054,1746,T1
5298,July 1,2015,Honduras,Mexico,0,0,Friendly,in the United States,7,-7,1536,1844,0,0,71,15,1529,1851,draw
5299,July 3,2015,Peru,Paraguay,2,0,Copa América,in Chile,33,-33,1808,1698,4,-8,20,43,1775,1731,T1
5300,July 3,2015,Trinidad and Tobago,Haiti,1,0,Friendly,in the United States,9,-9,1497,1443,1,-2,88,101,1488,1452,T1
5301,July 3,2015,United States,Guatemala,4,0,Friendly,in the United States,3,-3,1864,1516,0,-1,14,78,1861,1519,T1
5302,July 4,2015,Chile,Argentina,0,0,Copa América,in Chile,-1,1,1975,2070,0,0,6,2,1976,2069,draw
5303,July 6,2015,Malawi,Uganda,1,0,Friendly,in Malawi,11,-11,1377,1489,3,-4,115,89,1366,1500,T1
5304,July 7,2015,Haiti,Panama,1,1,CONCACAF Championship,in the United States,16,-16,1459,1701,3,-1,98,40,1443,1717,draw
5305,July 7,2015,United States,Honduras,2,1,CONCACAF Championship,in the United States,4,-4,1868,1532,0,0,14,71,1864,1536,T1
5306,July 8,2015,Canada,El Salvador,0,0,CONCACAF Championship,in the United States,-3,3,1525,1495,-1,0,75,88,1528,1492,draw
5307,July 8,2015,Costa Rica,Jamaica,2,2,CONCACAF Championship,in the United States,-18,18,1822,1539,-1,6,17,70,1840,1521,draw
5308,July 9,2015,Mexico,Cuba,6,0,CONCACAF Championship,in the United States,7,-7,1851,1370,0,-2,15,117,1844,1377,T1
5309,July 9,2015,Trinidad and Tobago,Guatemala,3,1,CONCACAF Championship,in the United States,40,-40,1537,1476,16,-14,71,92,1497,1516,T1
5310,July 10,2015,Honduras,Panama,1,1,CONCACAF Championship,in the United States,11,-11,1543,1690,4,-4,69,44,1532,1701,draw
5311,July 10,2015,United States,Haiti,1,0,CONCACAF Championship,in the United States,3,-3,1871,1456,1,0,13,98,1868,1459,T1
5312,July 11,2015,Costa Rica,El Salvador,1,1,CONCACAF Championship,in the United States,-18,18,1804,1513,-4,8,21,79,1822,1495,draw
5313,July 11,2015,Jamaica,Canada,1,0,CONCACAF Championship,in the United States,24,-24,1563,1501,6,-8,65,84,1539,1525,T1
5314,July 12,2015,Guatemala,Mexico,0,0,CONCACAF Championship,in the United States,20,-20,1496,1831,4,-1,88,16,1476,1851,draw
5315,July 12,2015,Trinidad and Tobago,Cuba,2,0,CONCACAF Championship,in the United States,21,-21,1558,1349,5,-7,67,124,1537,1370,T1
5316,July 13,2015,Haiti,Honduras,1,0,CONCACAF Championship,in the United States,31,-31,1487,1512,7,-8,91,79,1456,1543,T1
5317,July 13,2015,United States,Panama,1,1,CONCACAF Championship,in the United States,-17,17,1854,1707,-1,5,14,39,1871,1690,draw
5318,July 14,2015,Canada,Costa Rica,0,0,CONCACAF Championship,in Canada,13,-13,1514,1791,6,-1,78,22,1501,1804,draw
5319,July 14,2015,Jamaica,El Salvador,1,0,CONCACAF Championship,in Canada,21,-21,1584,1492,3,-10,62,88,1563,1513,T1
5320,July 15,2015,Cuba,Guatemala,1,0,CONCACAF Championship,in the United States,35,-35,1384,1461,10,-9,114,96,1349,1496,T1
5321,July 15,2015,Mexico,Trinidad and Tobago,4,4,CONCACAF Championship,in the United States,-16,16,1815,1574,-1,3,17,64,1831,1558,draw
5322,July 18,2015,Jamaica,Haiti,1,0,CONCACAF Championship,in the United States,18,-18,1602,1469,2,-3,60,93,1584,1487,T1
5323,July 18,2015,United States,Cuba,6,0,CONCACAF Championship,in the United States,4,-4,1858,1380,0,0,14,114,1854,1384,T1
5324,July 19,2015,Mexico,Costa Rica,1,0,CONCACAF Championship,in the United States,23,-23,1838,1768,2,-2,15,24,1815,1791,T1
5325,July 19,2015,Panama,Trinidad and Tobago,1,1,CONCACAF Championship,in the United States,-9,9,1698,1583,-3,1,42,63,1707,1574,draw
5326,July 22,2015,Mexico,Panama,2,1,CONCACAF Championship,in the United States,15,-15,1853,1683,1,-2,14,44,1838,1698,T1
5327,July 22,2015,United States,Jamaica,1,2,CONCACAF Championship,in the United States,-44,44,1814,1646,-3,8,17,52,1858,1602,T2
5328,July 25,2015,United States,Panama,1,1,CONCACAF Championship,in the United States,-15,15,1799,1698,-4,2,21,42,1814,1683,draw
5329,July 26,2015,Mexico,Jamaica,3,1,CONCACAF Championship,in the United States,17,-17,1870,1629,1,-2,13,54,1853,1646,T1
5330,July 31,2015,Mayotte,Maldives,3,1,Indian Ocean Games,in Réunion,13,-13,1213,1022,4,-2,157,187,1200,1035,T1
5331,July 31,2015,Réunion,Mauritius,1,0,Indian Ocean Games,in Réunion,2,-2,1364,1028,0,1,120,186,1362,1030,T1
5332,August 2,2015,China,South Korea,0,2,East Asian Cup,in China,-26,26,1572,1775,-3,4,64,24,1598,1749,T2
5333,August 2,2015,Madagascar,Mayotte,1,1,Indian Ocean Games,in Réunion,-3,3,1284,1216,0,0,134,157,1287,1213,draw
5334,August 2,2015,Maldives,Seychelles,2,1,Indian Ocean Games,in Réunion,13,-13,1035,956,2,-2,185,192,1022,969,T1
5335,August 2,2015,North Korea,Japan,2,1,East Asian Cup,in China,33,-33,1531,1723,13,-9,73,36,1498,1756,T1
5336,August 4,2015,Madagascar,Maldives,4,0,Indian Ocean Games,in Réunion,11,-11,1295,1024,0,-2,134,187,1284,1035,T1
5337,August 4,2015,Mayotte,Seychelles,1,0,Indian Ocean Games,in Réunion,5,-5,1221,951,1,0,156,192,1216,956,T1
5338,August 5,2015,China,North Korea,2,0,East Asian Cup,in China,18,-18,1590,1513,3,-6,61,79,1572,1531,T1
5339,August 5,2015,Japan,South Korea,1,1,East Asian Cup,in China,3,-3,1726,1772,0,0,36,24,1723,1775,draw
5340,August 6,2015,Mayotte,Mauritius,2,1,Indian Ocean Games,in Réunion,7,-7,1228,1021,4,-1,152,187,1221,1028,T1
5341,August 6,2015,Réunion,Madagascar,1,0,Indian Ocean Games,in Réunion,8,-8,1372,1287,2,0,118,134,1364,1295,T1
5342,August 7,2015,Mauritius,Madagascar,3,1,Indian Ocean Games,in Réunion,37,-37,1058,1250,5,-7,182,141,1021,1287,T1
5343,August 8,2015,Réunion,Mayotte,3,1,Indian Ocean Games,in Réunion,9,-9,1381,1219,4,-4,114,156,1372,1228,T1
5344,August 9,2015,China,Japan,1,1,East Asian Cup,in China,2,-2,1592,1724,0,0,61,36,1590,1726,draw
5345,August 9,2015,North Korea,South Korea,0,0,East Asian Cup,in China,13,-13,1526,1759,4,-3,75,27,1513,1772,draw
5346,August 19,2015,Fiji,Tonga,5,0,Friendly,in Fiji,1,-1,1281,684,0,0,135,221,1280,685,T1
5347,August 20,2015,Cambodia,Bhutan,2,0,Friendly,in Cambodia,6,-6,737,578,0,0,214,232,731,584,T1
5348,August 26,2015,Lebanon,Iraq,2,3,Friendly,in Lebanon,-9,9,1390,1533,-2,3,112,73,1399,1524,T2
5349,August 27,2015,Fiji,Eastern Samoa,6,0,Friendly,in Fiji,0,0,1281,382,0,0,135,238,1281,382,T1
5350,August 28,2015,Libya,Tanzania,2,1,Friendly,in Turkey,4,-4,1477,1242,0,-1,92,144,1473,1246,T1
5351,August 28,2015,Oman,Yemen,1,0,Friendly,in Oman,1,-1,1513,1173,0,-2,80,168,1512,1174,T1
5352,August 28,2015,Qatar,Singapore,4,0,Friendly,in Qatar,3,-3,1532,1192,0,0,74,162,1529,1195,T1
5353,August 28,2015,Rwanda,Ethiopia,3,1,Friendly,in Rwanda,9,-9,1415,1339,1,-2,108,127,1406,1348,T1
5354,August 28,2015,Saint Vincent and the Grenadines,Barbados,2,2,Friendly,in Saint Vincent and the Grenadines,-4,4,1201,1145,-1,1,161,172,1205,1141,draw
5355,August 28,2015,United Arab Emirates,Myanmar,1,0,Friendly,in the United Arab Emirates,0,0,1652,1034,0,0,49,186,1652,1034,T1
5356,August 29,2015,Laos,Cambodia,2,1,Friendly,in Thailand,7,-7,837,730,0,0,208,214,830,737,T1
5357,August 29,2015,Malaysia,Bangladesh,0,0,Friendly,in Malaysia,-7,7,1144,942,-1,0,172,197,1151,935,draw
5358,August 31,2015,India,Nepal,0,0,Friendly,in India,-6,6,1035,887,0,1,185,203,1041,881,draw
5359,August 31,2015,Lebanon,Palestine,0,0,Friendly,in Lebanon,-5,5,1385,1315,-1,1,113,130,1390,1310,draw
5360,August 31,2015,Tonga,Cook Islands,0,3,World Cup and Oceania Cup qualifier,in Tonga,-46,46,638,721,-4,8,225,216,684,675,T2
5361,August 31,2015,Samoa,Eastern Samoa,3,2,World Cup and Oceania Cup qualifier,in Tonga,6,-6,688,376,1,0,221,238,682,382,T1
5362,September 1,2015,Congo,Ghana,2,3,Friendly,in Congo,-7,7,1437,1654,-2,2,103,49,1444,1647,T2
5363,September 2,2015,Cook Islands,Samoa,1,0,World Cup and Oceania Cup qualifier,in Tonga,18,-18,739,670,2,-3,214,224,721,688,T1
5364,September 2,2015,Tonga,Eastern Samoa,1,2,World Cup and Oceania Cup qualifier,in Tonga,-36,36,602,412,-5,1,230,237,638,376,T2
5365,September 3,2015,Australia,Bangladesh,5,0,World Cup and Asian Cup qualifier,in Australia,0,0,1733,942,0,0,33,197,1733,942,T1
5366,September 3,2015,Azerbaijan,Croatia,0,0,European Championship qualifier,in Azerbaijan,14,-14,1439,1819,4,0,102,15,1425,1833,draw
5367,September 3,2015,Bahrain,North Korea,0,1,World Cup and Asian Cup qualifier,in Bahrain,-21,21,1427,1547,-6,6,106,70,1448,1526,T2
5368,September 3,2015,Belgium,Bosnia and Herzegovina,3,1,European Championship qualifier,in Belgium,11,-11,1910,1720,1,-3,10,37,1899,1731,T1
5369,September 3,2015,Bulgaria,Norway,0,1,European Championship qualifier,in Bulgaria,-26,26,1588,1630,-4,6,61,54,1614,1604,T2
5370,September 3,2015,China,Hong Kong,0,0,World Cup and Asian Cup qualifier,in China,-18,18,1574,1192,-3,4,64,162,1592,1174,draw
5371,September 3,2015,Cyprus,Wales,0,1,European Championship qualifier,in Cyprus,-10,10,1401,1709,0,1,109,39,1411,1699,T2
5372,September 3,2015,Czechia,Kazakhstan,2,1,European Championship qualifier,in Czechia,2,-2,1762,1341,0,-1,26,126,1760,1343,T1
5373,September 3,2015,Iran,Guam,6,0,World Cup and Asian Cup qualifier,in Iran,0,0,1731,876,-1,0,35,205,1731,876,T1
5374,September 3,2015,Iraq,Taiwan,5,1,World Cup and Asian Cup qualifier,in Iran,1,-1,1534,784,-1,0,74,211,1533,785,T1
5375,September 3,2015,Israel,Andorra,4,0,European Championship qualifier,in Israel,1,-1,1610,962,0,0,58,190,1609,963,T1
5376,September 3,2015,Italy,Malta,1,0,European Championship qualifier,in Italy,1,-1,1871,1237,0,0,13,147,1870,1238,T1
5377,September 3,2015,Japan,Cambodia,3,0,World Cup and Asian Cup qualifier,in Japan,0,0,1724,730,0,0,36,215,1724,730,T1
5378,September 3,2015,Jordan,Kyrgyzstan,0,0,World Cup and Asian Cup qualifier,in Jordan,-18,18,1485,1141,-5,3,89,173,1503,1123,draw
5379,September 3,2015,Kuwait,Myanmar,9,0,World Cup and Asian Cup qualifier,in Qatar,7,-7,1495,1027,3,0,86,186,1488,1034,T1
5380,September 3,2015,Netherlands,Iceland,0,1,European Championship qualifier,in the Netherlands,-37,37,1973,1733,-2,11,6,33,2010,1696,T2
5381,September 3,2015,Oman,Turkmenistan,3,1,World Cup and Asian Cup qualifier,in Oman,6,-6,1519,1238,2,-3,78,146,1513,1244,T1
5382,September 3,2015,Philippines,Maldives,2,0,Friendly,in the Philippines,3,-3,1280,1021,0,0,136,187,1277,1024,T1
5383,September 3,2015,Qatar,Bhutan,15,0,World Cup and Asian Cup qualifier,in Qatar,0,0,1532,578,-1,0,75,232,1532,578,T1
5384,September 3,2015,Saudi Arabia,East Timor,7,0,World Cup and Asian Cup qualifier,in Saudi Arabia,1,-1,1501,718,2,0,84,217,1500,719,T1
5385,September 3,2015,South Korea,Laos,8,0,World Cup and Asian Cup qualifier,in South Korea,0,0,1759,837,0,0,27,208,1759,837,T1
5386,September 3,2015,Syria,Singapore,1,0,World Cup and Asian Cup qualifier,in Oman,5,-5,1523,1187,0,-1,77,163,1518,1192,T1
5387,September 3,2015,Thailand,Afghanistan,2,0,Friendly,in Thailand,3,-3,1369,1090,1,0,119,179,1366,1093,T1
5388,September 3,2015,Turkey,Latvia,1,1,European Championship qualifier,in Turkey,-15,15,1705,1481,-4,2,41,92,1720,1466,draw
5389,September 3,2015,United Arab Emirates,Malaysia,10,0,World Cup and Asian Cup qualifier,in the United Arab Emirates,3,-3,1655,1141,1,-1,49,173,1652,1144,T1
5390,September 3,2015,Uzbekistan,Yemen,1,0,World Cup and Asian Cup qualifier,in Uzbekistan,2,-2,1580,1171,1,0,63,168,1578,1173,T1
5391,September 4,2015,Antigua and Barbuda,Guatemala,1,0,World Cup qualifier,in Antigua and Barbuda,27,-27,1266,1434,6,-7,139,103,1239,1461,T1
5392,September 4,2015,Argentina,Bolivia,7,0,Friendly,in the United States,3,-3,2073,1636,0,1,2,51,2070,1639,T1
5393,September 4,2015,Canada,Belize,3,0,World Cup qualifier,in Canada,5,-5,1519,1174,2,-2,78,166,1514,1179,T1
5394,September 4,2015,Curaçao,El Salvador,0,1,World Cup qualifier,in Curaçao,-7,7,1118,1499,0,1,176,86,1125,1492,T2
5395,September 4,2015,Denmark,Albania,0,0,European Championship qualifier,in Denmark,-13,13,1769,1620,-1,3,23,56,1782,1607,draw
5396,September 4,2015,Djibouti,Togo,0,2,African Nations Cup qualifier,in Djibouti,-2,2,785,1445,0,1,210,99,787,1443,T2
5397,September 4,2015,Eastern Samoa,Cook Islands,2,0,World Cup and Oceania Cup qualifier,in Tonga,52,-52,464,687,1,-7,236,221,412,739,T1
5398,September 4,2015,Faroe Islands,Northern Ireland,1,3,European Championship qualifier,in the Faroe Islands,-16,16,1244,1553,-3,5,143,68,1260,1537,T2
5399,September 4,2015,Georgia,Scotland,1,0,European Championship qualifier,in Georgia,29,-29,1490,1706,8,-8,88,40,1461,1735,T1
5400,September 4,2015,Germany,Poland,3,1,European Championship qualifier,in Germany,4,-4,2113,1733,0,-1,1,31,2109,1737,T1
5401,September 4,2015,Greece,Finland,0,1,European Championship qualifier,in Greece,-30,30,1618,1594,-6,7,57,59,1648,1564,T2
5402,September 4,2015,Grenada,Haiti,1,3,World Cup qualifier,in Grenada,-13,13,1129,1482,-2,1,174,93,1142,1469,T2
5403,September 4,2015,Hungary,Romania,0,0,European Championship qualifier,in Hungary,0,0,1680,1778,1,1,44,22,1680,1778,draw
5404,September 4,2015,Ireland,Gibraltar,4,0,European Championship qualifier,in Portugal,2,-2,1720,1129,2,1,36,174,1718,1131,T1
5405,September 4,2015,Jamaica,Nicaragua,2,3,World Cup qualifier,in Jamaica,-38,38,1591,1214,-5,7,60,158,1629,1176,T2
5406,September 4,2015,Mexico,Trinidad and Tobago,3,3,Friendly,in the United States,-7,7,1863,1590,0,1,14,61,1870,1583,draw
5407,September 4,2015,Panama,Uruguay,0,1,Friendly,in Panama,-8,8,1690,1885,0,0,43,12,1698,1877,T2
5408,September 4,2015,Portugal,France,0,1,Friendly,in Portugal,-12,12,1895,1937,0,1,11,8,1907,1925,T2
5409,September 4,2015,Serbia,Armenia,2,0,European Championship qualifier,in Serbia,10,-10,1716,1519,2,-2,38,78,1706,1529,T1
5410,September 4,2015,Saint Vincent and the Grenadines,Aruba,2,0,World Cup qualifier,in Saint Vincent and the Grenadines,6,-6,1207,912,0,0,161,199,1201,918,T1
5411,September 4,2015,Tonga,Samoa,0,3,World Cup and Oceania Cup qualifier,in Tonga,-38,38,564,708,-3,7,233,217,602,670,T2
5412,September 4,2015,United States,Peru,2,1,Friendly,in the United States,7,-7,1806,1801,2,-3,19,21,1799,1808,T1
5413,September 4,2015,Venezuela,Honduras,0,3,Friendly,in Venezuela,-29,29,1670,1541,-4,7,46,74,1699,1512,T2
5414,September 5,2015,Austria,Moldova,1,0,European Championship qualifier,in Austria,3,-3,1751,1391,-1,-1,29,111,1748,1394,T1
5415,September 5,2015,Botswana,Burkina Faso,1,0,African Nations Cup qualifier,in Botswana,25,-25,1295,1440,4,-4,134,100,1270,1465,T1
5416,September 5,2015,Brazil,Costa Rica,1,0,Friendly,in the United States,4,-4,2037,1764,0,0,3,24,2033,1768,T1
5417,September 5,2015,Burundi,Niger,2,0,African Nations Cup qualifier,in Burundi,20,-20,1333,1279,4,-4,127,137,1313,1299,T1
5418,September 5,2015,Chile,Paraguay,3,2,Friendly,in Chile,2,-2,1977,1696,0,0,5,42,1975,1698,T1
5419,September 5,2015,Comoros,Uganda,0,1,African Nations Cup qualifier,in the Comoros,-2,2,892,1491,0,0,202,89,894,1489,T2
5420,September 5,2015,Estonia,Lithuania,1,0,European Championship qualifier,in Estonia,12,-12,1495,1419,4,-3,87,107,1483,1431,T1
5421,September 5,2015,Gabon,Sudan,4,0,Friendly,in Gabon,8,-8,1491,1342,2,-1,89,125,1483,1350,T1
5422,September 5,2015,Guinea-Bissau,Congo,2,4,African Nations Cup qualifier,in Guinea-Bissau,-23,23,1227,1460,-12,6,153,96,1250,1437,T2
5423,September 5,2015,Liberia,Tunisia,1,0,African Nations Cup qualifier,in Liberia,30,-30,1314,1541,2,-6,132,72,1284,1571,T1
5424,September 5,2015,Luxembourg,Macedonia,1,0,European Championship qualifier,in Luxembourg,28,-28,1250,1432,12,-6,143,103,1222,1460,T1
5425,September 5,2015,Mauritania,South Africa,3,1,African Nations Cup qualifier,in Mauritania,48,-48,1253,1505,20,-15,142,83,1205,1553,T1
5426,September 5,2015,Montenegro,Liechtenstein,2,0,European Championship qualifier,in Montenegro,4,-4,1593,1215,2,-2,60,158,1589,1219,T1
5427,September 5,2015,Namibia,Senegal,0,2,African Nations Cup qualifier,in Namibia,-15,15,1352,1678,-3,2,123,45,1367,1663,T2
5428,September 5,2015,Russia,Sweden,1,0,European Championship qualifier,in Russia,18,-18,1760,1789,3,-3,26,21,1742,1807,T1
5429,September 5,2015,Rwanda,Ghana,0,1,African Nations Cup qualifier,in Rwanda,-12,12,1403,1666,0,2,108,48,1415,1654,T2
5430,September 5,2015,San Marino,England,0,6,European Championship qualifier,in San Marino,0,0,886,1936,0,0,204,9,886,1936,T2
5431,September 5,2015,São Tomé and Príncipe,Morocco,0,3,African Nations Cup qualifier,in São Tomé and Príncipe,-7,7,1071,1559,-1,4,181,66,1078,1552,T2
5432,September 5,2015,Seychelles,Ethiopia,1,1,African Nations Cup qualifier,in the Seychelles,14,-14,965,1325,2,-2,190,129,951,1339,draw
5433,September 5,2015,South Sudan,Equatorial Guinea,1,0,African Nations Cup qualifier,in South Sudan,32,-32,1088,1357,3,-9,180,121,1056,1389,T1
5434,September 5,2015,Spain,Slovakia,2,0,European Championship qualifier,in Spain,9,-9,1973,1756,1,-3,6,28,1964,1765,T1
5435,September 5,2015,Switzerland,Slovenia,3,2,European Championship qualifier,in Switzerland,7,-7,1810,1628,2,-1,18,53,1803,1635,T1
5436,September 5,2015,Tanzania,Nigeria,0,0,African Nations Cup qualifier,in Tanzania,15,-15,1257,1647,3,-2,141,50,1242,1662,draw
5437,September 5,2015,Ukraine,Belarus,3,1,European Championship qualifier,in Ukraine,7,-7,1818,1552,0,-1,17,68,1811,1559,T1
5438,September 6,2015,Benin,Mali,1,1,African Nations Cup qualifier,in Benin,4,-4,1384,1543,2,-2,112,71,1380,1547,draw
5439,September 6,2015,Bosnia and Herzegovina,Andorra,3,0,European Championship qualifier,in Bosnia and Herzegovina,0,0,1720,962,1,0,35,191,1720,962,T1
5440,September 6,2015,Cape Verde,Libya,2,1,African Nations Cup qualifier,in Egypt,16,-16,1558,1461,4,1,67,94,1542,1477,T1
5441,September 6,2015,Chad,Egypt,1,5,African Nations Cup qualifier,in Chad,-13,13,1248,1640,-5,2,145,52,1261,1627,T2
5442,September 6,2015,Central African Republic,Democratic Republic of Congo,2,0,African Nations Cup qualifier,in Central African Republic,44,-44,1271,1457,14,-12,139,96,1227,1501,T1
5443,September 6,2015,Cyprus,Belgium,0,1,European Championship qualifier,in Cyprus,-3,3,1398,1913,0,0,109,10,1401,1910,T2
5444,September 6,2015,Gambia,Cameroon,0,1,African Nations Cup qualifier,in The Gambia,-11,11,1348,1633,-5,1,124,54,1359,1622,T2
5445,September 6,2015,Iceland,Kazakhstan,0,0,European Championship qualifier,in Iceland,-18,18,1715,1359,-8,6,39,120,1733,1341,draw
5446,September 6,2015,Italy,Bulgaria,1,0,European Championship qualifier,in Italy,4,-4,1875,1584,0,0,13,63,1871,1588,T1
5447,September 6,2015,Ivory Coast,Sierra Leone,0,0,African Nations Cup qualifier,in Nigeria,-17,17,1720,1340,-5,4,35,126,1737,1323,draw
5448,September 6,2015,Kenya,Zambia,1,2,African Nations Cup qualifier,in Kenya,-19,19,1375,1530,-6,5,116,76,1394,1511,T2
5449,September 6,2015,Latvia,Czechia,1,2,European Championship qualifier,in Latvia,-10,10,1471,1772,1,2,93,23,1481,1762,T2
5450,September 6,2015,Lesotho,Algeria,1,3,African Nations Cup qualifier,in Lesotho,-6,6,1204,1684,-2,1,162,44,1210,1678,T2
5451,September 6,2015,Madagascar,Angola,0,0,African Nations Cup qualifier,in Madagascar,5,-5,1255,1436,1,-1,142,100,1250,1441,draw
5452,September 6,2015,Malta,Azerbaijan,2,2,European Championship qualifier,in Malta,6,-6,1243,1433,1,-1,147,102,1237,1439,draw
5453,September 6,2015,Mauritius,Mozambique,1,0,African Nations Cup qualifier,in Mauritius,30,-30,1088,1313,3,-8,180,132,1058,1343,T1
5454,September 6,2015,Norway,Croatia,2,0,European Championship qualifier,in Norway,38,-38,1668,1781,4,-6,48,21,1630,1819,T1
5455,September 6,2015,Swaziland,Malawi,2,2,African Nations Cup qualifier,in Swaziland,2,-2,1243,1375,-1,0,147,116,1241,1377,draw
5456,September 6,2015,Turkey,Netherlands,3,0,European Championship qualifier,in Turkey,51,-51,1756,1922,13,-3,28,9,1705,1973,T1
5457,September 6,2015,Wales,Israel,0,0,European Championship qualifier,in Wales,-10,10,1699,1620,-2,2,41,56,1709,1610,draw
5458,September 6,2015,Zimbabwe,Guinea,1,1,African Nations Cup qualifier,in Zimbabwe,3,-3,1360,1503,2,-1,119,83,1357,1506,draw
5459,September 7,2015,Albania,Portugal,0,1,European Championship qualifier,in Albania,-11,11,1609,1906,-2,0,58,11,1620,1895,T2
5460,September 7,2015,Armenia,Denmark,0,0,European Championship qualifier,in Armenia,8,-8,1527,1761,1,-1,77,25,1519,1769,draw
5461,September 7,2015,Finland,Faroe Islands,1,0,European Championship qualifier,in Finland,3,-3,1597,1241,0,-2,59,148,1594,1244,T1
5462,September 7,2015,France,Serbia,2,1,Friendly,in France,3,-3,1940,1713,0,-1,7,39,1937,1716,T1
5463,September 7,2015,Ireland,Georgia,1,0,European Championship qualifier,in Ireland,5,-5,1725,1485,1,0,34,90,1720,1490,T1
5464,September 7,2015,Myanmar,New Zealand,1,1,Friendly,in Myanmar,8,-8,1035,1508,1,0,185,81,1027,1516,draw
5465,September 7,2015,Northern Ireland,Hungary,1,1,European Championship qualifier,in Northern Ireland,2,-2,1555,1678,0,0,68,45,1553,1680,draw
5466,September 7,2015,Poland,Gibraltar,8,1,European Championship qualifier,in Poland,2,-2,1735,1127,0,-1,31,175,1733,1129,T1
5467,September 7,2015,Romania,Greece,0,0,European Championship qualifier,in Romania,-13,13,1765,1631,-1,3,23,55,1778,1618,draw
5468,September 7,2015,Scotland,Germany,2,3,European Championship qualifier,in Scotland,-6,6,1700,2119,0,0,40,1,1706,2113,T2
5469,September 8,2015,Argentina,Mexico,2,2,Friendly,in the United States,-5,5,2068,1868,0,0,2,14,2073,1863,draw
5470,September 8,2015,Aruba,Saint Vincent and the Grenadines,2,1,World Cup qualifier,in Aruba,30,-30,942,1177,2,-4,197,165,912,1207,T1
5471,September 8,2015,Bahrain,Yemen,4,0,World Cup and Asian Cup qualifier,in Qatar,14,-14,1441,1157,5,-2,100,170,1427,1171,T1
5472,September 8,2015,Bangladesh,Jordan,0,4,World Cup and Asian Cup qualifier,in Bangladesh,-5,5,937,1490,-1,1,198,89,942,1485,T2
5473,September 8,2015,Belarus,Luxembourg,2,0,European Championship qualifier,in Belarus,5,-5,1557,1245,1,-1,68,145,1552,1250,T1
5474,September 8,2015,Belize,Canada,1,1,World Cup qualifier,in Belize,12,-12,1186,1507,3,-3,163,82,1174,1519,draw
5475,September 8,2015,Cambodia,Syria,0,6,World Cup and Asian Cup qualifier,in Cambodia,-2,2,728,1525,0,0,214,78,730,1523,T2
5476,September 8,2015,China,Maldives,3,0,World Cup and Asian Cup qualifier,in China,2,-2,1576,1019,0,0,65,187,1574,1021,T1
5477,September 8,2015,Colombia,Peru,1,1,Friendly,in the United States,-5,5,1998,1806,0,2,4,17,2003,1801,draw
5478,September 8,2015,Costa Rica,Uruguay,1,0,Friendly,in Costa Rica,11,-11,1775,1874,2,-1,22,13,1764,1885,T1
5479,September 8,2015,Ecuador,Honduras,2,0,Friendly,in Ecuador,3,-3,1822,1538,0,-2,15,74,1819,1541,T1
5480,September 8,2015,El Salvador,Curaçao,1,0,World Cup qualifier,in El Salvador,2,-2,1501,1116,1,0,84,176,1499,1118,T1
5481,September 8,2015,England,Switzerland,2,0,European Championship qualifier,in England,13,-13,1949,1797,1,-2,7,19,1936,1810,T1
5482,September 8,2015,Guam,Oman,0,0,World Cup and Asian Cup qualifier,in Guam,18,-18,894,1501,3,-5,202,84,876,1519,draw
5483,September 8,2015,Guatemala,Antigua and Barbuda,2,0,World Cup qualifier,in Guatemala,11,-11,1445,1255,3,-1,98,141,1434,1266,T1
5484,September 8,2015,Haiti,Grenada,3,0,World Cup qualifier,in Haiti,5,-5,1487,1124,2,-1,90,175,1482,1129,T1
5485,September 8,2015,Hong Kong,Qatar,2,3,World Cup and Asian Cup qualifier,in Hong Kong,-8,8,1184,1540,-1,2,164,73,1192,1532,T2
5486,September 8,2015,India,Iran,0,3,World Cup and Asian Cup qualifier,in India,-2,2,1033,1733,-1,0,186,33,1035,1731,T2
5487,September 8,2015,Japan,Afghanistan,6,0,World Cup and Asian Cup qualifier,in Iran,2,-2,1726,1088,1,0,34,179,1724,1090,T1
5488,September 8,2015,Laos,Kuwait,0,2,World Cup and Asian Cup qualifier,in Laos,-2,2,835,1497,0,0,208,86,837,1495,T2
5489,September 8,2015,Lebanon,South Korea,0,3,World Cup and Asian Cup qualifier,in Lebanon,-12,12,1373,1771,-5,3,116,24,1385,1759,T2
5490,September 8,2015,Liechtenstein,Russia,0,7,European Championship qualifier,in Liechtenstein,-6,6,1209,1766,0,1,158,25,1215,1760,T2
5491,September 8,2015,Lithuania,San Marino,2,1,European Championship qualifier,in Lithuania,1,-1,1420,885,0,-1,107,205,1419,886,T1
5492,September 8,2015,Macedonia,Spain,0,1,European Championship qualifier,in Macedonia,-3,3,1429,1976,-1,0,104,6,1432,1973,T2
5493,September 8,2015,Malaysia,Saudi Arabia,1,2,World Cup and Asian Cup qualifier,in Malaysia,-7,7,1134,1508,-1,4,173,80,1141,1501,T2
5494,September 8,2015,Moldova,Montenegro,0,2,European Championship qualifier,in Moldova,-21,21,1370,1614,-8,2,118,58,1391,1593,T2
5495,September 8,2015,Nicaragua,Jamaica,0,2,World Cup qualifier,in Nicaragua,-10,10,1204,1601,-1,1,160,60,1214,1591,T2
5496,September 8,2015,Nigeria,Niger,2,0,Friendly,in Nigeria,2,-2,1649,1277,1,1,50,136,1647,1279,T1
5497,September 8,2015,Palestine,United Arab Emirates,0,0,World Cup and Asian Cup qualifier,in Palestine,12,-12,1327,1643,2,-1,128,51,1315,1655,draw
5498,September 8,2015,Philippines,Uzbekistan,1,5,World Cup and Asian Cup qualifier,in the Philippines,-18,18,1262,1598,-3,3,139,61,1280,1580,T2
5499,September 8,2015,Slovakia,Ukraine,0,0,European Championship qualifier,in Slovakia,-2,2,1754,1820,-1,0,29,16,1756,1818,draw
5500,September 8,2015,Slovenia,Estonia,1,0,European Championship qualifier,in Slovenia,8,-8,1636,1487,3,-4,53,90,1628,1495,T1
5501,September 8,2015,South Africa,Senegal,1,0,Friendly,in South Africa,12,-12,1517,1666,3,-3,79,48,1505,1678,T1
5502,September 8,2015,Sweden,Austria,1,4,European Championship qualifier,in Sweden,-48,48,1741,1799,-10,12,30,18,1789,1751,T2
5503,September 8,2015,Taiwan,Vietnam,1,2,World Cup and Asian Cup qualifier,in Taiwan,-5,5,779,1235,0,3,211,150,784,1230,T2
5504,September 8,2015,Tajikistan,Australia,0,3,World Cup and Asian Cup qualifier,in Tajikistan,-6,6,1228,1739,-3,1,153,31,1234,1733,T2
5505,September 8,2015,Thailand,Iraq,2,2,World Cup and Asian Cup qualifier,in Thailand,4,-4,1373,1530,2,-1,116,75,1369,1534,draw
5506,September 8,2015,United States,Brazil,1,4,Friendly,in the United States,-11,11,1795,2048,-2,0,20,3,1806,2037,T2
5507,September 8,2015,Venezuela,Panama,1,1,Friendly,in Venezuela,-2,2,1668,1692,1,0,46,43,1670,1690,draw
5508,September 8,2015,Zambia,Gabon,1,1,Friendly,in Zambia,-4,4,1526,1495,-1,1,77,87,1530,1491,draw
5509,September 12,2015,Rwanda,Gabon,0,1,Friendly,in Rwanda,-10,10,1393,1505,-1,4,109,83,1403,1495,T2
5510,September 30,2015,Botswana,Ethiopia,2,3,Friendly,in Botswana,-12,12,1283,1337,0,3,134,127,1295,1325,T2
5511,October 2,2015,Oman,Syria,2,1,Friendly,in Oman,8,-8,1509,1517,5,0,80,78,1501,1525,T1
5512,October 3,2015,Jordan,Iraq,3,0,Friendly,in Jordan,15,-15,1505,1515,5,-4,84,79,1490,1530,T1
5513,October 7,2015,Comoros,Lesotho,0,0,World Cup qualifier,in the Comoros,11,-11,903,1193,1,-1,202,161,892,1204,draw
5514,October 7,2015,Mauritius,Kenya,2,5,World Cup qualifier,in Mauritius,-18,18,1070,1393,-3,5,182,109,1088,1375,T2
5515,October 7,2015,Seychelles,Burundi,0,1,World Cup qualifier,in the Seychelles,-7,7,958,1340,-1,2,191,126,965,1333,T2
5516,October 7,2015,Tanzania,Malawi,2,0,World Cup qualifier,in Tanzania,32,-32,1289,1343,6,-10,134,124,1257,1375,T1
5517,October 8,2015,Albania,Serbia,0,2,European Championship qualifier,in Albania,-30,30,1579,1743,-6,8,65,31,1609,1713,T2
5518,October 8,2015,Argentina,Ecuador,0,2,World Cup qualifier,in Argentina,-53,53,2015,1875,-1,2,3,13,2068,1822,T2
5519,October 8,2015,Bahrain,Uzbekistan,0,4,World Cup and Asian Cup qualifier,in Bahrain,-31,31,1410,1629,-7,8,107,53,1441,1598,T2
5520,October 8,2015,Bhutan,Maldives,3,4,World Cup and Asian Cup qualifier,in Bhutan,-5,5,573,1024,0,0,231,187,578,1019,T2
5521,October 8,2015,Bolivia,Uruguay,0,2,World Cup qualifier,in Bolivia,-19,19,1617,1893,-4,1,57,12,1636,1874,T2
5522,October 8,2015,Chile,Brazil,2,0,World Cup qualifier,in Chile,28,-28,2005,2020,0,1,5,2,1977,2048,T1
5523,October 8,2015,Colombia,Peru,2,0,World Cup qualifier,in Colombia,9,-9,2007,1797,0,-1,4,18,1998,1806,T1
5524,October 8,2015,Costa Rica,South Africa,0,1,Friendly,in Costa Rica,-18,18,1757,1535,-4,3,26,74,1775,1517,T2
5525,October 8,2015,Democratic Republic of Congo,Nigeria,2,0,Friendly,in Belgium,23,-23,1480,1626,3,-4,93,54,1457,1649,T1
5526,October 8,2015,East Timor,Palestine,1,1,World Cup and Asian Cup qualifier,in East Timor,18,-18,736,1309,2,-1,214,130,718,1327,draw
5527,October 8,2015,France,Armenia,4,0,Friendly,in France,2,-2,1942,1525,0,-4,8,79,1940,1527,T1
5528,October 8,2015,Georgia,Gibraltar,4,0,European Championship qualifier,in Georgia,5,-5,1490,1122,3,-1,89,175,1485,1127,T1
5529,October 8,2015,Honduras,Guatemala,1,1,Friendly,in Honduras,-5,5,1533,1450,-1,0,75,98,1538,1445,draw
5530,October 8,2015,Hungary,Faroe Islands,2,1,European Championship qualifier,in Hungary,2,-2,1680,1239,1,-2,44,150,1678,1241,T1
5531,October 8,2015,Ireland,Germany,1,0,European Championship qualifier,in Ireland,34,-34,1759,2085,10,0,25,1,1725,2119,T1
5532,October 8,2015,Japan,Syria,3,0,World Cup and Asian Cup qualifier,in Oman,16,-16,1742,1501,2,-9,32,86,1726,1517,T1
5533,October 8,2015,Jordan,Australia,2,0,World Cup and Asian Cup qualifier,in Jordan,41,-41,1546,1698,13,-10,71,41,1505,1739,T1
5534,October 8,2015,Kuwait,South Korea,0,1,World Cup and Asian Cup qualifier,in Kuwait,-11,11,1486,1782,-4,3,92,21,1497,1771,T2
5535,October 8,2015,Kyrgyzstan,Tajikistan,2,2,World Cup and Asian Cup qualifier,in Kyrgyzstan,-1,1,1140,1229,0,-1,172,154,1141,1228,draw
5536,October 8,2015,Lebanon,Myanmar,2,0,World Cup and Asian Cup qualifier,in Thailand,8,-8,1381,1027,3,0,112,185,1373,1035,T1
5537,October 8,2015,Liberia,Guinea-Bissau,1,1,World Cup qualifier,in Liberia,-10,10,1304,1237,-2,3,133,151,1314,1227,draw
5538,October 8,2015,Malaysia,Laos,3,1,Friendly,in Thailand,5,-5,1139,830,0,0,173,208,1134,835,T1
5539,October 8,2015,North Korea,Philippines,0,0,World Cup and Asian Cup qualifier,in North Korea,-16,16,1531,1278,-6,3,76,137,1547,1262,draw
5540,October 8,2015,Northern Ireland,Greece,3,1,European Championship qualifier,in Northern Ireland,28,-28,1583,1603,5,-5,64,61,1555,1631,T1
5541,October 8,2015,Oman,Iran,1,1,World Cup and Asian Cup qualifier,in Oman,7,-7,1516,1726,0,-2,80,35,1509,1733,draw
5542,October 8,2015,Panama,Trinidad and Tobago,1,2,Friendly,in Panama,-15,15,1677,1605,-2,3,45,60,1692,1590,T2
5543,October 8,2015,Portugal,Denmark,1,0,European Championship qualifier,in Portugal,8,-8,1914,1753,1,-2,10,29,1906,1761,T1
5544,October 8,2015,Qatar,China,1,0,World Cup and Asian Cup qualifier,in Qatar,16,-16,1556,1560,3,-1,70,66,1540,1576,T1
5545,October 8,2015,Romania,Finland,1,1,European Championship qualifier,in Romania,-13,13,1752,1610,-4,3,30,59,1765,1597,draw
5546,October 8,2015,São Tomé and Príncipe,Ethiopia,1,0,World Cup qualifier,in São Tomé and Príncipe,29,-29,1100,1308,2,-3,179,131,1071,1337,T1
5547,October 8,2015,Saudi Arabia,United Arab Emirates,2,1,World Cup and Asian Cup qualifier,in Saudi Arabia,22,-22,1530,1621,4,-4,77,55,1508,1643,T1
5548,October 8,2015,Scotland,Poland,2,2,European Championship qualifier,in Scotland,-4,4,1696,1739,-2,-2,42,34,1700,1735,draw
5549,October 8,2015,Singapore,Afghanistan,1,0,World Cup and Asian Cup qualifier,in Singapore,10,-10,1197,1078,1,-2,161,181,1187,1088,T1
5550,October 8,2015,South Sudan,Mauritania,1,1,World Cup qualifier,in South Sudan,4,-4,1092,1249,-1,0,180,143,1088,1253,draw
5551,October 8,2015,Turkmenistan,India,2,1,World Cup and Asian Cup qualifier,in Turkmenistan,6,-6,1244,1027,2,1,147,185,1238,1033,T1
5552,October 8,2015,Venezuela,Paraguay,0,1,World Cup qualifier,in Venezuela,-24,24,1644,1720,-3,6,49,36,1668,1696,T2
5553,October 8,2015,Vietnam,Iraq,1,1,World Cup and Asian Cup qualifier,in Vietnam,10,-10,1245,1505,5,-4,145,83,1235,1515,draw
5554,October 9,2015,Algeria,Guinea,1,2,Friendly,in Algeria,-17,17,1667,1520,-3,5,46,80,1684,1503,T2
5555,October 9,2015,Djibouti,Swaziland,0,6,World Cup qualifier,in Djibouti,-10,10,775,1253,-1,5,211,143,785,1243,T2
5556,October 9,2015,England,Estonia,2,0,European Championship qualifier,in England,2,-2,1951,1485,0,-1,7,91,1949,1487,T1
5557,October 9,2015,Gambia,Namibia,1,1,World Cup qualifier,in The Gambia,-5,5,1343,1357,0,1,123,121,1348,1352,draw
5558,October 9,2015,Haiti,El Salvador,3,1,Friendly,in the United States,16,-16,1503,1485,4,-5,86,91,1487,1501,T1
5559,October 9,2015,Liechtenstein,Sweden,0,2,European Championship qualifier,in Liechtenstein,-5,5,1204,1746,-1,3,159,30,1209,1741,T2
5560,October 9,2015,Macedonia,Ukraine,0,2,European Championship qualifier,in Macedonia,-9,9,1420,1829,-3,0,106,16,1429,1820,T2
5561,October 9,2015,Mali,Burkina Faso,4,1,Friendly,in France,12,-12,1555,1428,2,-4,70,104,1543,1440,T1
5562,October 9,2015,Moldova,Russia,1,2,European Championship qualifier,in Moldova,-6,6,1364,1772,0,1,117,23,1370,1766,T2
5563,October 9,2015,Montenegro,Austria,2,3,European Championship qualifier,in Montenegro,-15,15,1599,1814,-4,0,62,17,1614,1799,T2
5564,October 9,2015,Morocco,Ivory Coast,0,1,Friendly,in Morocco,-8,8,1551,1728,-4,2,71,34,1559,1720,T2
5565,October 9,2015,Niger,Somalia,2,0,World Cup qualifier,in Ethiopia,5,-5,1282,863,2,0,136,206,1277,868,T1
5566,October 9,2015,Slovakia,Belarus,0,1,European Championship qualifier,in Slovakia,-34,34,1720,1591,-8,6,36,63,1754,1557,T2
5567,October 9,2015,Slovenia,Lithuania,1,1,European Championship qualifier,in Slovenia,-14,14,1622,1434,-3,5,54,101,1636,1420,draw
5568,October 9,2015,Spain,Luxembourg,4,0,European Championship qualifier,in Spain,1,-1,1977,1244,0,-2,6,147,1976,1245,T1
5569,October 9,2015,Switzerland,San Marino,7,0,European Championship qualifier,in Switzerland,0,0,1797,885,0,0,18,205,1797,885,T1
5570,October 9,2015,Taiwan,Macao,5,1,Friendly,in Taiwan,7,-7,786,613,1,0,210,228,779,620,T1
5571,October 9,2015,Thailand,Hong Kong,1,0,Friendly,in Thailand,3,-3,1376,1181,0,0,116,164,1373,1184,T1
5572,October 9,2015,Tunisia,Gabon,3,3,Friendly,in Tunisia,-4,4,1537,1509,0,1,73,82,1541,1505,draw
5573,October 10,2015,Andorra,Belgium,1,4,European Championship qualifier,in Andorra,-1,1,961,1914,0,1,190,10,962,1913,T2
5574,October 10,2015,Azerbaijan,Italy,1,3,European Championship qualifier,in Azerbaijan,-7,7,1426,1882,-3,-1,105,14,1433,1875,T2
5575,October 10,2015,Bosnia and Herzegovina,Wales,2,0,European Championship qualifier,in Bosnia and Herzegovina,20,-20,1740,1679,4,-3,32,43,1720,1699,T1
5576,October 10,2015,Chad,Sierra Leone,1,0,World Cup qualifier,in Chad,20,-20,1268,1320,4,-2,141,128,1248,1340,T1
5577,October 10,2015,Croatia,Bulgaria,3,0,European Championship qualifier,in Croatia,11,-11,1792,1573,1,-2,21,66,1781,1584,T1
5578,October 10,2015,Czechia,Turkey,0,2,European Championship qualifier,in Czechia,-40,40,1732,1796,-11,7,34,20,1772,1756,T2
5579,October 10,2015,Eritrea,Botswana,0,2,World Cup qualifier,in Eritrea,-24,24,1085,1307,-3,3,180,132,1109,1283,T2
5580,October 10,2015,Iceland,Latvia,2,2,European Championship qualifier,in Iceland,-15,15,1700,1486,0,4,39,90,1715,1471,draw
5581,October 10,2015,Israel,Cyprus,1,2,European Championship qualifier,in Israel,-35,35,1585,1433,-7,6,63,102,1620,1398,T2
5582,October 10,2015,Kazakhstan,Netherlands,1,2,European Championship qualifier,in Kazakhstan,-3,3,1356,1925,-2,0,121,9,1359,1922,T2
5583,October 10,2015,Kosovo,Equatorial Guinea,2,0,Friendly,in Kosovo,10,-10,1387,1347,4,-1,111,122,1377,1357,T1
5584,October 10,2015,Madagascar,Central African Republic,3,0,World Cup qualifier,in Madagascar,27,-27,1282,1244,5,-6,136,146,1255,1271,T1
5585,October 10,2015,Norway,Malta,2,0,European Championship qualifier,in Norway,3,-3,1671,1240,0,0,45,149,1668,1243,T1
5586,October 10,2015,United States,Mexico,2,3,CONCACAF Cup,in the United States,-22,22,1773,1890,-3,2,23,13,1795,1868,T2
5587,October 11,2015,Armenia,Albania,0,3,European Championship qualifier,in Armenia,-40,40,1485,1619,-12,9,91,56,1525,1579,T2
5588,October 11,2015,Denmark,France,1,2,Friendly,in Denmark,-7,7,1746,1949,-1,0,28,8,1753,1942,T2
5589,October 11,2015,Egypt,Zambia,3,0,Friendly,in the United Arab Emirates,12,-12,1652,1514,1,-2,49,80,1640,1526,T1
5590,October 11,2015,Ethiopia,São Tomé and Príncipe,3,0,World Cup qualifier,in Ethiopia,10,-10,1318,1090,2,-1,129,179,1308,1100,T1
5591,October 11,2015,Faroe Islands,Romania,0,3,European Championship qualifier,in the Faroe Islands,-6,6,1233,1758,-1,3,151,25,1239,1752,T2
5592,October 11,2015,Finland,Northern Ireland,1,1,European Championship qualifier,in Finland,-7,7,1603,1590,-3,0,60,64,1610,1583,draw
5593,October 11,2015,Germany,Georgia,2,1,European Championship qualifier,in Germany,1,-1,2086,1489,0,1,1,88,2085,1490,T1
5594,October 11,2015,Greece,Hungary,4,3,European Championship qualifier,in Greece,19,-19,1622,1661,6,-6,53,48,1603,1680,T1
5595,October 11,2015,Kenya,Mauritius,0,0,World Cup qualifier,in Kenya,-17,17,1376,1087,-6,2,115,180,1393,1070,draw
5596,October 11,2015,Malawi,Tanzania,1,0,World Cup qualifier,in Malawi,12,-12,1355,1277,1,-4,122,139,1343,1289,T1
5597,October 11,2015,Nigeria,Cameroon,3,0,Friendly,in Belgium,18,-18,1644,1615,3,-7,50,58,1626,1633,T1
5598,October 11,2015,Poland,Ireland,2,1,European Championship qualifier,in Poland,15,-15,1754,1744,6,-5,27,30,1739,1759,T1
5599,October 11,2015,Scotland,Gibraltar,6,0,European Championship qualifier,in Portugal,3,-3,1699,1119,1,0,40,175,1696,1122,T1
5600,October 11,2015,Serbia,Portugal,1,2,European Championship qualifier,in Serbia,-16,16,1727,1930,-5,1,35,9,1743,1914,T2
5601,October 12,2015,Austria,Liechtenstein,3,0,European Championship qualifier,in Austria,1,-1,1815,1203,1,-1,16,160,1814,1204,T1
5602,October 12,2015,Belarus,Macedonia,0,0,European Championship qualifier,in Belarus,-13,13,1578,1433,-2,6,65,101,1591,1420,draw
5603,October 12,2015,Democratic Republic of Congo,Gabon,2,1,Friendly,in Belgium,11,-11,1491,1498,7,-5,87,86,1480,1509,T1
5604,October 12,2015,Estonia,Switzerland,0,1,European Championship qualifier,in Estonia,-9,9,1476,1806,-3,0,94,18,1485,1797,T2
5605,October 12,2015,Lithuania,England,0,3,European Championship qualifier,in Lithuania,-6,6,1428,1957,-3,0,104,7,1434,1951,T2
5606,October 12,2015,Luxembourg,Slovakia,2,4,European Championship qualifier,in Luxembourg,-6,6,1238,1726,-3,1,149,36,1244,1720,T2
5607,October 12,2015,Morocco,Guinea,1,1,Friendly,in Morocco,-4,4,1547,1524,0,0,71,78,1551,1520,draw
5608,October 12,2015,Russia,Montenegro,2,0,European Championship qualifier,in Russia,10,-10,1782,1589,2,-1,22,63,1772,1599,T1
5609,October 12,2015,San Marino,Slovenia,0,2,European Championship qualifier,in San Marino,-1,1,884,1623,0,0,205,53,885,1622,T2
5610,October 12,2015,Sweden,Moldova,2,0,European Championship qualifier,in Sweden,4,-4,1750,1360,0,0,28,117,1746,1364,T1
5611,October 12,2015,Ukraine,Spain,0,1,European Championship qualifier,in Ukraine,-17,17,1812,1994,-1,0,17,6,1829,1977,T2
5612,October 13,2015,Algeria,Senegal,1,0,Friendly,in Algeria,7,-7,1674,1659,2,-2,43,48,1667,1666,T1
5613,October 13,2015,Bahrain,Philippines,2,0,World Cup and Asian Cup qualifier,in Bahrain,12,-12,1422,1266,1,-2,107,140,1410,1278,T1
5614,October 13,2015,Belgium,Israel,3,1,European Championship qualifier,in Belgium,5,-5,1919,1580,0,-1,11,65,1914,1585,T1
5615,October 13,2015,Bhutan,Hong Kong,0,1,World Cup and Asian Cup qualifier,in Bhutan,-2,2,571,1183,-1,1,232,163,573,1181,T2
5616,October 13,2015,Botswana,Eritrea,3,1,World Cup qualifier,in Botswana,8,-8,1315,1077,1,0,131,181,1307,1085,T1
5617,October 13,2015,Brazil,Venezuela,3,1,World Cup qualifier,in Brazil,4,-4,2024,1640,0,-1,2,51,2020,1644,T1
5618,October 13,2015,Bulgaria,Azerbaijan,2,0,European Championship qualifier,in Bulgaria,12,-12,1585,1414,2,-2,64,108,1573,1426,T1
5619,October 13,2015,Burundi,Seychelles,2,0,World Cup qualifier,in Burundi,4,-4,1344,954,2,-1,124,192,1340,958,T1
5620,October 13,2015,Canada,Ghana,1,1,Friendly,in the United States,4,-4,1511,1662,1,0,81,46,1507,1666,draw
5621,October 13,2015,Congo,Benin,2,1,Friendly,in Congo,5,-5,1465,1379,2,-5,94,116,1460,1384,T1
5622,October 13,2015,Cyprus,Bosnia and Herzegovina,2,3,European Championship qualifier,in Cyprus,-9,9,1424,1749,-4,2,105,30,1433,1740,T2
5623,October 13,2015,East Timor,Malaysia,0,1,World Cup and Asian Cup qualifier,in East Timor,-6,6,730,1145,0,1,214,172,736,1139,T2
5624,October 13,2015,Ecuador,Bolivia,2,0,World Cup qualifier,in Ecuador,7,-7,1882,1610,0,-1,15,58,1875,1617,T1
5625,October 13,2015,El Salvador,Guatemala,1,1,Friendly,in the United States,-1,1,1484,1451,1,0,91,98,1485,1450,draw
5626,October 13,2015,Guinea-Bissau,Liberia,1,3,World Cup qualifier,in Guinea-Bissau,-33,33,1204,1337,-9,8,159,126,1237,1304,T2
5627,October 13,2015,Honduras,South Africa,1,1,Friendly,in Honduras,-3,3,1530,1538,-1,1,76,73,1533,1535,draw
5628,October 13,2015,Iran,Japan,1,1,Friendly,in Iran,-2,2,1724,1744,-2,-1,38,32,1726,1742,draw
5629,October 13,2015,Italy,Norway,2,1,European Championship qualifier,in Italy,6,-6,1888,1665,0,-1,14,45,1882,1671,T1
5630,October 13,2015,Jordan,Tajikistan,3,0,World Cup and Asian Cup qualifier,in Jordan,6,-6,1552,1223,1,0,71,154,1546,1229,T1
5631,October 13,2015,Kuwait,Lebanon,0,0,World Cup and Asian Cup qualifier,in Kuwait,-11,11,1475,1392,-3,1,93,111,1486,1381,draw
5632,October 13,2015,Kyrgyzstan,Bangladesh,2,0,World Cup and Asian Cup qualifier,in Kyrgyzstan,9,-9,1149,928,1,-1,171,199,1140,937,T1
5633,October 13,2015,Latvia,Kazakhstan,0,1,European Championship qualifier,in Latvia,-32,32,1454,1388,-7,9,97,112,1486,1356,T2
5634,October 13,2015,Lesotho,Comoros,1,1,World Cup qualifier,in Lesotho,-16,16,1177,919,-2,2,164,200,1193,903,draw
5635,October 13,2015,Madagascar,Central African Republic,2,2,World Cup qualifier,in Madagascar,-8,8,1274,1252,-4,2,139,144,1282,1244,draw
5636,October 13,2015,Malta,Croatia,0,1,European Championship qualifier,in Malta,-3,3,1237,1795,0,1,148,20,1240,1792,T2
5637,October 13,2015,Mauritania,South Sudan,4,0,World Cup qualifier,in Mauritania,14,-14,1263,1078,3,-2,141,180,1249,1092,T1
5638,October 13,2015,Mexico,Panama,1,0,Friendly,in Mexico,3,-3,1893,1674,1,0,12,43,1890,1677,T1
5639,October 13,2015,Myanmar,Laos,3,1,World Cup and Asian Cup qualifier,in Thailand,15,-15,1042,815,0,0,185,208,1027,830,T1
5640,October 13,2015,Namibia,Gambia,2,1,World Cup qualifier,in Namibia,14,-14,1371,1329,2,-4,118,128,1357,1343,T1
5641,October 13,2015,Netherlands,Czechia,2,3,European Championship qualifier,in the Netherlands,-34,34,1891,1766,-3,8,13,25,1925,1732,T2
5642,October 13,2015,Niger,Somalia,4,0,World Cup qualifier,in Niger,4,-4,1286,859,0,-1,135,207,1282,863,T1
5643,October 13,2015,North Korea,Yemen,1,0,World Cup and Asian Cup qualifier,in North Korea,2,-2,1533,1155,1,0,75,170,1531,1157,T1
5644,October 13,2015,Oman,India,3,0,World Cup and Asian Cup qualifier,in Oman,2,-2,1518,1025,0,-1,79,186,1516,1027,T1
5645,October 13,2015,Paraguay,Argentina,0,0,World Cup qualifier,in Paraguay,10,-10,1730,2005,4,-1,34,4,1720,2015,draw
5646,October 13,2015,Peru,Chile,3,4,World Cup qualifier,in Peru,-14,14,1783,2019,-3,2,22,3,1797,2005,T2
5647,October 13,2015,Qatar,Maldives,4,0,World Cup and Asian Cup qualifier,in Qatar,2,-2,1558,1022,1,0,68,187,1556,1024,T1
5648,October 13,2015,Sierra Leone,Chad,2,1,World Cup qualifier,in Nigeria,17,-17,1337,1251,2,-4,126,145,1320,1268,T1
5649,October 13,2015,Singapore,Cambodia,2,1,World Cup and Asian Cup qualifier,in Singapore,1,-1,1198,727,0,0,161,215,1197,728,T1
5650,October 13,2015,South Korea,Jamaica,3,0,Friendly,in South Korea,6,-6,1788,1595,1,0,21,61,1782,1601,T1
5651,October 13,2015,Syria,Afghanistan,5,2,World Cup and Asian Cup qualifier,in Oman,6,-6,1507,1072,2,0,83,182,1501,1078,T1
5652,October 13,2015,Trinidad and Tobago,Nicaragua,0,0,Friendly,in Trinidad and Tobago,-9,9,1596,1213,-1,3,60,156,1605,1204,draw
5653,October 13,2015,Turkey,Iceland,1,0,European Championship qualifier,in Turkey,10,-10,1806,1690,2,-2,18,41,1796,1700,T1
5654,October 13,2015,Turkmenistan,Guam,1,0,World Cup and Asian Cup qualifier,in Turkmenistan,3,-3,1247,891,0,0,146,203,1244,894,T1
5655,October 13,2015,Uruguay,Colombia,3,0,World Cup qualifier,in Uruguay,36,-36,1929,1971,2,-2,10,6,1893,2007,T1
5656,October 13,2015,United States,Costa Rica,0,1,Friendly,in the United States,-13,13,1760,1770,-2,2,26,24,1773,1757,T2
5657,October 13,2015,Vietnam,Thailand,0,3,World Cup and Asian Cup qualifier,in Vietnam,-32,32,1213,1408,-11,6,156,109,1245,1376,T2
5658,October 13,2015,Wales,Andorra,2,0,European Championship qualifier,in Wales,1,-1,1680,960,0,0,42,190,1679,961,T1
5659,October 17,2015,Swaziland,Djibouti,2,1,World Cup qualifier,in Swaziland,1,-1,1254,774,0,0,143,211,1253,775,T1
5660,November 3,2015,Cambodia,Brunei,6,1,Friendly,in Cambodia,9,-9,736,603,1,0,214,229,727,612,T1
5661,November 4,2015,Saint Vincent and the Grenadines,Antigua and Barbuda,2,1,Friendly,in Saint Vincent and the Grenadines,9,-9,1186,1246,2,-4,162,146,1177,1255,T1
5662,November 5,2015,United Arab Emirates,Turkmenistan,5,1,Friendly,in the United Arab Emirates,2,-2,1623,1245,2,-1,53,146,1621,1247,T1
5663,November 6,2015,Angola,Namibia,1,0,Friendly tournament,in Angola,8,-8,1444,1363,0,0,100,118,1436,1371,T1
5664,November 6,2015,Democratic Republic of Congo,Zambia,3,0,Friendly tournament,in Angola,28,-28,1519,1486,8,-9,79,89,1491,1514,T1
5665,November 7,2015,Angola,Democratic Republic of Congo,1,0,Friendly tournament,in Angola,14,-14,1458,1505,4,-4,96,83,1444,1519,T1
5666,November 7,2015,Hong Kong,Myanmar,5,0,Friendly,in Hong Kong,8,-8,1191,1034,2,0,162,185,1183,1042,T1
5667,November 7,2015,Namibia,Zambia,0,0,Friendly tournament,in Angola,5,-5,1368,1481,0,-2,118,91,1363,1486,draw
5668,November 7,2015,Vanuatu,Fiji,1,1,Friendly,in Vanuatu,0,0,1174,1281,0,0,167,136,1174,1281,draw
5669,November 9,2015,Palestine,Saudi Arabia,0,0,World Cup and Asian Cup qualifier,in Jordan,11,-11,1320,1519,3,-2,130,78,1309,1530,draw
5670,November 10,2015,Vanuatu,Fiji,2,1,Friendly,in Vanuatu,10,-10,1184,1271,2,-3,165,139,1174,1281,T1
5671,November 11,2015,Estonia,Georgia,3,0,Friendly,in Estonia,13,-13,1489,1476,4,-3,88,91,1476,1489,T1
5672,November 11,2015,Jordan,Malta,2,0,Friendly,in Turkey,4,-4,1556,1233,1,0,70,148,1552,1237,T1
5673,November 11,2015,Mozambique,Gabon,1,0,World Cup qualifier,in Mozambique,25,-25,1338,1473,8,-7,125,93,1313,1498,T1
5674,November 11,2015,Sudan,Zambia,0,1,World Cup qualifier,in Sudan,-18,18,1324,1499,-5,5,130,86,1342,1481,T2
5675,November 12,2015,Afghanistan,Cambodia,3,0,World Cup and Asian Cup qualifier,in Iran,9,-9,1081,727,2,-1,180,215,1072,736,T1
5676,November 12,2015,Andorra,Saint Kitts and Nevis,0,1,Friendly,in Andorra,-5,5,955,1237,-1,4,191,147,960,1232,T2
5677,November 12,2015,Australia,Kyrgyzstan,3,0,World Cup and Asian Cup qualifier,in Australia,2,-2,1700,1147,1,0,39,171,1698,1149,T1
5678,November 12,2015,Benin,Burkina Faso,2,1,World Cup qualifier,in Benin,17,-17,1396,1411,6,-5,110,108,1379,1428,T1
5679,November 12,2015,Bolivia,Venezuela,4,2,World Cup qualifier,in Bolivia,24,-24,1634,1616,6,-6,52,57,1610,1640,T1
5680,November 12,2015,Burundi,Democratic Republic of Congo,2,3,World Cup qualifier,in Burundi,-17,17,1327,1522,-5,6,129,77,1344,1505,T2
5681,November 12,2015,Chile,Colombia,1,1,World Cup qualifier,in Chile,-8,8,2011,1979,0,0,3,6,2019,1971,draw
5682,November 12,2015,China,Bhutan,12,0,World Cup and Asian Cup qualifier,in China,0,0,1560,571,0,0,67,232,1560,571,T1
5683,November 12,2015,Ecuador,Uruguay,2,1,World Cup qualifier,in Ecuador,17,-17,1899,1912,3,-1,12,11,1882,1929,T1
5684,November 12,2015,India,Guam,1,0,World Cup and Asian Cup qualifier,in India,8,-8,1033,883,1,-2,185,205,1025,891,T1
5685,November 12,2015,Iran,Turkmenistan,3,1,World Cup and Asian Cup qualifier,in Iran,2,-2,1726,1243,1,1,37,145,1724,1245,T1
5686,November 12,2015,Lebanon,Laos,7,0,World Cup and Asian Cup qualifier,in Lebanon,2,-2,1394,813,0,0,111,208,1392,815,T1
5687,November 12,2015,Macedonia,Montenegro,4,1,Friendly,in Macedonia,20,-20,1453,1569,2,-3,99,66,1433,1589,T1
5688,November 12,2015,Maldives,Hong Kong,0,1,World Cup and Asian Cup qualifier,in the Maldives,-16,16,1006,1207,0,3,187,159,1022,1191,T2
5689,November 12,2015,Morocco,Equatorial Guinea,2,0,World Cup qualifier,in Morocco,9,-9,1556,1338,2,-1,70,124,1547,1347,T1
5690,November 12,2015,Namibia,Guinea,0,1,World Cup qualifier,in Namibia,-17,17,1351,1541,-4,4,122,73,1368,1524,T2
5691,November 12,2015,Norway,Hungary,0,1,European Championship qualifier,in Norway,-26,26,1639,1687,-6,5,51,42,1665,1661,T2
5692,November 12,2015,Oman,New Zealand,0,1,Friendly,in Oman,-13,13,1505,1521,-5,3,84,78,1518,1508,T2
5693,November 12,2015,Palestine,Malaysia,6,0,World Cup and Asian Cup qualifier,in Jordan,23,-23,1343,1122,8,-2,123,174,1320,1145,T1
5694,November 12,2015,Philippines,Yemen,0,1,World Cup and Asian Cup qualifier,in the Philippines,-31,31,1235,1186,-8,7,148,163,1266,1155,T2
5695,November 12,2015,Singapore,Japan,0,3,World Cup and Asian Cup qualifier,in Singapore,-5,5,1193,1749,-1,2,162,30,1198,1744,T2
5696,November 12,2015,South Korea,Myanmar,4,0,World Cup and Asian Cup qualifier,in South Korea,1,-1,1789,1033,0,0,21,185,1788,1034,T1
5697,November 12,2015,Tajikistan,Bangladesh,5,0,World Cup and Asian Cup qualifier,in Tajikistan,7,-7,1230,921,2,0,152,199,1223,928,T1
5698,November 12,2015,Thailand,Taiwan,4,2,World Cup and Asian Cup qualifier,in Thailand,1,-1,1409,785,0,0,109,210,1408,786,T1
5699,November 12,2015,Togo,Uganda,0,1,World Cup qualifier,in Togo,-23,23,1422,1514,-5,6,105,81,1445,1491,T2
5700,November 12,2015,United Arab Emirates,East Timor,8,0,World Cup and Asian Cup qualifier,in the United Arab Emirates,0,0,1623,730,0,1,53,214,1623,730,T1
5701,November 12,2015,Uzbekistan,North Korea,3,1,World Cup and Asian Cup qualifier,in Uzbekistan,15,-15,1644,1518,3,-5,49,80,1629,1533,T1
5702,November 13,2015,Angola,South Africa,1,3,World Cup qualifier,in Angola,-32,32,1426,1570,-6,9,102,65,1458,1538,T2
5703,November 13,2015,Argentina,Brazil,1,1,World Cup qualifier,in Argentina,-5,5,2000,2029,-1,0,5,2,2005,2024,draw
5704,November 13,2015,Belgium,Italy,3,1,Friendly,in Belgium,10,-10,1929,1878,0,0,10,15,1919,1888,T1
5705,November 13,2015,Bosnia and Herzegovina,Ireland,1,1,European Championship qualifier,in Bosnia and Herzegovina,-6,6,1743,1750,-3,4,33,29,1749,1744,draw
5706,November 13,2015,Canada,Honduras,1,0,World Cup qualifier,in Canada,15,-15,1526,1515,6,-5,76,81,1511,1530,T1
5707,November 13,2015,Comoros,Ghana,0,0,World Cup qualifier,in the Comoros,19,-19,938,1643,2,-3,198,49,919,1662,draw
5708,November 13,2015,Costa Rica,Haiti,1,0,World Cup qualifier,in Costa Rica,4,-4,1774,1499,-1,0,25,86,1770,1503,T1
5709,November 13,2015,Czechia,Serbia,4,1,Friendly,in Czechia,11,-11,1777,1716,1,-2,24,38,1766,1727,T1
5710,November 13,2015,France,Germany,2,0,Friendly,in France,17,-17,1966,2069,1,0,7,1,1949,2086,T1
5711,November 13,2015,Guatemala,Trinidad and Tobago,1,2,World Cup qualifier,in Guatemala,-17,17,1434,1613,1,2,99,58,1451,1596,T2
5712,November 13,2015,Jamaica,Panama,0,2,World Cup qualifier,in Jamaica,-32,32,1563,1706,-6,5,67,39,1595,1674,T2
5713,November 13,2015,Kenya,Cape Verde,1,0,World Cup qualifier,in Kenya,25,-25,1401,1533,7,-7,110,75,1376,1558,T1
5714,November 13,2015,Kosovo,Albania,2,2,Friendly,in Kosovo,4,-4,1391,1615,1,-1,113,57,1387,1619,draw
5715,November 13,2015,Liberia,Ivory Coast,0,1,World Cup qualifier,in Liberia,-6,6,1331,1734,-1,0,127,35,1337,1728,T2
5716,November 13,2015,Libya,Rwanda,1,0,World Cup qualifier,in Tunisia,16,-16,1477,1377,4,-5,91,117,1461,1393,T1
5717,November 13,2015,Luxembourg,Greece,1,0,Friendly,in Luxembourg,17,-17,1255,1605,5,-4,141,59,1238,1622,T1
5718,November 13,2015,Madagascar,Senegal,2,2,World Cup qualifier,in Madagascar,14,-14,1288,1645,3,0,135,47,1274,1659,draw
5719,November 13,2015,Mauritania,Tunisia,1,2,World Cup qualifier,in Mauritania,-11,11,1252,1548,-2,2,142,73,1263,1537,T2
5720,November 13,2015,Mexico,El Salvador,3,0,World Cup qualifier,in Mexico,4,-4,1897,1480,-1,0,14,90,1893,1484,T1
5721,November 13,2015,Niger,Cameroon,0,3,World Cup qualifier,in Niger,-15,15,1271,1630,-3,6,138,52,1286,1615,T2
5722,November 13,2015,Northern Ireland,Latvia,1,0,Friendly,in Northern Ireland,4,-4,1594,1450,1,0,61,98,1590,1454,T1
5723,November 13,2015,Peru,Paraguay,1,0,World Cup qualifier,in Peru,12,-12,1795,1718,2,-3,20,37,1783,1730,T1
5724,November 13,2015,Poland,Iceland,4,2,Friendly,in Poland,8,-8,1762,1682,2,-2,26,43,1754,1690,T1
5725,November 13,2015,Qatar,Turkey,1,2,Friendly,in Qatar,-6,6,1552,1812,-4,1,72,17,1558,1806,T2
5726,November 13,2015,Slovakia,Switzerland,3,2,Friendly,in Slovakia,9,-9,1735,1797,3,-1,34,19,1726,1806,T1
5727,November 13,2015,Spain,England,2,0,Friendly,in Spain,9,-9,2003,1948,1,-1,4,8,1994,1957,T1
5728,November 13,2015,Swaziland,Nigeria,0,0,World Cup qualifier,in Swaziland,14,-14,1268,1630,1,-3,140,52,1254,1644,draw
5729,November 13,2015,United States,Saint Vincent and the Grenadines,6,1,World Cup qualifier,in the United States,2,-2,1762,1184,0,-2,26,165,1760,1186,T1
5730,November 13,2015,Wales,Netherlands,2,3,Friendly,in Wales,-7,7,1673,1898,-2,1,45,13,1680,1891,T2
5731,November 14,2015,Botswana,Mali,2,1,World Cup qualifier,in Botswana,28,-28,1343,1527,10,-4,123,75,1315,1555,T1
5732,November 14,2015,Chad,Egypt,1,0,World Cup qualifier,in Chad,34,-34,1285,1618,7,-8,137,54,1251,1652,T1
5733,November 14,2015,Ethiopia,Congo,3,4,World Cup qualifier,in Ethiopia,-17,17,1301,1482,-2,5,134,90,1318,1465,T2
5734,November 14,2015,Gabon,Mozambique,1,0,World Cup qualifier,in Gabon,8,-8,1481,1330,3,-4,91,128,1473,1338,T1
5735,November 14,2015,Russia,Portugal,1,0,Friendly,in Russia,11,-11,1793,1919,1,-1,22,10,1782,1930,T1
5736,November 14,2015,Sweden,Denmark,2,1,European Championship qualifier,in Sweden,14,-14,1764,1732,3,-3,26,35,1750,1746,T1
5737,November 14,2015,Tanzania,Algeria,2,2,World Cup qualifier,in Tanzania,14,-14,1291,1660,1,-1,135,45,1277,1674,draw
5738,November 14,2015,Ukraine,Slovenia,2,0,European Championship qualifier,in Ukraine,10,-10,1822,1613,1,-3,16,57,1812,1623,T1
5739,November 15,2015,Democratic Republic of Congo,Burundi,2,2,World Cup qualifier,in the Democratic Republic of the Congo,-14,14,1508,1341,-6,5,83,125,1522,1327,draw
5740,November 15,2015,Equatorial Guinea,Morocco,1,0,World Cup qualifier,in Equatorial Guinea,27,-27,1365,1529,7,-6,118,75,1338,1556,T1
5741,November 15,2015,Guinea,Namibia,2,0,World Cup qualifier,in Morocco,15,-15,1556,1336,4,-5,69,127,1541,1351,T1
5742,November 15,2015,Hungary,Norway,2,1,European Championship qualifier,in Hungary,12,-12,1699,1627,1,-3,41,52,1687,1639,T1
5743,November 15,2015,Uganda,Togo,3,0,World Cup qualifier,in Uganda,17,-17,1531,1405,8,-4,74,109,1514,1422,T1
5744,November 15,2015,Zambia,Sudan,2,0,World Cup qualifier,in Zambia,10,-10,1509,1314,4,0,82,132,1499,1324,T1
5745,November 16,2015,Albania,Georgia,2,2,Friendly,in Albania,-6,6,1609,1482,-2,4,58,90,1615,1476,draw
5746,November 16,2015,Ireland,Bosnia and Herzegovina,2,0,European Championship qualifier,in Ireland,21,-21,1771,1722,4,-4,26,36,1750,1743,T1
5747,November 17,2015,Algeria,Tanzania,7,0,World Cup qualifier,in Algeria,6,-6,1666,1285,0,-1,45,136,1660,1291,T1
5748,November 17,2015,Austria,Switzerland,1,2,Friendly,in Austria,-13,13,1802,1810,-3,1,20,18,1815,1797,T2
5749,November 17,2015,Azerbaijan,Moldova,2,1,Friendly,in Azerbaijan,6,-6,1420,1354,1,-2,105,121,1414,1360,T1
5750,November 17,2015,Bangladesh,Australia,0,4,World Cup and Asian Cup qualifier,in Bangladesh,-1,1,920,1701,0,1,200,39,921,1700,T2
5751,November 17,2015,Bhutan,Qatar,0,3,World Cup and Asian Cup qualifier,in Bhutan,0,0,571,1552,0,2,232,69,571,1552,T2
5752,November 17,2015,Brazil,Peru,3,0,World Cup qualifier,in Brazil,9,-9,2038,1786,0,-3,2,23,2029,1795,T1
5753,November 17,2015,Burkina Faso,Benin,2,0,World Cup qualifier,in Burkina Faso,20,-20,1431,1376,7,-5,100,116,1411,1396,T1
5754,November 17,2015,Cambodia,Japan,0,2,World Cup and Asian Cup qualifier,in Cambodia,0,0,727,1749,0,0,215,31,727,1749,T2
5755,November 17,2015,Cameroon,Niger,0,0,World Cup qualifier,in Cameroon,-17,17,1613,1288,-6,4,56,135,1630,1271,draw
5756,November 17,2015,Cape Verde,Kenya,2,0,World Cup qualifier,in Cape Verde,12,-12,1545,1389,1,-2,72,112,1533,1401,T1
5757,November 17,2015,Colombia,Argentina,0,1,World Cup qualifier,in Colombia,-24,24,1955,2024,-1,2,7,3,1979,2000,T2
5758,November 17,2015,Congo,Ethiopia,2,1,World Cup qualifier,in Congo,7,-7,1489,1294,2,0,88,134,1482,1301,T1
5759,November 17,2015,Denmark,Sweden,2,2,European Championship qualifier,in Denmark,-4,4,1728,1768,0,0,34,27,1732,1764,draw
5760,November 17,2015,East Timor,Saudi Arabia,0,10,World Cup and Asian Cup qualifier,in East Timor,-2,2,728,1521,0,0,214,79,730,1519,T2
5761,November 17,2015,Egypt,Chad,4,0,World Cup qualifier,in Egypt,6,-6,1624,1279,2,-1,52,138,1618,1285,T1
5762,November 17,2015,El Salvador,Canada,0,0,World Cup qualifier,in El Salvador,-3,3,1477,1529,1,1,92,76,1480,1526,draw
5763,November 17,2015,England,France,2,0,Friendly,in England,12,-12,1960,1954,2,-1,6,8,1948,1966,T1
5764,November 17,2015,Estonia,Saint Kitts and Nevis,3,0,Friendly,in Estonia,4,-4,1493,1233,1,-1,87,148,1489,1237,T1
5765,November 17,2015,Ghana,Comoros,2,0,World Cup qualifier,in Ghana,1,-1,1644,937,0,0,48,198,1643,938,T1
5766,November 17,2015,Guam,Iran,0,6,World Cup and Asian Cup qualifier,in Guam,-1,1,882,1727,0,-1,205,36,883,1726,T2
5767,November 17,2015,Haiti,Jamaica,0,1,World Cup qualifier,in Haiti,-22,22,1477,1585,-5,5,92,62,1499,1563,T2
5768,November 17,2015,Honduras,Mexico,0,2,World Cup qualifier,in Honduras,-10,10,1505,1907,-5,1,86,13,1515,1897,T2
5769,November 17,2015,Hong Kong,China,0,0,World Cup and Asian Cup qualifier,in Hong Kong,12,-12,1219,1548,4,-3,155,71,1207,1560,draw
5770,November 17,2015,Italy,Romania,2,2,Friendly,in Italy,-6,6,1872,1764,0,1,15,29,1878,1758,draw
5771,November 17,2015,Ivory Coast,Liberia,3,0,World Cup qualifier,in Ivory Coast,4,-4,1738,1327,0,-2,33,130,1734,1331,T1
5772,November 17,2015,Kyrgyzstan,Jordan,1,0,World Cup and Asian Cup qualifier,in Kyrgyzstan,34,-34,1181,1522,5,-9,166,78,1147,1556,T1
5773,November 17,2015,Laos,South Korea,0,5,World Cup and Asian Cup qualifier,in Laos,-1,1,812,1790,0,1,208,22,813,1789,T2
5774,November 17,2015,Luxembourg,Portugal,0,2,Friendly,in Luxembourg,-1,1,1254,1920,-1,-1,143,11,1255,1919,T2
5775,November 17,2015,Macedonia,Lebanon,0,1,Friendly,in Macedonia,-14,14,1439,1408,-2,4,99,108,1453,1394,T2
5776,November 17,2015,Malaysia,United Arab Emirates,1,2,World Cup and Asian Cup qualifier,in Malaysia,-4,4,1118,1627,-1,3,175,50,1122,1623,T2
5777,November 17,2015,Mali,Botswana,2,0,World Cup qualifier,in Mali,10,-10,1537,1333,3,-4,73,127,1527,1343,T1
5778,November 17,2015,Nigeria,Swaziland,2,0,World Cup qualifier,in Nigeria,4,-4,1634,1264,1,-1,49,142,1630,1268,T1
5779,November 17,2015,North Korea,Bahrain,2,0,World Cup and Asian Cup qualifier,in North Korea,15,-15,1533,1407,6,-4,74,109,1518,1422,T1
5780,November 17,2015,Panama,Costa Rica,1,2,World Cup qualifier,in Panama,-22,22,1684,1796,-3,4,42,21,1706,1774,T2
5781,November 17,2015,Paraguay,Bolivia,2,1,World Cup qualifier,in Paraguay,10,-10,1728,1624,3,-3,34,52,1718,1634,T1
5782,November 17,2015,Poland,Czechia,3,1,Friendly,in Poland,11,-11,1773,1766,3,-4,25,28,1762,1777,T1
5783,November 17,2015,Russia,Croatia,1,3,Friendly,in Russia,-19,19,1774,1814,-2,3,24,17,1793,1795,T2
5784,November 17,2015,Rwanda,Libya,1,3,World Cup qualifier,in Rwanda,-30,30,1347,1507,-5,10,122,84,1377,1477,T2
5785,November 17,2015,Senegal,Madagascar,3,0,World Cup qualifier,in Senegal,5,-5,1650,1283,0,-1,46,137,1645,1288,T1
5786,November 17,2015,Singapore,Syria,1,2,World Cup and Asian Cup qualifier,in Singapore,-9,9,1184,1516,-1,3,163,81,1193,1507,T2
5787,November 17,2015,Slovakia,Iceland,3,1,Friendly,in Slovakia,9,-9,1744,1673,0,0,32,43,1735,1682,T1
5788,November 17,2015,Slovenia,Ukraine,1,1,European Championship qualifier,in Slovenia,6,-6,1619,1816,2,0,54,16,1613,1822,draw
5789,November 17,2015,South Africa,Angola,1,0,World Cup qualifier,in South Africa,8,-8,1578,1418,0,-4,65,106,1570,1426,T1
5790,November 17,2015,Saint Vincent and the Grenadines,Guatemala,0,4,World Cup qualifier,in Saint Vincent and the Grenadines,-22,22,1162,1456,-5,3,170,96,1184,1434,T2
5791,November 17,2015,Taiwan,Iraq,0,2,World Cup and Asian Cup qualifier,in Taiwan,-2,2,783,1507,0,1,210,84,785,1505,T2
5792,November 17,2015,Trinidad and Tobago,United States,0,0,World Cup qualifier,in Trinidad and Tobago,3,-3,1616,1759,1,-2,55,30,1613,1762,draw
5793,November 17,2015,Tunisia,Mauritania,2,1,World Cup qualifier,in Tunisia,4,-4,1552,1248,3,-2,69,145,1548,1252,T1
5794,November 17,2015,Turkey,Greece,0,0,Friendly,in Turkey,-7,7,1805,1612,-1,2,19,57,1812,1605,draw
5795,November 17,2015,Turkmenistan,Oman,2,1,World Cup and Asian Cup qualifier,in Turkmenistan,29,-29,1272,1476,6,-9,140,94,1243,1505,T1
5796,November 17,2015,Uruguay,Chile,3,0,World Cup qualifier,in Uruguay,35,-35,1947,1976,2,-2,9,5,1912,2011,T1
5797,November 17,2015,Uzbekistan,Yemen,3,1,World Cup and Asian Cup qualifier,in Qatar,4,-4,1648,1182,0,-2,47,165,1644,1186,T1
5798,November 17,2015,Venezuela,Ecuador,1,3,World Cup qualifier,in Venezuela,-16,16,1600,1915,-5,0,60,12,1616,1899,T2
5799,November 21,2015,Burundi,Zanzibar,1,0,CECAFA Cup,in Ethiopia,16,-16,1357,1261,3,-3,121,142,1341,1277,T1
5800,November 21,2015,Ethiopia,Rwanda,0,1,CECAFA Cup,in Ethiopia,-23,23,1271,1370,-5,5,139,117,1294,1347,T2
5801,November 22,2015,Kenya,Uganda,2,0,CECAFA Cup,in Ethiopia,42,-42,1431,1489,12,-12,100,87,1389,1531,T1
5802,November 22,2015,Tanzania,Somalia,4,0,CECAFA Cup,in Ethiopia,6,-6,1291,853,1,0,134,207,1285,859,T1
5803,November 23,2015,Malawi,Sudan,2,1,CECAFA Cup,in Ethiopia,18,-18,1373,1296,5,-1,117,133,1355,1314,T1
5804,November 23,2015,South Sudan,Djibouti,2,0,CECAFA Cup,in Ethiopia,9,-9,1087,765,2,-1,179,212,1078,774,T1
5805,November 24,2015,Tanzania,Rwanda,2,1,CECAFA Cup,in Ethiopia,24,-24,1315,1346,2,-5,132,123,1291,1370,T1
5806,November 24,2015,Uganda,Zanzibar,4,0,CECAFA Cup,in Ethiopia,16,-16,1505,1245,2,-4,85,146,1489,1261,T1
5807,November 25,2015,Burundi,Kenya,1,1,CECAFA Cup,in Ethiopia,4,-4,1361,1427,2,-3,119,103,1357,1431,draw
5808,November 25,2015,Ethiopia,Somalia,2,0,CECAFA Cup,in Ethiopia,3,-3,1274,850,1,0,138,207,1271,853,T1
5809,November 25,2015,Malawi,Djibouti,3,0,CECAFA Cup,in Ethiopia,2,-2,1375,763,0,-1,117,213,1373,765,T1
5810,November 25,2015,South Sudan,Sudan,0,0,CECAFA Cup,in Ethiopia,11,-11,1098,1285,1,-1,178,135,1087,1296,draw
5811,November 27,2015,Rwanda,Somalia,3,0,CECAFA Cup,in Ethiopia,4,-4,1350,846,1,0,122,207,1346,850,T1
5812,November 27,2015,South Sudan,Malawi,2,0,CECAFA Cup,in Ethiopia,50,-50,1148,1325,6,-14,172,131,1098,1375,T1
5813,November 27,2015,Sudan,Djibouti,4,0,CECAFA Cup,in Ethiopia,4,-4,1289,759,1,0,134,213,1285,763,T1
5814,November 27,2015,Zanzibar,Kenya,3,1,CECAFA Cup,in Ethiopia,44,-44,1289,1383,12,-10,134,113,1245,1427,T1
5815,November 28,2015,Ethiopia,Tanzania,1,1,CECAFA Cup,in Ethiopia,-3,3,1271,1318,-1,0,140,132,1274,1315,draw
5816,November 28,2015,Uganda,Burundi,1,0,CECAFA Cup,in Ethiopia,12,-12,1517,1349,5,-4,80,122,1505,1361,T1
5817,November 30,2015,Ethiopia,Tanzania,1,1,CECAFA Cup,in Ethiopia,-3,3,1268,1321,-1,1,141,131,1271,1318,draw
5818,November 30,2015,Uganda,Malawi,2,0,CECAFA Cup,in Ethiopia,15,-15,1532,1310,5,-1,75,132,1517,1325,T1
5819,December 1,2015,Kenya,Rwanda,0,0,CECAFA Cup,in Ethiopia,-2,2,1381,1352,0,0,113,121,1383,1350,draw
5820,December 1,2015,South Sudan,Sudan,0,0,CECAFA Cup,in Ethiopia,8,-8,1156,1281,0,-3,172,137,1148,1289,draw
5821,December 3,2015,Ethiopia,Uganda,0,0,CECAFA Cup,in Ethiopia,9,-9,1277,1523,2,-2,139,77,1268,1532,draw
5822,December 3,2015,Rwanda,Sudan,1,1,CECAFA Cup,in Ethiopia,-4,4,1348,1285,-1,1,122,136,1352,1281,draw
5823,December 5,2015,Ethiopia,Sudan,1,1,CECAFA Cup,in Ethiopia,-5,5,1272,1290,0,2,139,134,1277,1285,draw
5824,December 5,2015,Uganda,Rwanda,1,0,CECAFA Cup,in Ethiopia,11,-11,1534,1337,3,-1,74,123,1523,1348,T1
5825,December 8,2015,Nicaragua,Cuba,5,0,Friendly,in Nicaragua,24,-24,1237,1356,10,-4,147,119,1213,1380,T1
5826,December 11,2015,Nicaragua,Cuba,1,0,Friendly,in Nicaragua,11,-11,1248,1345,2,-2,145,121,1237,1356,T1
5827,December 15,2015,Costa Rica,Nicaragua,1,0,Friendly,in Costa Rica,0,0,1796,1248,0,0,21,145,1796,1248,T1
5828,December 16,2015,Honduras,Cuba,2,0,Friendly,in Honduras,5,-5,1510,1340,4,-1,82,122,1505,1345,T1
5829,December 17,2015,Bangladesh,Nepal,1,0,Friendly,in Bangladesh,6,-6,926,881,0,-2,200,205,920,887,T1
5830,December 23,2015,Sri Lanka,Nepal,1,0,South Asian Cup,in India,26,-26,792,855,1,-1,210,206,766,881,T1
5831,December 24,2015,Afghanistan,Bangladesh,4,0,South Asian Cup,in India,22,-22,1103,904,2,-2,179,202,1081,926,T1
5832,December 24,2015,Maldives,Bhutan,3,1,South Asian Cup,in India,5,-5,1011,566,0,0,187,232,1006,571,T1
5833,December 25,2015,India,Sri Lanka,2,0,South Asian Cup,in India,7,-7,1040,785,0,0,185,210,1033,792,T1
5834,December 26,2015,Afghanistan,Bhutan,3,0,South Asian Cup,in India,3,-3,1106,563,1,-2,178,234,1103,566,T1
5835,December 26,2015,Maldives,Bangladesh,3,1,South Asian Cup,in India,21,-21,1032,883,0,-1,187,203,1011,904,T1
5836,December 26,2015,Martinique,Guadeloupe,2,0,Friendly,in Martinique,7,-7,1436,1320,1,-2,100,131,1429,1327,T1
5837,December 27,2015,India,Nepal,4,1,South Asian Cup,in India,11,-11,1051,844,0,-1,185,207,1040,855,T1
5838,December 28,2015,Afghanistan,Maldives,4,1,South Asian Cup,in India,28,-28,1134,1004,4,0,174,187,1106,1032,T1
5839,December 28,2015,Bangladesh,Bhutan,3,0,South Asian Cup,in India,10,-10,893,553,1,0,202,234,883,563,T1
5840,December 31,2015,Afghanistan,Sri Lanka,5,0,South Asian Cup,in India,9,-9,1143,776,0,-1,174,211,1134,785,T1
5841,January 3,2016,India,Afghanistan,2,1,South Asian Cup,in India,19,-19,1082,1124,2,0,182,174,1063,1143,T1
5842,January 6,2016,Estonia,Sweden,1,1,Friendly,in the United Arab Emirates,7,-7,1500,1761,0,-2,87,29,1493,1768,draw
5843,January 8,2016,Bangladesh,Sri Lanka,4,2,Friendly tournament,in Bangladesh,10,-10,903,766,0,0,202,211,893,776,T1
5844,January 8,2016,Haiti,Trinidad and Tobago,1,0,Copa América qualifier,in Panama,28,-28,1505,1588,5,-6,87,61,1477,1616,T1
5845,January 8,2016,Panama,Cuba,4,0,Copa América qualifier,in Panama,5,-5,1689,1335,0,-3,42,125,1684,1340,T1
5846,January 10,2016,Sweden,Finland,3,0,Friendly,in the United Arab Emirates,10,-10,1771,1593,3,-2,26,60,1761,1603,T1
5847,January 11,2016,Maldives,Cambodia,3,2,Friendly tournament,in Bangladesh,5,-5,997,722,1,-1,187,216,992,727,T1
5848,January 13,2016,Iceland,Finland,1,0,Friendly,in the United Arab Emirates,8,-8,1681,1585,0,-1,43,61,1673,1593,T1
5849,January 13,2016,Nepal,Sri Lanka,1,0,Friendly tournament,in Bangladesh,12,-12,856,754,1,-2,206,213,844,766,T1
5850,January 15,2016,Bangladesh,Nepal,0,0,Friendly tournament,in Bangladesh,-6,6,897,862,0,1,202,205,903,856,draw
5851,January 16,2016,United Arab Emirates,Iceland,2,1,Friendly,in the United Arab Emirates,9,-9,1636,1672,1,-1,49,44,1627,1681,T1
5852,January 19,2016,Nepal,Maldives,4,1,Friendly tournament,in Bangladesh,36,-36,898,961,3,-2,202,189,862,997,T1
5853,January 27,2016,Egypt,Jordan,0,1,Friendly,in Egypt,-15,15,1609,1537,-4,5,56,73,1624,1522,T2
5854,January 27,2016,Nicaragua,Honduras,1,3,Friendly,in Nicaragua,-8,8,1240,1518,-2,1,147,81,1248,1510,T2
5855,January 29,2016,Egypt,Libya,2,0,Friendly,in Egypt,7,-7,1616,1500,2,-2,54,87,1609,1507,T1
5856,January 31,2016,United States,Iceland,3,2,Friendly,in the United States,5,-5,1764,1667,1,0,29,44,1759,1672,T1
5857,February 2,2016,Venezuela,Costa Rica,1,0,Friendly,in Venezuela,13,-13,1613,1783,3,-2,55,23,1600,1796,T1
5858,February 5,2016,Bahrain,Lebanon,2,0,Friendly,in Bahrain,11,-11,1418,1397,3,-2,106,110,1407,1408,T1
5859,February 5,2016,United States,Canada,1,0,Friendly,in the United States,3,-3,1767,1526,1,-1,28,78,1764,1529,T1
5860,February 6,2016,Guadeloupe,Martinique,1,1,Friendly,in Guadeloupe,0,0,1320,1436,0,0,131,100,1320,1436,draw
5861,February 10,2016,Guatemala,Honduras,3,1,Friendly,in Guatemala,13,-13,1469,1505,0,-4,96,85,1456,1518,T1
5862,February 14,2016,Uzbekistan,Lebanon,2,0,Friendly,in the United Arab Emirates,6,-6,1654,1391,1,0,46,110,1648,1397,T1
5863,February 17,2016,Panama,El Salvador,1,0,Friendly,in Panama,3,-3,1692,1474,0,-2,42,95,1689,1477,T1
5864,February 21,2016,Guyana,Suriname,2,0,Friendly,in Guyana,8,-8,1235,1154,5,-2,149,172,1227,1162,T1
5865,February 21,2016,Saint Kitts and Nevis,Bermuda,3,0,Friendly,in Saint Kitts and Nevis,13,-13,1246,1220,3,-6,146,155,1233,1233,T1
5866,February 25,2016,French Guiana,Suriname,2,3,Friendly,in French Guiana,-16,16,1289,1170,-1,3,134,169,1305,1154,T2
5867,March 2,2016,Guatemala,El Salvador,1,0,Friendly,in Guatemala,7,-7,1476,1467,3,-1,93,96,1469,1474,T1
5868,March 9,2016,Nicaragua,El Salvador,1,1,Friendly,in Nicaragua,4,-4,1244,1463,0,0,148,96,1240,1467,draw
5869,March 13,2016,Sint Maarten,Anguilla,2,0,Friendly,in Sint Maarten,2,-2,932,571,0,0,199,231,930,573,T1
5870,March 13,2016,Saint Vincent and the Grenadines,Martinique,0,4,Friendly,in Saint Vincent and the Grenadines,-10,10,1152,1446,-1,1,172,99,1162,1436,T2
5871,March 15,2016,Nicaragua,Panama,1,0,Friendly,in Nicaragua,18,-18,1262,1674,5,0,143,42,1244,1692,T1
5872,March 18,2016,Syria,Iraq,1,0,Friendly,in Iran,10,-10,1526,1497,3,-4,78,88,1516,1507,T1
5873,March 18,2016,United Arab Emirates,Bangladesh,6,1,Friendly,in the United Arab Emirates,0,0,1636,897,0,0,49,203,1636,897,T1
5874,March 19,2016,Grenada,Trinidad and Tobago,2,2,Friendly,in Grenada,8,-8,1132,1580,0,-3,174,63,1124,1588,draw
5875,March 19,2016,Taiwan,Guam,3,2,Friendly,in Taiwan,10,-10,793,872,0,0,210,205,783,882,T1
5876,March 22,2016,Cuba,Bermuda,2,1,CONCACAF Champ &amp; Carib Champ qual,in Cuba,9,-9,1344,1211,4,-3,121,158,1335,1220,T1
5877,March 22,2016,Grenada,Sint Maarten,5,0,CONCACAF Champ &amp; Carib Champ qual,in Grenada,12,-12,1144,920,0,0,174,199,1132,932,T1
5878,March 22,2016,Guyana,Anguilla,7,0,CONCACAF Champ &amp; Carib Champ qual,in Guyana,1,-1,1236,570,0,0,149,231,1235,571,T1
5879,March 22,2016,Sierra Leone,Malawi,1,1,Friendly,in Sierra Leone,-4,4,1333,1314,-3,0,125,132,1337,1310,draw
5880,March 23,2016,Antigua and Barbuda,Aruba,2,1,CONCACAF Champ &amp; Carib Champ qual,in Antigua and Barbuda,4,-4,1250,938,1,0,146,197,1246,942,T1
5881,March 23,2016,Barbados,Curaçao,1,0,CONCACAF Champ &amp; Carib Champ qual,in Barbados,13,-13,1158,1103,2,-2,171,180,1145,1116,T1
5882,March 23,2016,Chad,Tanzania,0,1,African Nations Cup qualifier,in Chad,-23,23,1256,1344,-5,9,143,121,1279,1321,T2
5883,March 23,2016,Croatia,Israel,2,0,Friendly,in Croatia,4,-4,1818,1576,1,-3,16,66,1814,1580,T1
5884,March 23,2016,Gibraltar,Liechtenstein,0,0,Friendly,in Gibraltar,0,0,1119,1203,-1,0,177,161,1119,1203,draw
5885,March 23,2016,Guadeloupe,Suriname,0,0,CONCACAF Champ &amp; Carib Champ qual,in Guadeloupe,-12,12,1308,1182,-1,4,132,165,1320,1170,draw
5886,March 23,2016,Guinea-Bissau,Kenya,1,0,African Nations Cup qualifier,in Guinea-Bissau,24,-24,1228,1357,6,-5,154,118,1204,1381,T1
5887,March 23,2016,Martinique,British Virgin Islands,3,0,CONCACAF Champ &amp; Carib Champ qual,in Martinique,0,0,1446,627,0,0,99,227,1446,627,T1
5888,March 23,2016,Poland,Serbia,1,0,Friendly,in Poland,6,-6,1779,1710,1,0,24,38,1773,1716,T1
5889,March 23,2016,Romania,Lithuania,1,0,Friendly,in Romania,2,-2,1766,1426,1,0,29,102,1764,1428,T1
5890,March 23,2016,São Tomé and Príncipe,Libya,2,1,African Nations Cup qualifier,in São Tomé and Príncipe,34,-34,1124,1466,5,-9,175,95,1090,1500,T1
5891,March 23,2016,Slovenia,Macedonia,1,0,Friendly,in Slovenia,3,-3,1622,1436,0,0,53,100,1619,1439,T1
5892,March 23,2016,South Sudan,Benin,1,2,African Nations Cup qualifier,in South Sudan,-13,13,1143,1389,-3,3,174,112,1156,1376,T2
5893,March 23,2016,Zambia,Congo,1,1,African Nations Cup qualifier,in Zambia,-7,7,1502,1496,-3,1,85,88,1509,1489,draw
5894,March 24,2016,Australia,Tajikistan,7,0,World Cup and Asian Cup qualifier,in Australia,3,-3,1704,1227,-1,-1,40,154,1701,1230,T1
5895,March 24,2016,Bahrain,Yemen,3,0,World Cup and Asian Cup qualifier,in Bahrain,9,-9,1427,1173,4,-4,102,169,1418,1182,T1
5896,March 24,2016,Bolivia,Colombia,2,3,World Cup qualifier,in Bolivia,-8,8,1616,1963,-3,2,55,5,1624,1955,T2
5897,March 24,2016,Chile,Argentina,1,2,World Cup qualifier,in Chile,-23,23,1953,2047,-3,1,8,2,1976,2024,T2
5898,March 24,2016,China,Maldives,4,0,World Cup and Asian Cup qualifier,in China,1,-1,1549,960,0,-1,71,190,1548,961,T1
5899,March 24,2016,Comoros,Botswana,1,0,African Nations Cup qualifier,in the Comoros,34,-34,971,1299,9,-6,189,132,937,1333,T1
5900,March 24,2016,Czechia,Scotland,0,1,Friendly,in Czechia,-14,14,1752,1713,-1,2,30,38,1766,1699,T2
5901,March 24,2016,Denmark,Iceland,2,1,Friendly,in Denmark,6,-6,1734,1661,-1,-1,35,45,1728,1667,T1
5902,March 24,2016,Djibouti,Liberia,0,1,African Nations Cup qualifier,in Djibouti,-3,3,756,1330,0,3,212,127,759,1327,T2
5903,March 24,2016,Ecuador,Paraguay,2,2,World Cup qualifier,in Ecuador,-14,14,1901,1742,-1,1,13,33,1915,1728,draw
5904,March 24,2016,Estonia,Norway,0,0,Friendly,in Estonia,1,-1,1501,1626,0,0,86,51,1500,1627,draw
5905,March 24,2016,Ghana,Mozambique,3,1,African Nations Cup qualifier,in Ghana,5,-5,1649,1325,0,-1,48,129,1644,1330,T1
5906,March 24,2016,Greece,Montenegro,2,1,Friendly,in Greece,6,-6,1618,1563,3,0,54,67,1612,1569,T1
5907,March 24,2016,Iran,India,4,0,World Cup and Asian Cup qualifier,in Iran,1,-1,1728,1081,0,0,36,182,1727,1082,T1
5908,March 24,2016,Iraq,Thailand,2,2,World Cup and Asian Cup qualifier,in Iran,-5,5,1492,1414,-1,0,88,108,1497,1409,draw
5909,March 24,2016,Italy,Spain,1,1,Friendly,in Italy,1,-1,1873,2002,0,0,15,4,1872,2003,draw
5910,March 24,2016,Japan,Afghanistan,5,0,World Cup and Asian Cup qualifier,in Japan,1,-1,1750,1123,0,-1,31,176,1749,1124,T1
5911,March 24,2016,Jordan,Bangladesh,8,0,World Cup and Asian Cup qualifier,in Jordan,1,-1,1538,896,0,0,73,203,1537,897,T1
5912,March 24,2016,Madagascar,Central African Republic,1,1,African Nations Cup qualifier,in Madagascar,-7,7,1276,1259,0,2,137,143,1283,1252,draw
5913,March 24,2016,Malta,Moldova,0,0,Friendly,in Malta,1,-1,1234,1353,1,0,150,119,1233,1354,draw
5914,March 24,2016,Oman,Guam,1,0,World Cup and Asian Cup qualifier,in Oman,1,-1,1477,871,0,0,92,205,1476,872,T1
5915,March 24,2016,Peru,Venezuela,2,2,World Cup qualifier,in Peru,-13,13,1773,1626,-3,4,25,51,1786,1613,draw
5916,March 24,2016,Qatar,Hong Kong,2,0,World Cup and Asian Cup qualifier,in Qatar,5,-5,1557,1214,1,-2,68,158,1552,1219,T1
5917,March 24,2016,Saudi Arabia,Malaysia,2,0,World Cup and Asian Cup qualifier,in Saudi Arabia,3,-3,1524,1115,0,0,80,178,1521,1118,T1
5918,March 24,2016,Singapore,Myanmar,2,1,Friendly,in Singapore,4,-4,1188,1029,1,0,162,186,1184,1033,T1
5919,March 24,2016,Solomon Islands,Papua New Guinea,2,0,Friendly,in the Solomon Islands,7,-7,1183,1047,4,0,165,185,1176,1054,T1
5920,March 24,2016,South Korea,Lebanon,1,0,World Cup and Asian Cup qualifier,in South Korea,2,-2,1792,1389,0,-1,21,111,1790,1391,T1
5921,March 24,2016,Syria,Cambodia,6,0,World Cup and Asian Cup qualifier,in Oman,1,-1,1527,721,0,0,78,216,1526,722,T1
5922,March 24,2016,Turkey,Sweden,2,1,Friendly,in Turkey,6,-6,1811,1765,1,-3,18,29,1805,1771,T1
5923,March 24,2016,United Arab Emirates,Palestine,2,0,World Cup and Asian Cup qualifier,in the United Arab Emirates,6,-6,1642,1337,0,0,49,123,1636,1343,T1
5924,March 24,2016,Ukraine,Cyprus,1,0,Friendly,in Ukraine,1,-1,1817,1423,0,-2,17,105,1816,1424,T1
5925,March 24,2016,Uzbekistan,Philippines,1,0,World Cup and Asian Cup qualifier,in Uzbekistan,2,-2,1656,1233,0,-1,46,151,1654,1235,T1
5926,March 24,2016,Vietnam,Taiwan,4,1,World Cup and Asian Cup qualifier,in Vietnam,3,-3,1216,790,1,0,157,210,1213,793,T1
5927,March 24,2016,Wales,Northern Ireland,1,1,Friendly,in Wales,-5,5,1668,1599,0,0,43,59,1673,1594,draw
5928,March 25,2016,Algeria,Ethiopia,7,1,African Nations Cup qualifier,in Algeria,5,-5,1671,1267,2,-2,42,140,1666,1272,T1
5929,March 25,2016,Armenia,Belarus,0,0,Friendly,in Armenia,0,0,1485,1578,-1,0,90,64,1485,1578,draw
5930,March 25,2016,Brazil,Uruguay,2,2,World Cup qualifier,in Brazil,-10,10,2028,1957,0,1,3,8,2038,1947,draw
5931,March 25,2016,Canada,Mexico,0,3,World Cup qualifier,in Canada,-12,12,1514,1919,-3,1,82,11,1526,1907,T2
5932,March 25,2016,El Salvador,Honduras,2,2,World Cup qualifier,in El Salvador,-3,3,1460,1508,0,-1,96,84,1463,1505,draw
5933,March 25,2016,Gabon,Sierra Leone,2,1,Friendly,in Gabon,4,-4,1485,1329,1,-1,90,127,1481,1333,T1
5934,March 25,2016,Guatemala,United States,2,0,World Cup qualifier,in Guatemala,45,-45,1521,1722,13,-10,80,37,1476,1767,T1
5935,March 25,2016,Guinea,Malawi,0,0,African Nations Cup qualifier,in Guinea,-15,15,1541,1329,-4,3,73,127,1556,1314,draw
5936,March 25,2016,Haiti,Panama,0,0,World Cup qualifier,in Haiti,4,-4,1509,1670,0,-1,83,43,1505,1674,draw
5937,March 25,2016,Ireland,Switzerland,1,0,Friendly,in Ireland,8,-8,1779,1802,4,0,22,19,1771,1810,T1
5938,March 25,2016,Ivory Coast,Sudan,1,0,African Nations Cup qualifier,in Ivory Coast,2,-2,1740,1288,2,-2,32,135,1738,1290,T1
5939,March 25,2016,Jamaica,Costa Rica,1,1,World Cup qualifier,in Jamaica,5,-5,1590,1778,-1,-2,61,24,1585,1783,draw
5940,March 25,2016,Luxembourg,Bosnia and Herzegovina,0,3,Friendly,in Luxembourg,-4,4,1250,1726,-1,1,146,36,1254,1722,T2
5941,March 25,2016,Mali,Equatorial Guinea,1,0,African Nations Cup qualifier,in Mali,7,-7,1544,1358,2,-1,72,116,1537,1365,T1
5942,March 25,2016,Mauritania,Gambia,2,1,African Nations Cup qualifier,in Mauritania,19,-19,1267,1310,7,-2,140,130,1248,1329,T1
5943,March 25,2016,Netherlands,France,2,3,Friendly,in the Netherlands,-11,11,1887,1965,0,2,14,5,1898,1954,T2
5944,March 25,2016,Nigeria,Egypt,1,1,African Nations Cup qualifier,in Nigeria,-7,7,1627,1623,0,2,50,53,1634,1616,draw
5945,March 25,2016,Portugal,Bulgaria,0,1,Friendly,in Portugal,-18,18,1902,1603,-1,1,12,59,1920,1585,T2
5946,March 25,2016,Slovakia,Latvia,0,0,Friendly,in Slovakia,-8,8,1736,1458,-1,1,33,97,1744,1450,draw
5947,March 25,2016,Saint Vincent and the Grenadines,Trinidad and Tobago,2,3,World Cup qualifier,in Saint Vincent and the Grenadines,-5,5,1147,1585,0,1,172,62,1152,1580,T2
5948,March 25,2016,Swaziland,Zimbabwe,1,1,African Nations Cup qualifier,in Swaziland,0,0,1264,1360,-1,1,142,115,1264,1360,draw
5949,March 25,2016,Tunisia,Togo,1,0,African Nations Cup qualifier,in Tunisia,8,-8,1560,1397,2,0,68,109,1552,1405,T1
5950,March 26,2016,Anguilla,Puerto Rico,0,4,CONCACAF Champ &amp; Carib Champ qual,in Anguilla,-7,7,563,1072,-2,0,233,184,570,1065,T2
5951,March 26,2016,Aruba,Saint Kitts and Nevis,0,2,CONCACAF Champ &amp; Carib Champ qual,in Aruba,-14,14,924,1260,0,4,198,144,938,1246,T2
5952,March 26,2016,Austria,Albania,2,1,Friendly,in Austria,3,-3,1805,1606,0,1,19,57,1802,1609,T1
5953,March 26,2016,Bermuda,French Guiana,2,1,CONCACAF Champ &amp; Carib Champ qual,in Bermuda,19,-19,1230,1270,6,-6,153,139,1211,1289,T1
5954,March 26,2016,British Virgin Islands,Dominica,0,7,CONCACAF Champ &amp; Carib Champ qual,in the British Virgin Islands,-19,19,608,976,-1,1,228,190,627,957,T2
5955,March 26,2016,Burkina Faso,Uganda,1,0,African Nations Cup qualifier,in Burkina Faso,20,-20,1451,1514,2,-7,99,82,1431,1534,T1
5956,March 26,2016,Burundi,Namibia,1,3,African Nations Cup qualifier,in Burundi,-39,39,1310,1375,-8,10,128,115,1349,1336,T2
5957,March 26,2016,Cameroon,South Africa,2,2,African Nations Cup qualifier,in Cameroon,-7,7,1606,1585,0,2,57,62,1613,1578,draw
5958,March 26,2016,Cape Verde,Morocco,0,1,African Nations Cup qualifier,in Cape Verde,-26,26,1519,1555,-9,7,80,70,1545,1529,T2
5959,March 26,2016,Curaçao,Dominican Republic,2,1,CONCACAF Champ &amp; Carib Champ qual,in Curaçao,18,-18,1121,1148,3,0,177,170,1103,1166,T1
5960,March 26,2016,Democratic Republic of Congo,Angola,2,1,African Nations Cup qualifier,in the Democratic Republic of the Congo,10,-10,1518,1408,3,-1,81,108,1508,1418,T1
5961,March 26,2016,Germany,England,2,3,Friendly,in Germany,-15,15,2054,1975,0,2,1,5,2069,1960,T2
5962,March 26,2016,Hungary,Croatia,1,1,Friendly,in Hungary,1,-1,1700,1817,0,0,41,16,1699,1818,draw
5963,March 26,2016,Kazakhstan,Azerbaijan,1,0,Friendly,in Turkey,11,-11,1399,1409,4,-1,109,107,1388,1420,T1
5964,March 26,2016,Mauritius,Rwanda,1,0,African Nations Cup qualifier,in Mauritius,28,-28,1115,1309,2,-7,179,130,1087,1337,T1
5965,March 26,2016,Poland,Finland,5,0,Friendly,in Poland,6,-6,1785,1579,0,-2,22,64,1779,1585,T1
5966,March 26,2016,Russia,Lithuania,3,0,Friendly,in Russia,2,-2,1776,1424,0,0,25,103,1774,1426,T1
5967,March 26,2016,Senegal,Niger,2,0,African Nations Cup qualifier,in Senegal,4,-4,1654,1284,0,0,47,135,1650,1288,T1
5968,March 26,2016,Seychelles,Lesotho,2,0,African Nations Cup qualifier,in the Seychelles,40,-40,994,1137,5,-6,188,174,954,1177,T1
5969,March 26,2016,Sint Maarten,US Virgin Islands,1,2,CONCACAF Champ &amp; Carib Champ qual,in Sint Maarten,-34,34,886,740,-4,4,203,214,920,706,T2
5970,March 26,2016,Vanuatu,New Caledonia,2,1,Friendly,in Vanuatu,12,-12,1196,1346,2,-4,162,120,1184,1358,T1
5971,March 27,2016,Benin,South Sudan,4,1,African Nations Cup qualifier,in Benin,8,-8,1397,1135,2,-1,110,174,1389,1143,T1
5972,March 27,2016,Botswana,Comoros,2,1,African Nations Cup qualifier,in Botswana,3,-3,1302,968,0,0,132,191,1299,971,T1
5973,March 27,2016,Congo,Zambia,1,1,African Nations Cup qualifier,in Congo,-5,5,1491,1507,-1,0,89,86,1496,1502,draw
5974,March 27,2016,Kenya,Guinea-Bissau,0,1,African Nations Cup qualifier,in Kenya,-32,32,1325,1260,-9,10,127,144,1357,1228,T2
5975,March 27,2016,Mozambique,Ghana,0,0,African Nations Cup qualifier,in Mozambique,11,-11,1336,1638,4,-1,123,49,1325,1649,draw
5976,March 27,2016,Romania,Spain,0,0,Friendly,in Romania,4,-4,1770,1998,0,0,27,4,1766,2002,draw
5977,March 27,2016,Solomon Islands,Papua New Guinea,1,2,Friendly,in the Solomon Islands,-16,16,1167,1063,-3,0,168,185,1183,1047,T2
5978,March 27,2016,Thailand,South Korea,0,1,Friendly,in Thailand,-3,3,1411,1795,0,0,106,21,1414,1792,T2
5979,March 28,2016,Central African Republic,Madagascar,2,1,African Nations Cup qualifier,in Central African Republic,15,-15,1274,1261,10,-7,136,143,1259,1276,T1
5980,March 28,2016,Equatorial Guinea,Mali,0,1,African Nations Cup qualifier,in Equatorial Guinea,-15,15,1343,1559,-4,3,121,69,1358,1544,T2
5981,March 28,2016,Faroe Islands,Liechtenstein,3,2,Friendly,in Spain,9,-9,1242,1194,2,-1,150,162,1233,1203,T1
5982,March 28,2016,Libya,São Tomé and Príncipe,4,0,African Nations Cup qualifier,in Algeria,9,-9,1475,1115,2,-3,93,178,1466,1124,T1
5983,March 28,2016,Moldova,Andorra,1,0,Friendly,in Malta,2,-2,1355,953,1,0,117,193,1353,955,T1
5984,March 28,2016,Northern Ireland,Slovenia,1,0,Friendly,in Northern Ireland,8,-8,1607,1614,3,-2,57,56,1599,1622,T1
5985,March 28,2016,Sierra Leone,Gabon,1,0,Friendly,in Sierra Leone,12,-12,1341,1473,3,-5,122,95,1329,1485,T1
5986,March 28,2016,Ukraine,Wales,1,0,Friendly,in Ukraine,4,-4,1821,1664,0,0,16,44,1817,1668,T1
5987,March 28,2016,Zimbabwe,Swaziland,4,0,African Nations Cup qualifier,in Zimbabwe,18,-18,1378,1246,1,-7,115,149,1360,1264,T1
5988,March 29,2016,Afghanistan,Singapore,2,1,World Cup and Asian Cup qualifier,in Iran,24,-24,1147,1164,4,-6,171,169,1123,1188,T1
5989,March 29,2016,Angola,Democratic Republic of Congo,0,2,African Nations Cup qualifier,in Angola,-29,29,1379,1547,-5,8,113,73,1408,1518,T2
5990,March 29,2016,Argentina,Bolivia,2,0,World Cup qualifier,in Argentina,3,-3,2050,1613,0,1,2,54,2047,1616,T1
5991,March 29,2016,Australia,Jordan,5,1,World Cup and Asian Cup qualifier,in Australia,13,-13,1717,1525,1,-3,39,77,1704,1538,T1
5992,March 29,2016,Austria,Turkey,1,2,Friendly,in Austria,-13,13,1792,1824,-1,2,20,16,1805,1811,T2
5993,March 29,2016,China,Qatar,2,0,World Cup and Asian Cup qualifier,in China,22,-22,1571,1535,5,-4,67,74,1549,1557,T1
5994,March 29,2016,Colombia,Ecuador,3,1,World Cup qualifier,in Colombia,17,-17,1980,1884,2,-1,5,14,1963,1901,T1
5995,March 29,2016,Costa Rica,Jamaica,3,0,World Cup qualifier,in Costa Rica,11,-11,1789,1579,3,-3,21,64,1778,1590,T1
5996,March 29,2016,Dominica,Martinique,1,4,CONCACAF Champ &amp; Carib Champ qual,in Dominica,-7,7,969,1453,0,1,190,99,976,1446,T2
5997,March 29,2016,Dominican Republic,Barbados,2,0,CONCACAF Champ &amp; Carib Champ qual,in the Dominican Republic,22,-22,1170,1136,3,-5,167,174,1148,1158,T1
5998,March 29,2016,Egypt,Nigeria,1,0,African Nations Cup qualifier,in Egypt,15,-15,1638,1612,5,-5,48,55,1623,1627,T1
5999,March 29,2016,England,Netherlands,1,2,Friendly,in England,-15,15,1960,1902,-4,1,9,13,1975,1887,T2
6000,March 29,2016,Estonia,Serbia,0,1,Friendly,in Estonia,-7,7,1494,1717,-1,0,88,39,1501,1710,T2
6001,March 29,2016,Ethiopia,Algeria,3,3,African Nations Cup qualifier,in Ethiopia,14,-14,1281,1657,3,-5,137,47,1267,1671,draw
6002,March 29,2016,France,Russia,4,2,Friendly,in France,5,-5,1970,1771,0,0,6,25,1965,1776,T1
6003,March 29,2016,French Guiana,Cuba,3,0,CONCACAF Champ &amp; Carib Champ qual,in French Guiana,32,-32,1302,1312,8,-10,131,129,1270,1344,T1
6004,March 29,2016,Gambia,Mauritania,0,0,African Nations Cup qualifier,in The Gambia,-8,8,1302,1275,-3,1,131,139,1310,1267,draw
6005,March 29,2016,Georgia,Kazakhstan,1,1,Friendly,in Georgia,-5,5,1477,1404,0,1,91,108,1482,1399,draw
6006,March 29,2016,Germany,Italy,4,1,Friendly,in Germany,6,-6,2060,1867,0,0,1,15,2054,1873,T1
6007,March 29,2016,Gibraltar,Latvia,0,5,Friendly,in Gibraltar,-8,8,1111,1466,-1,1,178,96,1119,1458,T2
6008,March 29,2016,Greece,Iceland,2,3,Friendly,in Greece,-12,12,1606,1673,-6,2,60,43,1618,1661,T2
6009,March 29,2016,Honduras,El Salvador,2,0,World Cup qualifier,in Honduras,18,-18,1526,1442,9,-4,76,100,1508,1460,T1
6010,March 29,2016,India,Turkmenistan,1,2,World Cup and Asian Cup qualifier,in India,-15,15,1066,1287,-1,2,183,135,1081,1272,T2
6011,March 29,2016,Iran,Oman,2,0,World Cup and Asian Cup qualifier,in Iran,7,-7,1735,1470,1,-3,34,95,1728,1477,T1
6012,March 29,2016,Iraq,Vietnam,1,0,World Cup and Asian Cup qualifier,in Iran,7,-7,1499,1209,1,0,87,158,1492,1216,T1
6013,March 29,2016,Ireland,Slovakia,2,2,Friendly,in Ireland,-4,4,1775,1740,-1,0,24,33,1779,1736,draw
6014,March 29,2016,Japan,Syria,5,0,World Cup and Asian Cup qualifier,in Japan,11,-11,1761,1516,1,-3,29,79,1750,1527,T1
6015,March 29,2016,Lebanon,Myanmar,1,1,World Cup and Asian Cup qualifier,in Lebanon,-17,17,1372,1046,-2,0,115,186,1389,1029,draw
6016,March 29,2016,Lesotho,Seychelles,2,1,African Nations Cup qualifier,in Lesotho,8,-8,1145,986,1,-1,172,189,1137,994,T1
6017,March 29,2016,Liberia,Djibouti,5,0,African Nations Cup qualifier,in Liberia,2,-2,1332,754,1,0,124,212,1330,756,T1
6018,March 29,2016,Luxembourg,Albania,0,2,Friendly,in Luxembourg,-6,6,1244,1612,-3,3,150,55,1250,1606,T2
6019,March 29,2016,Macedonia,Bulgaria,0,2,Friendly,in Macedonia,-12,12,1424,1615,0,8,101,52,1436,1603,T2
6020,March 29,2016,Malawi,Guinea,1,2,African Nations Cup qualifier,in Malawi,-14,14,1315,1555,-2,1,128,72,1329,1541,T2
6021,March 29,2016,Malaysia,Macao,0,0,Friendly,in Malaysia,-9,9,1106,622,-1,0,179,227,1115,613,draw
6022,March 29,2016,Maldives,Bhutan,4,2,World Cup and Asian Cup qualifier,in the Maldives,3,-3,963,550,0,0,192,234,960,553,T1
6023,March 29,2016,Mexico,Canada,2,0,World Cup qualifier,in Mexico,3,-3,1922,1511,1,2,10,80,1919,1514,T1
6024,March 29,2016,Montenegro,Belarus,0,0,Friendly,in Montenegro,-2,2,1561,1580,-2,2,69,63,1563,1578,draw
6025,March 29,2016,Morocco,Cape Verde,2,0,African Nations Cup qualifier,in Morocco,19,-19,1574,1500,5,-6,66,86,1555,1519,T1
6026,March 29,2016,Namibia,Burundi,1,3,African Nations Cup qualifier,in Namibia,-43,43,1332,1353,-8,11,124,117,1375,1310,T2
6027,March 29,2016,Niger,Senegal,1,2,African Nations Cup qualifier,in Niger,-7,7,1277,1661,-3,2,138,45,1284,1654,T2
6028,March 29,2016,Norway,Finland,2,0,Friendly,in Norway,9,-9,1635,1570,1,-4,50,68,1626,1579,T1
6029,March 29,2016,Palestine,East Timor,7,0,World Cup and Asian Cup qualifier,in Palestine,1,-1,1338,727,1,0,122,215,1337,728,T1
6030,March 29,2016,Panama,Haiti,1,0,World Cup qualifier,in Panama,7,-7,1677,1502,1,-1,42,85,1670,1509,T1
6031,March 29,2016,Paraguay,Brazil,2,2,World Cup qualifier,in Paraguay,10,-10,1752,2018,0,0,31,3,1742,2028,draw
6032,March 29,2016,Philippines,North Korea,3,2,World Cup and Asian Cup qualifier,in the Philippines,30,-30,1263,1503,10,-9,143,84,1233,1533,T1
6033,March 29,2016,Portugal,Belgium,2,1,Friendly,in Portugal,8,-8,1910,1921,0,-1,12,11,1902,1929,T1
6034,March 29,2016,Puerto Rico,Guyana,0,1,CONCACAF Champ &amp; Carib Champ qual,in Puerto Rico,-16,16,1056,1252,-1,3,185,148,1072,1236,T2
6035,March 29,2016,Rwanda,Mauritius,5,0,African Nations Cup qualifier,in Rwanda,12,-12,1321,1103,3,-3,127,181,1309,1115,T1
6036,March 29,2016,Scotland,Denmark,1,0,Friendly,in Scotland,8,-8,1721,1726,0,-2,38,36,1713,1734,T1
6037,March 29,2016,South Africa,Cameroon,0,0,African Nations Cup qualifier,in South Africa,-4,4,1581,1610,0,0,62,58,1585,1606,draw
6038,March 29,2016,Saint Kitts and Nevis,Antigua and Barbuda,1,0,CONCACAF Champ &amp; Carib Champ qual,in Saint Kitts and Nevis,14,-14,1274,1236,4,-5,140,152,1260,1250,T1
6039,March 29,2016,Sudan,Ivory Coast,1,1,African Nations Cup qualifier,in Sudan,15,-15,1303,1725,4,-5,130,37,1288,1740,draw
6040,March 29,2016,Suriname,Guadeloupe,3,2,CONCACAF Champ &amp; Carib Champ qual,in Suriname,21,-21,1203,1287,4,-4,161,135,1182,1308,T1
6041,March 29,2016,Sweden,Czechia,1,1,Friendly,in Sweden,-3,3,1762,1755,0,-1,28,30,1765,1752,draw
6042,March 29,2016,Switzerland,Bosnia and Herzegovina,0,2,Friendly,in Switzerland,-22,22,1780,1748,-3,4,23,32,1802,1726,T2
6043,March 29,2016,Tajikistan,Kyrgyzstan,0,1,World Cup and Asian Cup qualifier,in Tajikistan,-28,28,1199,1209,-7,8,162,158,1227,1181,T2
6044,March 29,2016,Togo,Tunisia,0,0,African Nations Cup qualifier,in Togo,4,-4,1401,1556,1,-3,109,71,1397,1560,draw
6045,March 29,2016,Trinidad and Tobago,Saint Vincent and the Grenadines,6,0,World Cup qualifier,in Trinidad and Tobago,4,-4,1589,1143,1,-2,61,173,1585,1147,T1
6046,March 29,2016,United Arab Emirates,Saudi Arabia,1,1,World Cup and Asian Cup qualifier,in the United Arab Emirates,-11,11,1631,1535,-3,3,51,74,1642,1524,draw
6047,March 29,2016,Uganda,Burkina Faso,0,0,African Nations Cup qualifier,in Uganda,-9,9,1505,1460,-1,2,83,97,1514,1451,draw
6048,March 29,2016,Uruguay,Peru,1,0,World Cup qualifier,in Uruguay,7,-7,1964,1766,0,-1,8,27,1957,1773,T1
6049,March 29,2016,United States,Guatemala,4,0,World Cup qualifier,in the United States,11,-11,1733,1510,2,-3,35,81,1722,1521,T1
6050,March 29,2016,US Virgin Islands,Grenada,1,2,CONCACAF Champ &amp; Carib Champ qual,in the US Virgin Islands,-6,6,734,1150,0,2,214,170,740,1144,T2
6051,March 29,2016,Uzbekistan,Bahrain,1,0,World Cup and Asian Cup qualifier,in Uzbekistan,5,-5,1661,1422,1,-3,45,105,1656,1427,T1
6052,March 29,2016,Venezuela,Chile,1,4,World Cup qualifier,in Venezuela,-15,15,1611,1968,-6,2,57,7,1626,1953,T2
6053,April 27,2016,Martinique,Panama,0,2,Friendly,in Martinique,-10,10,1443,1687,0,0,99,42,1453,1677,T2
6054,May 20,2016,Hungary,Ivory Coast,0,0,Friendly,in Hungary,-2,2,1698,1727,0,1,41,36,1700,1725,draw
6055,May 21,2016,Botswana,Lesotho,2,1,Friendly,in Botswana,4,-4,1306,1141,1,-1,130,173,1302,1145,T1
6056,May 22,2016,England,Turkey,2,1,Friendly,in England,4,-4,1964,1820,1,-1,8,17,1960,1824,T1
6057,May 22,2016,Puerto Rico,United States,1,3,Friendly,in Puerto Rico,-1,1,1055,1734,0,0,185,35,1056,1733,T2
6058,May 23,2016,Peru,Trinidad and Tobago,4,0,Friendly,in Peru,6,-6,1772,1583,2,0,25,61,1766,1589,T1
6059,May 24,2016,Panama,Venezuela,0,0,Friendly,in Panama,-5,5,1682,1616,0,5,42,52,1687,1611,draw
6060,May 25,2016,Democratic Republic of Congo,Romania,1,1,Friendly,in Italy,6,-6,1553,1764,0,0,73,27,1547,1770,draw
6061,May 25,2016,Serbia,Cyprus,2,1,Friendly,in Serbia,2,-2,1719,1421,0,-1,39,105,1717,1423,T1
6062,May 25,2016,United States,Ecuador,1,0,Friendly,in the United States,11,-11,1745,1873,2,0,33,14,1734,1884,T1
6063,May 26,2016,Andorra,Azerbaijan,0,0,Friendly,in Austria,9,-9,962,1400,0,-2,193,109,953,1409,draw
6064,May 27,2016,Argentina,Honduras,1,0,Friendly,in Argentina,1,-1,2051,1525,0,0,2,76,2050,1526,T1
6065,May 27,2016,Chile,Jamaica,1,2,Friendly,in Chile,-19,19,1949,1598,-2,3,9,61,1968,1579,T2
6066,May 27,2016,Costa Rica,Venezuela,2,1,Friendly,in Costa Rica,3,-3,1792,1613,1,-4,20,56,1789,1616,T1
6067,May 27,2016,Croatia,Moldova,1,0,Friendly,in Croatia,1,-1,1818,1354,0,0,18,116,1817,1355,T1
6068,May 27,2016,Czechia,Malta,6,0,Friendly,in Austria,2,-2,1757,1232,0,0,30,153,1755,1234,T1
6069,May 27,2016,England,Australia,2,1,Friendly,in England,2,-2,1966,1715,1,0,7,40,1964,1717,T1
6070,May 27,2016,Ireland,Netherlands,1,1,Friendly,in Ireland,1,-1,1776,1901,0,0,24,13,1775,1902,draw
6071,May 27,2016,Lesotho,Swaziland,0,2,Friendly,in Lesotho,-15,15,1126,1261,-2,4,175,145,1141,1246,T2
6072,May 27,2016,Morocco,Congo,2,0,Friendly,in Morocco,8,-8,1582,1483,4,-1,62,90,1574,1491,T1
6073,May 27,2016,Nigeria,Mali,1,0,Friendly,in France,8,-8,1620,1551,4,-3,52,73,1612,1559,T1
6074,May 27,2016,Northern Ireland,Belarus,3,0,Friendly,in Northern Ireland,11,-11,1618,1569,6,-5,53,68,1607,1580,T1
6075,May 27,2016,Slovakia,Georgia,3,1,Friendly,in Austria,5,-5,1745,1472,1,-3,33,94,1740,1477,T1
6076,May 27,2016,Togo,Zambia,1,0,Friendly,in Togo,10,-10,1411,1497,2,-5,106,87,1401,1507,T1
6077,May 27,2016,Uruguay,Trinidad and Tobago,3,1,Friendly,in Uruguay,2,-2,1966,1581,1,-2,7,63,1964,1583,T1
6078,May 28,2016,Armenia,Guatemala,7,1,Friendly,in the United States,23,-23,1508,1487,8,-8,81,89,1485,1510,T1
6079,May 28,2016,Mauritania,Gabon,2,0,Friendly,in Spain,23,-23,1298,1450,5,-5,134,98,1275,1473,T1
6080,May 28,2016,Mexico,Paraguay,1,0,Friendly,in the United States,5,-5,1927,1747,-1,-2,11,33,1922,1752,T1
6081,May 28,2016,Myanmar,Malaysia,0,0,Friendly,in Myanmar,-1,1,1045,1107,0,0,186,179,1046,1106,draw
6082,May 28,2016,New Zealand,Fiji,3,1,World Cup qualifier and Oceania Cup,in Papua New Guinea,14,-14,1535,1257,4,-5,74,147,1521,1271,T1
6083,May 28,2016,Peru,El Salvador,3,1,Friendly,in the United States,4,-4,1776,1438,2,0,23,100,1772,1442,T1
6084,May 28,2016,Rwanda,Senegal,0,2,Friendly,in Rwanda,-6,6,1315,1667,0,1,127,44,1321,1661,T2
6085,May 28,2016,Solomon Islands,Vanuatu,1,0,World Cup qualifier and Oceania Cup,in Papua New Guinea,27,-27,1194,1169,5,-5,163,168,1167,1196,T1
6086,May 28,2016,Switzerland,Belgium,1,2,Friendly,in Switzerland,-9,9,1771,1930,-2,1,25,10,1780,1921,T2
6087,May 28,2016,United States,Bolivia,4,0,Friendly,in the United States,8,-8,1753,1605,2,-4,31,60,1745,1613,T1
6088,May 29,2016,Albania,Qatar,3,1,Friendly,in Austria,12,-12,1624,1523,5,-4,52,78,1612,1535,T1
6089,May 29,2016,Brazil,Panama,2,0,Friendly,in the United States,4,-4,2022,1678,0,0,3,42,2018,1682,T1
6090,May 29,2016,Cambodia,East Timor,2,0,Friendly,in Cambodia,11,-11,732,716,2,-2,215,217,721,727,T1
6091,May 29,2016,Colombia,Haiti,3,1,Friendly,in the United States,2,-2,1982,1500,0,0,5,84,1980,1502,T1
6092,May 29,2016,Germany,Slovakia,1,3,Friendly,in Germany,-27,27,2033,1772,-1,9,2,25,2060,1745,T2
6093,May 29,2016,Italy,Scotland,1,0,Friendly,in Malta,6,-6,1873,1715,1,-1,14,39,1867,1721,T1
6094,May 29,2016,Kenya,Tanzania,1,1,Friendly,in Kenya,-2,2,1323,1346,0,1,126,118,1325,1344,draw
6095,May 29,2016,Laos,Nepal,1,1,Friendly,in Laos,0,0,812,898,0,0,208,201,812,898,draw
6096,May 29,2016,Lithuania,Estonia,2,0,Baltic Cup,in Lithuania,21,-21,1445,1473,2,-4,99,92,1424,1494,T1
6097,May 29,2016,Macedonia,Azerbaijan,3,1,Friendly,in Austria,14,-14,1438,1386,0,-2,101,111,1424,1400,T1
6098,May 29,2016,Papua New Guinea,New Caledonia,1,1,World Cup qualifier and Oceania Cup,in Papua New Guinea,12,-12,1075,1334,1,-5,183,123,1063,1346,draw
6099,May 29,2016,Portugal,Norway,3,0,Friendly,in Portugal,4,-4,1914,1631,0,0,12,50,1910,1635,T1
6100,May 29,2016,Spain,Bosnia and Herzegovina,3,1,Friendly,in Switzerland,6,-6,2004,1742,0,-2,4,34,1998,1748,T1
6101,May 29,2016,Tahiti,Samoa,4,0,World Cup qualifier and Oceania Cup,in Papua New Guinea,5,-5,1231,703,1,0,154,218,1226,708,T1
6102,May 29,2016,Turkey,Montenegro,1,0,Friendly,in Turkey,2,-2,1822,1559,0,0,17,69,1820,1561,T1
6103,May 29,2016,Ukraine,Romania,4,3,Friendly,in Italy,8,-8,1829,1756,0,-4,16,31,1821,1764,T1
6104,May 30,2016,France,Cameroon,3,2,Friendly,in France,1,-1,1971,1609,0,0,6,58,1970,1610,T1
6105,May 30,2016,Gambia,Zambia,0,0,Friendly,in The Gambia,3,-3,1305,1494,1,0,131,87,1302,1497,draw
6106,May 30,2016,Sweden,Slovenia,0,0,Friendly,in Sweden,-6,6,1756,1620,-2,3,30,53,1762,1614,draw
6107,May 31,2016,Austria,Malta,2,1,Friendly,in Austria,0,0,1792,1232,0,0,20,153,1792,1232,T1
6108,May 31,2016,Fiji,Solomon Islands,1,0,World Cup qualifier and Oceania Cup,in Papua New Guinea,21,-21,1278,1173,8,-2,139,165,1257,1194,T1
6109,May 31,2016,Ireland,Belarus,1,2,Friendly,in Ireland,-17,17,1759,1586,-5,6,28,62,1776,1569,T2
6110,May 31,2016,Kenya,Sudan,1,1,Friendly,in Kenya,-3,3,1320,1306,0,2,126,130,1323,1303,draw
6111,May 31,2016,Luxembourg,Nigeria,1,3,Friendly,in Luxembourg,-5,5,1239,1625,-1,1,151,52,1244,1620,T2
6112,May 31,2016,New Zealand,Vanuatu,5,0,World Cup qualifier and Oceania Cup,in Papua New Guinea,11,-11,1546,1158,0,-1,74,169,1535,1169,T1
6113,May 31,2016,Serbia,Israel,3,1,Friendly,in Serbia,6,-6,1725,1570,0,-2,38,67,1719,1576,T1
6114,May 31,2016,Vietnam,Syria,2,0,Friendly,in Vietnam,23,-23,1232,1493,5,-7,153,86,1209,1516,T1
6115,May 31,2016,Zimbabwe,Uganda,2,0,Friendly,in Zimbabwe,16,-16,1394,1489,4,-5,110,87,1378,1505,T1
6116,June 1,2016,Armenia,El Salvador,4,0,Friendly,in the United States,15,-15,1523,1423,2,-2,78,103,1508,1438,T1
6117,June 1,2016,Belgium,Finland,1,1,Friendly,in Belgium,-9,9,1921,1579,-1,1,11,66,1930,1570,draw
6118,June 1,2016,Curaçao,Guyana,5,2,CONCACAF Champ &amp; Carib Champ qual,in Curaçao,38,-38,1159,1214,7,-8,169,157,1121,1252,T1
6119,June 1,2016,Czechia,Russia,2,1,Friendly,in Austria,10,-10,1767,1761,3,-2,26,27,1757,1771,T1
6120,June 1,2016,Estonia,Andorra,2,0,Friendly,in Estonia,1,-1,1474,961,-1,0,93,193,1473,962,T1
6121,June 1,2016,French Guiana,Bermuda,0,1,CONCACAF Champ &amp; Carib Champ qual,in French Guiana,-29,29,1273,1259,-9,8,142,148,1302,1230,T2
6122,June 1,2016,Grenada,Puerto Rico,3,3,CONCACAF Champ &amp; Carib Champ qual,in Grenada,-10,10,1140,1065,-3,0,173,185,1150,1055,draw
6123,June 1,2016,Guatemala,Venezuela,1,1,Friendly,in the United States,3,-3,1490,1610,1,0,87,57,1487,1613,draw
6124,June 1,2016,Latvia,Lithuania,2,1,Baltic Cup,in Latvia,10,-10,1476,1435,5,-2,90,101,1466,1445,T1
6125,June 1,2016,Martinique,Guadeloupe,2,0,CONCACAF Champ &amp; Carib Champ qual,in Martinique,11,-11,1454,1276,2,-4,98,140,1443,1287,T1
6126,June 1,2016,Mexico,Chile,1,0,Friendly,in the United States,11,-11,1938,1938,2,0,9,9,1927,1949,T1
6127,June 1,2016,New Caledonia,Samoa,7,0,World Cup qualifier and Oceania Cup,in Papua New Guinea,3,-3,1337,700,1,-1,122,219,1334,703,T1
6128,June 1,2016,Norway,Iceland,3,2,Friendly,in Norway,8,-8,1639,1665,2,-1,48,44,1631,1673,T1
6129,June 1,2016,Papua New Guinea,Tahiti,2,2,World Cup qualifier and Oceania Cup,in Papua New Guinea,4,-4,1079,1227,1,0,182,155,1075,1231,draw
6130,June 1,2016,Poland,Netherlands,1,2,Friendly,in Poland,-10,10,1775,1911,-1,0,23,13,1785,1901,T2
6131,June 1,2016,Spain,South Korea,6,1,Friendly,in Austria,9,-9,2013,1786,0,-2,4,21,2004,1795,T1
6132,June 1,2016,Saint Kitts and Nevis,Suriname,1,0,CONCACAF Champ &amp; Carib Champ qual,in Saint Kitts and Nevis,11,-11,1285,1192,5,-2,136,163,1274,1203,T1
6133,June 2,2016,England,Portugal,1,0,Friendly,in England,6,-6,1972,1908,1,-1,6,13,1966,1914,T1
6134,June 2,2016,Laos,India,0,1,Asian Cup qualifier,in Laos,-12,12,800,1078,0,1,208,183,812,1066,T2
6135,June 2,2016,Macedonia,Iran,1,3,Friendly,in Macedonia,-7,7,1431,1742,-1,1,101,34,1438,1735,T2
6136,June 2,2016,Malaysia,East Timor,3,0,Asian Cup qualifier,in Malaysia,4,-4,1111,712,1,0,178,217,1107,716,T1
6137,June 2,2016,Maldives,Yemen,0,2,Asian Cup qualifier,in the Maldives,-21,21,942,1194,-5,3,197,162,963,1173,T2
6138,June 2,2016,Seychelles,Algeria,0,2,African Nations Cup qualifier,in the Seychelles,-2,2,984,1659,0,0,189,47,986,1657,T2
6139,June 2,2016,Somaliland,Chagos Islands,3,2,World Football Cup,in Georgia,10,-10,1002,798,1,0,187,209,992,808,T1
6140,June 2,2016,Taiwan,Cambodia,2,2,Asian Cup qualifier,in Taiwan,-9,9,781,741,0,1,210,214,790,732,draw
6141,June 2,2016,Tajikistan,Bangladesh,5,0,Asian Cup qualifier,in Tajikistan,7,-7,1206,889,0,0,161,202,1199,896,T1
6142,June 3,2016,Azerbaijan,Canada,1,1,Friendly,in Austria,3,-3,1389,1508,0,0,112,80,1386,1511,draw
6143,June 3,2016,Bosnia and Herzegovina,Denmark,2,2,Friendly tournament,in Japan,-1,1,1741,1727,0,1,34,36,1742,1726,draw
6144,June 3,2016,China,Trinidad and Tobago,4,2,Friendly,in China,11,-11,1582,1570,4,-3,63,67,1571,1581,T1
6145,June 3,2016,Djibouti,Tunisia,0,3,African Nations Cup qualifier,in Djibouti,-1,1,753,1557,-1,0,213,70,754,1556,T2
6146,June 3,2016,Hong Kong,Vietnam,2,2,Friendly tournament,in Myanmar,1,-1,1215,1231,0,-1,157,154,1214,1232,draw
6147,June 3,2016,Japan,Bulgaria,7,2,Friendly tournament,in Japan,12,-12,1773,1603,3,-3,24,59,1761,1615,T1
6148,June 3,2016,Jordan,United Arab Emirates,3,1,King's Cup,in Thailand,29,-29,1554,1602,4,-9,72,60,1525,1631,T1
6149,June 3,2016,Kosovo,Faroe Islands,2,0,Friendly,in Germany,9,-9,1400,1233,2,-2,109,152,1391,1242,T1
6150,June 3,2016,Libya,Morocco,1,1,African Nations Cup qualifier,in Tunisia,6,-6,1481,1576,1,-3,90,66,1475,1582,draw
6151,June 3,2016,Mauritania,Cameroon,0,1,African Nations Cup qualifier,in Mauritania,-9,9,1289,1618,0,5,133,53,1298,1609,T2
6152,June 3,2016,Myanmar,Singapore,0,1,Friendly tournament,in Myanmar,-14,14,1031,1178,0,2,186,166,1045,1164,T2
6153,June 3,2016,Romania,Georgia,5,1,Friendly,in Romania,4,-4,1760,1468,1,-1,29,95,1756,1472,T1
6154,June 3,2016,Switzerland,Moldova,2,1,Friendly,in Switzerland,1,-1,1772,1353,0,0,25,116,1771,1354,T1
6155,June 3,2016,Thailand,Syria,2,2,King's Cup,in Thailand,-1,1,1410,1494,-1,1,107,85,1411,1493,draw
6156,June 3,2016,Ukraine,Albania,3,1,Friendly,in Italy,7,-7,1836,1617,0,-2,16,55,1829,1624,T1
6157,June 3,2016,United States,Colombia,0,2,Copa América,in the United States,-24,24,1729,2006,-3,0,35,5,1753,1982,T2
6158,June 4,2016,Australia,Greece,1,0,Friendly,in Australia,5,-5,1720,1601,0,-3,39,60,1715,1606,T1
6159,June 4,2016,Austria,Netherlands,0,2,Friendly,in Austria,-14,14,1778,1925,-3,1,22,11,1792,1911,T2
6160,June 4,2016,Bermuda,Dominican Republic,0,1,CONCACAF Champ &amp; Carib Champ qual,in Bermuda,-30,30,1229,1200,-5,5,153,163,1259,1170,T2
6161,June 4,2016,Botswana,Uganda,1,2,African Nations Cup qualifier,in Botswana,-15,15,1291,1504,0,6,130,82,1306,1489,T2
6162,June 4,2016,Brazil,Ecuador,0,0,Copa América,in the United States,-10,10,2012,1883,-1,0,4,14,2022,1873,draw
6163,June 4,2016,Burundi,Senegal,0,2,African Nations Cup qualifier,in Burundi,-14,14,1339,1681,-5,1,121,42,1353,1667,T2
6164,June 4,2016,Costa Rica,Paraguay,0,0,Copa América,in the United States,-3,3,1789,1750,0,0,19,32,1792,1747,draw
6165,June 4,2016,Croatia,San Marino,10,0,Friendly,in Croatia,0,0,1818,884,0,0,18,204,1818,884,T1
6166,June 4,2016,Estonia,Latvia,0,0,Baltic Cup,in Estonia,-4,4,1470,1480,1,1,92,90,1474,1476,draw
6167,June 4,2016,France,Scotland,3,0,Friendly,in France,4,-4,1975,1711,1,-1,6,40,1971,1715,T1
6168,June 4,2016,Gambia,South Africa,0,4,African Nations Cup qualifier,in The Gambia,-20,20,1285,1601,-4,4,136,60,1305,1581,T2
6169,June 4,2016,Germany,Hungary,2,0,Friendly,in Germany,2,-2,2035,1696,0,0,2,41,2033,1698,T1
6170,June 4,2016,Guadeloupe,Dominica,2,1,CONCACAF Champ &amp; Carib Champ qual,in Guadeloupe,4,-4,1280,965,1,-1,139,191,1276,969,T1
6171,June 4,2016,Guinea-Bissau,Zambia,3,2,African Nations Cup qualifier,in Guinea-Bissau,27,-27,1287,1467,13,-10,134,95,1260,1494,T1
6172,June 4,2016,Ivory Coast,Gabon,2,1,Friendly,in Ivory Coast,2,-2,1729,1448,1,0,35,99,1727,1450,T1
6173,June 4,2016,Namibia,Niger,1,0,African Nations Cup qualifier,in Namibia,12,-12,1344,1265,5,-3,119,142,1332,1277,T1
6174,June 4,2016,New Zealand,Solomon Islands,1,0,World Cup qualifier and Oceania Cup,in Papua New Guinea,5,-5,1551,1168,0,-2,75,169,1546,1173,T1
6175,June 4,2016,Peru,Haiti,1,0,Copa América,in the United States,8,-8,1784,1492,1,-4,21,86,1776,1500,T1
6176,June 4,2016,Puerto Rico,Antigua and Barbuda,2,1,CONCACAF Champ &amp; Carib Champ qual,in Puerto Rico,24,-24,1089,1212,3,-7,182,158,1065,1236,T1
6177,June 4,2016,Rwanda,Mozambique,2,3,African Nations Cup qualifier,in Rwanda,-24,24,1291,1360,-3,7,130,116,1315,1336,T2
6178,June 4,2016,São Tomé and Príncipe,Cape Verde,1,2,African Nations Cup qualifier,in São Tomé and Príncipe,-6,6,1109,1506,-2,1,179,81,1115,1500,T2
6179,June 4,2016,Sierra Leone,Sudan,1,0,African Nations Cup qualifier,in Sierra Leone,13,-13,1354,1293,3,1,117,129,1341,1306,T1
6180,June 4,2016,Slovakia,Northern Ireland,0,0,Friendly,in Slovakia,-6,6,1766,1624,-2,1,27,52,1772,1618,draw
6181,June 4,2016,South Sudan,Mali,0,3,African Nations Cup qualifier,in South Sudan,-10,10,1125,1561,-1,5,176,69,1135,1551,T2
6182,June 4,2016,Suriname,Saint Vincent and the Grenadines,2,1,CONCACAF Champ &amp; Carib Champ qual,in Suriname,12,-12,1204,1131,2,-2,162,174,1192,1143,T1
6183,June 4,2016,Tanzania,Egypt,0,2,African Nations Cup qualifier,in Tanzania,-15,15,1331,1653,-7,1,125,48,1346,1638,T2
6184,June 4,2016,US Virgin Islands,Guyana,0,7,CONCACAF Champ &amp; Carib Champ qual,in the US Virgin Islands,-9,9,725,1223,-1,3,216,155,734,1214,T2
6185,June 4,2016,Vanuatu,Fiji,3,2,World Cup qualifier and Oceania Cup,in Papua New Guinea,33,-33,1191,1245,4,-10,166,148,1158,1278,T1
6186,June 5,2016,Belgium,Norway,3,2,Friendly,in Belgium,2,-2,1923,1637,0,-1,12,50,1921,1639,T1
6187,June 5,2016,Central African Republic,Angola,3,1,African Nations Cup qualifier,in Central African Republic,30,-30,1304,1349,12,-4,128,118,1274,1379,T1
6188,June 5,2016,Comoros,Burkina Faso,0,1,African Nations Cup qualifier,in the Comoros,-4,4,964,1464,-1,1,191,95,968,1460,T2
6189,June 5,2016,Czechia,South Korea,1,2,Friendly,in Czechia,-12,12,1755,1798,-5,1,31,19,1767,1786,T2
6190,June 5,2016,Kenya,Congo,2,1,African Nations Cup qualifier,in Kenya,24,-24,1344,1459,7,-8,119,96,1320,1483,T1
6191,June 5,2016,Lesotho,Ethiopia,1,2,African Nations Cup qualifier,in Lesotho,-17,17,1109,1298,-3,9,178,129,1126,1281,T2
6192,June 5,2016,Liberia,Togo,2,2,African Nations Cup qualifier,in Liberia,-1,1,1331,1412,0,-1,124,107,1332,1411,draw
6193,June 5,2016,Madagascar,Democratic Republic of Congo,1,6,African Nations Cup qualifier,in Madagascar,-20,20,1241,1573,-3,7,148,67,1261,1553,T2
6194,June 5,2016,Mauritius,Ghana,0,2,African Nations Cup qualifier,in Mauritius,-5,5,1098,1643,0,1,181,49,1103,1638,T2
6195,June 5,2016,Mexico,Uruguay,3,1,Copa América,in the United States,41,-41,1979,1925,3,-2,6,10,1938,1966,T1
6196,June 5,2016,New Caledonia,Tahiti,1,1,World Cup qualifier and Oceania Cup,in Papua New Guinea,-8,8,1329,1235,-3,4,126,150,1337,1227,draw
6197,June 5,2016,Papua New Guinea,Samoa,8,0,World Cup qualifier and Oceania Cup,in Papua New Guinea,7,-7,1086,693,0,-1,183,220,1079,700,T1
6198,June 5,2016,Russia,Serbia,1,1,Friendly,in Monaco,-1,1,1760,1726,0,0,28,38,1761,1725,draw
6199,June 5,2016,Slovenia,Turkey,0,1,Friendly,in Slovenia,-7,7,1613,1829,-3,0,56,17,1620,1822,T2
6200,June 5,2016,Swaziland,Guinea,1,0,African Nations Cup qualifier,in Swaziland,30,-30,1291,1525,13,-4,132,76,1261,1555,T1
6201,June 5,2016,Sweden,Wales,3,0,Friendly,in Sweden,9,-9,1765,1655,4,-2,27,47,1756,1664,T1
6202,June 5,2016,Syria,United Arab Emirates,1,0,King's Cup,in Thailand,20,-20,1514,1582,5,-3,80,62,1494,1602,T1
6203,June 5,2016,Thailand,Jordan,2,0,King's Cup,in Thailand,25,-25,1435,1529,7,-2,100,75,1410,1554,T1
6204,June 5,2016,Venezuela,Jamaica,1,0,Copa América,in the United States,24,-24,1634,1574,5,-4,51,66,1610,1598,T1
6205,June 5,2016,Zimbabwe,Malawi,3,0,African Nations Cup qualifier,in Zimbabwe,18,-18,1412,1297,4,-3,107,130,1394,1315,T1
6206,June 6,2016,Argentina,Chile,2,1,Copa América,in the United States,17,-17,2068,1921,0,-3,1,12,2051,1938,T1
6207,June 6,2016,Iceland,Liechtenstein,4,0,Friendly,in Iceland,1,-1,1666,1193,0,0,44,164,1665,1194,T1
6208,June 6,2016,Italy,Finland,2,0,Friendly,in Italy,3,-3,1876,1576,0,0,15,64,1873,1579,T1
6209,June 6,2016,Malaysia,East Timor,3,0,Asian Cup qualifier,in Malaysia,4,-4,1115,708,0,0,176,217,1111,712,T1
6210,June 6,2016,Myanmar,Hong Kong,3,0,Friendly tournament,in Myanmar,32,-32,1063,1183,0,-10,186,167,1031,1215,T1
6211,June 6,2016,Panama,Bolivia,2,1,Copa América,in the United States,20,-20,1698,1585,2,-4,41,61,1678,1605,T1
6212,June 6,2016,Poland,Lithuania,0,0,Friendly,in Poland,-9,9,1766,1444,-2,0,25,100,1775,1435,draw
6213,June 6,2016,Vietnam,Singapore,3,0,Friendly tournament,in Myanmar,22,-22,1253,1156,6,-2,147,170,1231,1178,T1
6214,June 7,2016,Antigua and Barbuda,Grenada,5,1,CONCACAF Champ &amp; Carib Champ qual,in Antigua and Barbuda,20,-20,1232,1120,4,-2,153,174,1212,1140,T1
6215,June 7,2016,Australia,Greece,1,2,Friendly,in Australia,-16,16,1704,1617,-1,3,40,55,1720,1601,T2
6216,June 7,2016,Bangladesh,Tajikistan,0,1,Asian Cup qualifier,in Bangladesh,-9,9,880,1215,-2,1,204,159,889,1206,T2
6217,June 7,2016,Cambodia,Taiwan,2,0,Asian Cup qualifier,in Cambodia,25,-25,766,756,4,-2,210,212,741,781,T1
6218,June 7,2016,Canada,Uzbekistan,2,1,Friendly,in Austria,14,-14,1522,1647,1,-3,80,48,1508,1661,T1
6219,June 7,2016,China,Kazakhstan,0,1,Friendly,in China,-17,17,1565,1421,-7,3,69,106,1582,1404,T2
6220,June 7,2016,Colombia,Paraguay,2,1,Copa América,in the United States,9,-9,2015,1741,2,-4,3,36,2006,1750,T1
6221,June 7,2016,Curaçao,US Virgin Islands,7,0,CONCACAF Champ &amp; Carib Champ qual,in Curaçao,4,-4,1163,721,0,0,169,216,1159,725,T1
6222,June 7,2016,Denmark,Bulgaria,4,0,Friendly tournament,in Japan,18,-18,1745,1585,3,-3,34,60,1727,1603,T1
6223,June 7,2016,Dominica,Martinique,0,4,CONCACAF Champ &amp; Carib Champ qual,in Dominica,-7,7,958,1461,-2,2,192,96,965,1454,T2
6224,June 7,2016,Dominican Republic,French Guiana,2,1,CONCACAF Champ &amp; Carib Champ qual,in the Dominican Republic,18,-18,1218,1255,4,-4,158,146,1200,1273,T1
6225,June 7,2016,India,Laos,6,1,Asian Cup qualifier,in India,8,-8,1086,792,1,-1,183,209,1078,800,T1
6226,June 7,2016,Iran,Kyrgyzstan,6,0,Friendly,in Iran,1,-1,1743,1208,-2,-2,35,160,1742,1209,T1
6227,June 7,2016,Japan,Bosnia and Herzegovina,1,2,Friendly tournament,in Japan,-20,20,1753,1761,-9,7,32,27,1773,1741,T2
6228,June 7,2016,Spain,Georgia,0,1,Friendly,in Spain,-20,20,1993,1488,-2,5,5,88,2013,1468,T2
6229,June 7,2016,Saint Vincent and the Grenadines,Saint Kitts and Nevis,0,1,CONCACAF Champ &amp; Carib Champ qual,in Saint Vincent and the Grenadines,-17,17,1114,1302,-2,10,176,129,1131,1285,T2
6230,June 7,2016,United States,Costa Rica,4,0,Copa América,in the United States,42,-42,1771,1747,12,-13,23,33,1729,1789,T1
6231,June 7,2016,Yemen,Maldives,2,0,Asian Cup qualifier,in Qatar,11,-11,1205,931,1,0,162,197,1194,942,T1
6232,June 8,2016,Brazil,Haiti,7,1,Copa América,in the United States,5,-5,2017,1487,1,-2,3,88,2012,1492,T1
6233,June 8,2016,Ecuador,Peru,2,2,Copa América,in the United States,-7,7,1876,1791,0,0,14,20,1883,1784,draw
6234,June 8,2016,Namibia,Malawi,0,0,Friendly,in Namibia,-4,4,1340,1301,-2,1,121,130,1344,1297,draw
6235,June 8,2016,New Zealand,New Caledonia,1,0,Oceania Nations Cup,in Papua New Guinea,11,-11,1562,1318,3,0,70,126,1551,1329,T1
6236,June 8,2016,Papua New Guinea,Solomon Islands,2,1,Oceania Nations Cup,in Papua New Guinea,24,-24,1110,1144,5,-3,178,171,1086,1168,T1
6237,June 8,2016,Portugal,Estonia,7,0,Friendly,in Portugal,2,-2,1910,1468,0,-1,13,93,1908,1470,T1
6238,June 9,2016,Mexico,Jamaica,2,0,Copa América,in the United States,7,-7,1986,1567,0,-3,6,68,1979,1574,T1
6239,June 9,2016,Venezuela,Uruguay,1,0,Copa América,in the United States,42,-42,1676,1883,7,-4,44,13,1634,1925,T1
6240,June 10,2016,Argentina,Panama,5,0,Copa América,in the United States,11,-11,2079,1687,0,-1,1,42,2068,1698,T1
6241,June 10,2016,Chile,Bolivia,2,1,Copa América,in the United States,6,-6,1927,1579,2,-2,9,62,1921,1585,T1
6242,June 10,2016,France,Romania,2,1,European Championship,in France,7,-7,1982,1753,0,-3,7,31,1975,1760,T1
6243,June 11,2016,Costa Rica,Colombia,3,2,Copa América,in the United States,41,-41,1788,1974,12,-3,21,7,1747,2015,T1
6244,June 11,2016,England,Russia,1,1,European Championship,in France,-14,14,1958,1774,0,3,8,25,1972,1760,draw
6245,June 11,2016,Madagascar,Seychelles,1,0,COSAFA Cup,in Namibia,7,-7,1248,977,1,0,148,189,1241,984,T1
6246,June 11,2016,Papua New Guinea,New Zealand,0,0,Oceania Nations Cup,in Papua New Guinea,19,-19,1129,1543,5,-3,173,73,1110,1562,draw
6247,June 11,2016,Swaziland,Zimbabwe,2,2,COSAFA Cup,in Namibia,7,-7,1298,1405,2,-1,131,109,1291,1412,draw
6248,June 11,2016,Switzerland,Albania,1,0,European Championship,in France,15,-15,1787,1602,0,-2,22,57,1772,1617,T1
6249,June 11,2016,United States,Paraguay,1,0,Copa América,in the United States,16,-16,1787,1725,1,-2,22,38,1771,1741,T1
6250,June 11,2016,Wales,Slovakia,2,1,European Championship,in France,33,-33,1688,1733,5,-11,42,35,1655,1766,T1
6251,June 12,2016,Benin,Equatorial Guinea,2,1,African Nations Cup qualifier,in Benin,12,-12,1409,1331,2,-3,109,123,1397,1343,T1
6252,June 12,2016,Croatia,Turkey,1,0,European Championship,in France,26,-26,1844,1803,2,-2,16,19,1818,1829,T1
6253,June 12,2016,Ecuador,Haiti,4,0,Copa América,in the United States,9,-9,1885,1478,1,-2,13,90,1876,1487,T1
6254,June 12,2016,Germany,Ukraine,2,0,European Championship,in France,18,-18,2053,1818,0,-2,2,18,2035,1836,T1
6255,June 12,2016,Lesotho,Mauritius,3,0,COSAFA Cup,in Namibia,34,-34,1143,1064,7,-3,172,185,1109,1098,T1
6256,June 12,2016,Malawi,Angola,3,0,COSAFA Cup,in Namibia,40,-40,1341,1309,11,-10,119,128,1301,1349,T1
6257,June 12,2016,Peru,Brazil,1,0,Copa América,in the United States,39,-39,1830,1978,3,-3,17,6,1791,2017,T1
6258,June 12,2016,Poland,Northern Ireland,1,0,European Championship,in France,15,-15,1781,1609,2,-3,24,56,1766,1624,T1
6259,June 13,2016,Ireland,Sweden,1,1,European Championship,in France,0,0,1759,1765,0,0,29,27,1759,1765,draw
6260,June 13,2016,Italy,Belgium,2,0,European Championship,in France,43,-43,1919,1880,4,-4,11,15,1876,1923,T1
6261,June 13,2016,Madagascar,Zimbabwe,0,0,COSAFA Cup,in Namibia,8,-8,1256,1397,3,-1,145,111,1248,1405,draw
6262,June 13,2016,Mexico,Venezuela,1,1,Copa América,in the United States,-18,18,1968,1694,-3,3,7,42,1986,1676,draw
6263,June 13,2016,Spain,Czechia,1,0,European Championship,in France,10,-10,2003,1745,0,-2,3,32,1993,1755,T1
6264,June 13,2016,Swaziland,Seychelles,4,0,COSAFA Cup,in Namibia,10,-10,1308,967,2,0,129,189,1298,977,T1
6265,June 13,2016,Uruguay,Jamaica,3,0,Copa América,in the United States,12,-12,1895,1555,1,-4,13,72,1883,1567,T1
6266,June 14,2016,Argentina,Bolivia,3,0,Copa América,in the United States,5,-5,2084,1574,0,-2,1,64,2079,1579,T1
6267,June 14,2016,Chile,Panama,4,2,Copa América,in the United States,15,-15,1942,1672,0,-2,9,46,1927,1687,T1
6268,June 14,2016,Hungary,Austria,2,0,European Championship,in France,46,-46,1742,1732,7,-11,34,36,1696,1778,T1
6269,June 14,2016,Iceland,Portugal,1,1,European Championship,in France,15,-15,1681,1895,2,0,44,12,1666,1910,draw
6270,June 14,2016,Lesotho,Angola,2,0,COSAFA Cup,in Namibia,43,-43,1186,1266,6,-13,166,141,1143,1309,T1
6271,June 14,2016,Malawi,Mauritius,1,0,COSAFA Cup,in Namibia,7,-7,1348,1057,1,-1,118,186,1341,1064,T1
6272,June 15,2016,France,Albania,2,0,European Championship,in France,4,-4,1986,1598,0,-1,4,58,1982,1602,T1
6273,June 15,2016,Romania,Switzerland,1,1,European Championship,in France,2,-2,1755,1785,0,-1,29,23,1753,1787,draw
6274,June 15,2016,Slovakia,Russia,2,1,European Championship,in France,28,-28,1761,1746,9,-6,26,31,1733,1774,T1
6275,June 15,2016,Swaziland,Madagascar,1,0,COSAFA Cup,in Namibia,17,-17,1325,1239,2,-4,126,149,1308,1256,T1
6276,June 15,2016,Zimbabwe,Seychelles,5,0,COSAFA Cup,in Namibia,6,-6,1403,961,1,-1,110,190,1397,967,T1
6277,June 16,2016,England,Wales,2,1,European Championship,in France,9,-9,1967,1679,0,-2,8,45,1958,1688,T1
6278,June 16,2016,Germany,Poland,0,0,European Championship,in France,-16,16,2037,1797,0,3,2,21,2053,1781,draw
6279,June 16,2016,Lesotho,Malawi,1,0,COSAFA Cup,in Namibia,29,-29,1215,1319,7,-8,159,126,1186,1348,T1
6280,June 16,2016,Mauritius,Angola,2,0,COSAFA Cup,in Namibia,46,-46,1103,1220,4,-15,182,156,1057,1266,T1
6281,June 16,2016,Northern Ireland,Ukraine,2,0,European Championship,in France,58,-58,1667,1760,9,-9,47,27,1609,1818,T1
6282,June 16,2016,United States,Ecuador,2,1,Copa América,in the United States,25,-25,1812,1860,4,-1,18,15,1787,1885,T1
6283,June 17,2016,Colombia,Peru,0,0,Copa América,in the United States,-10,10,1964,1840,-2,1,8,16,1974,1830,draw
6284,June 17,2016,Croatia,Czechia,2,2,European Championship,in France,-7,7,1837,1752,-1,2,17,30,1844,1745,draw
6285,June 17,2016,Italy,Sweden,1,0,European Championship,in France,15,-15,1934,1750,1,-7,10,31,1919,1765,T1
6286,June 17,2016,Papua New Guinea,Malaysia,2,0,Friendly,in Papua New Guinea,10,-10,1139,1105,1,-3,173,180,1129,1115,T1
6287,June 17,2016,Spain,Turkey,3,0,European Championship,in France,21,-21,2024,1782,0,-4,3,23,2003,1803,T1
6288,June 18,2016,Argentina,Venezuela,4,1,Copa América,in the United States,8,-8,2092,1686,0,0,1,42,2084,1694,T1
6289,June 18,2016,Austria,Portugal,0,0,European Championship,in France,11,-11,1743,1884,3,-2,33,14,1732,1895,draw
6290,June 18,2016,Belgium,Ireland,3,0,European Championship,in France,29,-29,1909,1730,3,-9,11,36,1880,1759,T1
6291,June 18,2016,Chile,Mexico,7,0,Copa América,in the United States,60,-60,2002,1908,5,-6,4,12,1942,1968,T1
6292,June 18,2016,Hungary,Iceland,1,1,European Championship,in France,-4,4,1738,1685,0,0,35,43,1742,1681,draw
6293,June 18,2016,Lesotho,South Africa,1,1,COSAFA Cup,in Namibia,16,-16,1231,1585,5,-2,154,59,1215,1601,draw
6294,June 18,2016,Namibia,Botswana,1,1,COSAFA Cup,in Namibia,-8,8,1332,1299,-2,2,121,131,1340,1291,draw
6295,June 19,2016,Albania,Romania,1,0,European Championship,in France,36,-36,1634,1719,4,-12,53,39,1598,1755,T1
6296,June 19,2016,Democratic Republic of Congo,Mozambique,1,0,COSAFA Cup,in Namibia,9,-9,1582,1351,4,-2,61,117,1573,1360,T1
6297,June 19,2016,France,Switzerland,0,0,European Championship,in France,-17,17,1969,1802,-1,3,6,19,1986,1785,draw
6298,June 19,2016,French Guiana,Bermuda,3,0,CONCACAF Champ &amp; Carib Champ qual,in French Guiana,23,-23,1278,1206,4,-7,141,162,1255,1229,T1
6299,June 19,2016,Swaziland,Zambia,0,0,COSAFA Cup,in Namibia,8,-8,1333,1459,4,-2,121,96,1325,1467,draw
6300,June 20,2016,England,Slovakia,0,0,European Championship,in France,-13,13,1954,1774,-1,0,8,24,1967,1761,draw
6301,June 20,2016,Wales,Russia,3,0,European Championship,in France,52,-52,1731,1694,11,-12,34,42,1679,1746,T1
6302,June 21,2016,Croatia,Spain,2,1,European Championship,in France,37,-37,1874,1987,2,-1,15,4,1837,2024,T1
6303,June 21,2016,Germany,Northern Ireland,1,0,European Championship,in France,5,-5,2042,1662,0,0,2,47,2037,1667,T1
6304,June 21,2016,Namibia,Mozambique,3,0,COSAFA Cup,in Namibia,27,-27,1359,1324,7,-8,115,125,1332,1351,T1
6305,June 21,2016,Poland,Ukraine,1,0,European Championship,in France,22,-22,1819,1738,3,-5,18,31,1797,1760,T1
6306,June 21,2016,Turkey,Czechia,2,0,European Championship,in France,34,-34,1816,1718,4,-11,19,39,1782,1752,T1
6307,June 21,2016,United States,Argentina,0,4,Copa América,in the United States,-25,25,1787,2117,-5,0,23,1,1812,2092,T2
6308,June 21,2016,Zambia,Lesotho,3,2,COSAFA Cup,in Namibia,8,-8,1467,1223,2,0,94,154,1459,1231,T1
6309,June 22,2016,Belgium,Sweden,1,0,European Championship,in France,14,-14,1923,1736,1,-5,10,32,1909,1750,T1
6310,June 22,2016,Botswana,Democratic Republic of Congo,0,0,COSAFA Cup,in Namibia,13,-13,1312,1569,4,-6,127,67,1299,1582,draw
6311,June 22,2016,Chile,Colombia,2,0,Copa América,in the United States,33,-33,2035,1931,0,-1,3,8,2002,1964,T1
6312,June 22,2016,Hungary,Portugal,3,3,European Championship,in France,10,-10,1748,1874,3,0,28,14,1738,1884,draw
6313,June 22,2016,Iceland,Austria,2,1,European Championship,in France,29,-29,1714,1714,5,-10,39,39,1685,1743,T1
6314,June 22,2016,Ireland,Italy,1,0,European Championship,in France,38,-38,1768,1896,9,-3,25,12,1730,1934,T1
6315,June 22,2016,New Caledonia,Malaysia,1,2,Friendly,in New Caledonia,-17,17,1301,1122,-4,4,131,176,1318,1105,T2
6316,June 22,2016,South Africa,Swaziland,5,1,COSAFA Cup,in Namibia,14,-14,1599,1319,1,-4,58,125,1585,1333,T1
6317,June 24,2016,Namibia,Zambia,1,0,COSAFA Cup,in Namibia,20,-20,1379,1447,1,-5,114,99,1359,1467,T1
6318,June 25,2016,Poland,Switzerland,1,1,European Championship,in France,-1,1,1818,1803,0,0,18,20,1819,1802,draw
6319,June 25,2016,Portugal,Croatia,1,0,European Championship,in France,25,-25,1899,1849,2,-2,12,16,1874,1874,T1
6320,June 25,2016,South Africa,Botswana,3,2,COSAFA Cup,in Namibia,6,-6,1605,1306,0,-1,58,128,1599,1312,T1
6321,June 25,2016,Swaziland,Democratic Republic of Congo,1,0,COSAFA Cup,in Namibia,32,-32,1351,1537,7,-6,118,73,1319,1569,T1
6322,June 25,2016,United States,Colombia,0,1,Copa América,in the United States,-22,22,1765,1953,-2,0,25,8,1787,1931,T2
6323,June 25,2016,Wales,Northern Ireland,1,0,European Championship,in France,20,-20,1751,1642,5,-4,28,51,1731,1662,T1
6324,June 26,2016,Argentina,Chile,0,0,Copa América,in the United States,-6,6,2111,2041,0,0,1,3,2117,2035,draw
6325,June 26,2016,Belgium,Hungary,4,0,European Championship,in France,25,-25,1948,1723,1,-7,9,36,1923,1748,T1
6326,June 26,2016,Fiji,Malaysia,1,1,Friendly,in Fiji,-6,6,1239,1128,0,1,147,175,1245,1122,draw
6327,June 26,2016,France,Ireland,2,1,European Championship,in France,8,-8,1977,1760,0,-1,6,25,1969,1768,T1
6328,June 26,2016,Germany,Slovakia,3,0,European Championship,in France,15,-15,2057,1759,0,-3,2,26,2042,1774,T1
6329,June 27,2016,Iceland,England,2,1,European Championship,in France,40,-40,1754,1914,12,-4,27,11,1714,1954,T1
6330,June 27,2016,Italy,Spain,2,0,European Championship,in France,47,-47,1943,1940,5,-5,8,9,1896,1987,T1
6331,June 30,2016,Macao,Mongolia,2,2,East Asian Cup qualifier,in Guam,3,-3,625,670,0,0,227,224,622,673,draw
6332,June 30,2016,Poland,Portugal,1,1,European Championship,in France,6,-6,1824,1893,0,-1,18,14,1818,1899,draw
6333,June 30,2016,Taiwan,Northern Mariana Islands,8,1,East Asian Cup qualifier,in Guam,14,-14,770,448,2,0,210,237,756,462,T1
6334,July 1,2016,Wales,Belgium,3,1,European Championship,in France,57,-57,1808,1891,9,-7,20,14,1751,1948,T1
6335,July 2,2016,Germany,Italy,1,1,European Championship,in France,-8,8,2049,1951,0,0,2,7,2057,1943,draw
6336,July 2,2016,Macao,Northern Mariana Islands,3,1,East Asian Cup qualifier,in Guam,16,-16,641,432,2,0,225,237,625,448,T1
6337,July 2,2016,Taiwan,Mongolia,2,0,East Asian Cup qualifier,in Guam,22,-22,792,648,1,0,209,224,770,670,T1
6338,July 3,2016,France,Iceland,5,2,European Championship,in France,12,-12,1989,1742,1,-3,4,31,1977,1754,T1
6339,July 4,2016,Mongolia,Northern Mariana Islands,8,0,East Asian Cup qualifier,in Guam,21,-21,669,411,0,0,224,237,648,432,T1
6340,July 4,2016,Taiwan,Macao,3,2,East Asian Cup qualifier,in Guam,12,-12,804,629,1,-2,208,227,792,641,T1
6341,July 6,2016,Portugal,Wales,2,0,European Championship,in France,29,-29,1922,1779,3,-3,10,23,1893,1808,T1
6342,July 7,2016,France,Germany,2,0,European Championship,in France,33,-33,2022,2016,1,-2,3,4,1989,2049,T1
6343,July 10,2016,France,Portugal,0,1,European Championship,in France,-38,38,1984,1960,-1,4,4,6,2022,1922,T2
6344,July 24,2016,Uzbekistan,Iraq,2,1,Friendly,in Uzbekistan,4,-4,1651,1495,0,0,49,85,1647,1499,T1
6345,July 28,2016,Cambodia,Singapore,2,1,Friendly,in Cambodia,17,-17,783,1139,0,-2,211,172,766,1156,T1
6346,August 8,2016,Oman,Turkmenistan,1,0,Friendly,in Oman,3,-3,1473,1284,0,-2,92,139,1470,1287,T1
6347,August 8,2016,Qatar,Iraq,2,1,Friendly,in Qatar,6,-6,1529,1489,3,-1,75,86,1523,1495,T1
6348,August 10,2016,Panama,Guatemala,0,0,Friendly,in Panama,-7,7,1665,1497,0,0,46,85,1672,1490,draw
6349,August 13,2016,Bhutan,India,0,3,Friendly,in Bhutan,-3,3,547,1089,0,1,234,183,550,1086,T2
6350,August 16,2016,North Korea,Iraq,1,0,Friendly,in Malaysia,10,-10,1513,1479,2,-3,82,89,1503,1489,T1
6351,August 18,2016,Qatar,Jordan,3,2,Friendly,in Switzerland,10,-10,1539,1519,2,-5,73,80,1529,1529,T1
6352,August 21,2016,Iraq,North Korea,1,1,Friendly,in Malaysia,1,-1,1480,1512,1,0,88,82,1479,1513,draw
6353,August 24,2016,Uzbekistan,Burkina Faso,1,0,Friendly,in Uzbekistan,3,-3,1654,1461,1,0,48,94,1651,1464,T1
6354,August 24,2016,Saudi Arabia,Laos,4,0,Friendly,in Qatar,1,-1,1536,791,0,0,75,210,1535,792,T1
6355,August 24,2016,North Korea,United Arab Emirates,2,0,Friendly,in China,18,-18,1530,1564,6,-6,76,67,1512,1582,T1
6356,August 24,2016,Honduras,Nicaragua,1,0,Friendly,in Honduras,2,-2,1527,1260,-1,0,77,144,1525,1262,T1
6357,August 25,2016,Qatar,Thailand,3,0,Friendly,in Qatar,8,-8,1547,1427,1,-1,72,102,1539,1435,T1
6358,August 27,2016,Tajikistan,Syria,0,0,Friendly,in Tajikistan,5,-5,1220,1509,3,0,156,82,1215,1514,draw
6359,August 28,2016,Dominican Republic,Puerto Rico,5,0,Friendly,in the Dominican Republic,8,-8,1226,1081,5,-1,154,184,1218,1089,T1
6360,August 30,2016,Uganda,Kenya,0,0,Friendly,in Uganda,-6,6,1498,1350,0,0,84,119,1504,1344,draw
6361,August 30,2016,Kyrgyzstan,Kazakhstan,2,0,Friendly,in Kyrgyzstan,20,-20,1228,1401,5,-4,155,110,1208,1421,T1
6362,August 30,2016,Egypt,Guinea,1,1,Friendly,in Egypt,-6,6,1647,1531,0,2,49,76,1653,1525,draw
6363,August 30,2016,Puerto Rico,Dominican Republic,0,1,Friendly,in Puerto Rico,-9,9,1072,1235,-1,4,185,150,1081,1226,T2
6364,August 31,2016,Turkey,Russia,0,0,Friendly,in Turkey,-6,6,1810,1700,0,0,19,43,1816,1694,draw
6365,August 31,2016,Norway,Belarus,0,1,Friendly,in Norway,-14,14,1623,1600,-2,0,54,59,1637,1586,T2
6366,August 31,2016,Lebanon,Jordan,1,1,Friendly,in Lebanon,1,-1,1373,1518,0,1,115,80,1372,1519,draw
6367,August 31,2016,Ireland,Oman,4,0,Friendly,in Ireland,4,-4,1764,1469,1,0,25,92,1760,1473,T1
6368,August 31,2016,Germany,Finland,2,0,Friendly,in Germany,1,-1,2017,1575,0,-1,3,62,2016,1576,T1
6369,August 31,2016,Estonia,Malta,1,1,Friendly,in Estonia,-7,7,1461,1239,0,6,93,147,1468,1232,draw
6370,August 31,2016,Denmark,Liechtenstein,5,0,Friendly,in Denmark,1,-1,1746,1192,0,0,29,165,1745,1193,T1
6371,August 31,2016,Czechia,Armenia,3,0,Friendly,in Czechia,5,-5,1723,1518,2,-1,37,80,1718,1523,T1
6372,August 31,2016,Albania,Morocco,0,0,Friendly,in Albania,-4,4,1630,1580,1,0,52,61,1634,1576,draw
6373,August 31,2016,Nicaragua,Saint Kitts and Nevis,0,0,Friendly,in Nicaragua,-2,2,1258,1304,0,1,144,129,1260,1302,draw
6374,September 1,2016,Portugal,Gibraltar,5,0,Friendly,in Portugal,0,0,1960,1111,0,0,6,179,1960,1111,T1
6375,September 1,2016,Netherlands,Greece,1,2,Friendly,in the Netherlands,-18,18,1907,1635,-2,4,12,52,1925,1617,T2
6376,September 1,2016,Maldives,Bangladesh,5,0,Friendly,in the Maldives,12,-12,943,868,0,-1,197,205,931,880,T1
6377,September 1,2016,Italy,France,1,3,Friendly,in Italy,-18,18,1933,2002,-1,-1,9,5,1951,1984,T2
6378,September 1,2016,Hong Kong,Cambodia,4,2,Friendly,in Hong Kong,2,-2,1185,781,0,0,168,211,1183,783,T1
6379,September 1,2016,Belgium,Spain,0,2,Friendly,in Belgium,-17,17,1874,1957,0,1,14,8,1891,1940,T2
6380,September 1,2016,Bahrain,Singapore,3,1,Friendly,in Bahrain,3,-3,1425,1136,3,-1,102,173,1422,1139,T1
6381,September 1,2016,Uzbekistan,Syria,1,0,World Cup qualifier,in Uzbekistan,8,-8,1662,1501,1,-1,47,83,1654,1509,T1
6382,September 1,2016,South Korea,China,3,2,World Cup qualifier,in South Korea,5,-5,1803,1560,2,-2,19,68,1798,1565,T1
6383,September 1,2016,Saudi Arabia,Thailand,1,0,World Cup qualifier,in Saudi Arabia,9,-9,1545,1418,3,-4,72,106,1536,1427,T1
6384,September 1,2016,Japan,United Arab Emirates,1,2,World Cup qualifier,in Japan,-34,34,1719,1598,-10,6,38,61,1753,1564,T2
6385,September 1,2016,Iran,Qatar,2,0,World Cup qualifier,in Iran,9,-9,1752,1538,1,-2,29,74,1743,1547,T1
6386,September 1,2016,Australia,Iraq,2,0,World Cup qualifier,in Australia,8,-8,1712,1472,1,-3,41,91,1704,1480,T1
6387,September 1,2016,Paraguay,Chile,2,1,World Cup qualifier,in Paraguay,31,-31,1756,2010,8,-2,28,4,1725,2041,T1
6388,September 1,2016,Ecuador,Brazil,0,3,World Cup qualifier,in Ecuador,-33,33,1827,2011,-1,2,16,3,1860,1978,T2
6389,September 1,2016,Colombia,Venezuela,2,0,World Cup qualifier,in Colombia,6,-6,1959,1680,0,-1,7,45,1953,1686,T1
6390,September 1,2016,Bolivia,Peru,2,0,World Cup qualifier,in Bolivia,43,-43,1617,1797,6,-4,57,21,1574,1840,T1
6391,September 1,2016,Argentina,Uruguay,1,0,World Cup qualifier,in Argentina,6,-6,2117,1889,0,0,1,13,2111,1895,T1
6392,September 2,2016,Sudan,Gabon,1,2,Friendly,in Sudan,-8,8,1285,1456,-4,1,137,97,1293,1448,T2
6393,September 2,2016,Latvia,Luxembourg,3,1,Friendly,in Latvia,4,-4,1484,1235,1,-3,87,150,1480,1239,T1
6394,September 2,2016,South Africa,Mauritania,1,1,African Nations Cup qualifier,in South Africa,-17,17,1588,1306,-2,7,61,128,1605,1289,draw
6395,September 2,2016,Trinidad and Tobago,Guatemala,2,2,World Cup qualifier,in Trinidad and Tobago,-9,9,1561,1506,-1,3,66,82,1570,1497,draw
6396,September 2,2016,Saint Vincent and the Grenadines,United States,0,6,World Cup qualifier,in Saint Vincent and the Grenadines,-3,3,1111,1768,0,0,178,24,1114,1765,T2
6397,September 2,2016,Panama,Jamaica,2,0,World Cup qualifier,in Panama,14,-14,1679,1541,0,-2,46,73,1665,1555,T1
6398,September 2,2016,Honduras,Canada,2,1,World Cup qualifier,in Honduras,14,-14,1541,1508,5,-2,73,81,1527,1522,T1
6399,September 2,2016,Haiti,Costa Rica,0,1,World Cup qualifier,in Haiti,-9,9,1469,1797,-2,1,91,21,1478,1788,T2
6400,September 2,2016,El Salvador,Mexico,1,3,World Cup qualifier,in El Salvador,-6,6,1417,1914,-2,1,106,10,1423,1908,T2
6401,September 3,2016,India,Puerto Rico,4,1,Friendly,in India,12,-12,1101,1060,1,-1,182,186,1089,1072,T1
6402,September 3,2016,Senegal,Namibia,2,0,African Nations Cup qualifier,in Senegal,5,-5,1686,1374,0,0,44,114,1681,1379,T1
6403,September 3,2016,Nigeria,Tanzania,1,0,African Nations Cup qualifier,in Nigeria,4,-4,1629,1327,1,-3,53,125,1625,1331,T1
6404,September 3,2016,Mozambique,Mauritius,1,0,African Nations Cup qualifier,in Mozambique,5,-5,1329,1098,1,-1,124,183,1324,1103,T1
6405,September 3,2016,Ivory Coast,Sierra Leone,1,1,African Nations Cup qualifier,in Ivory Coast,-18,18,1711,1372,-7,0,41,116,1729,1354,draw
6406,September 3,2016,Ghana,Rwanda,1,1,African Nations Cup qualifier,in Ghana,-17,17,1626,1308,-4,6,54,128,1643,1291,draw
6407,September 3,2016,Ethiopia,Seychelles,2,1,African Nations Cup qualifier,in Ethiopia,3,-3,1301,958,0,-1,133,191,1298,961,T1
6408,September 3,2016,Cape Verde,Libya,0,1,African Nations Cup qualifier,in Cape Verde,-27,27,1479,1508,-6,7,88,81,1506,1481,T2
6409,September 3,2016,Cameroon,Gambia,2,0,African Nations Cup qualifier,in Cameroon,5,-5,1623,1280,1,-2,55,139,1618,1285,T1
6410,September 3,2016,Angola,Madagascar,1,1,African Nations Cup qualifier,in Angola,-5,5,1215,1244,-2,0,160,147,1220,1239,draw
6411,September 4,2016,Bahrain,Jordan,0,0,Friendly,in Bahrain,0,0,1425,1518,0,0,102,79,1425,1518,draw
6412,September 4,2016,Zambia,Kenya,1,1,African Nations Cup qualifier,in Zambia,-10,10,1437,1360,-1,2,100,117,1447,1350,draw
6413,September 4,2016,Uganda,Comoros,1,0,African Nations Cup qualifier,in Uganda,1,-1,1499,963,0,0,85,189,1498,964,T1
6414,September 4,2016,Tunisia,Liberia,4,1,African Nations Cup qualifier,in Tunisia,9,-9,1566,1322,2,-3,68,125,1557,1331,T1
6415,September 4,2016,Togo,Djibouti,5,0,African Nations Cup qualifier,in Togo,1,-1,1413,752,-1,0,108,214,1412,753,T1
6416,September 4,2016,Niger,Burundi,3,1,African Nations Cup qualifier,in Niger,28,-28,1293,1311,7,-7,135,127,1265,1339,T1
6417,September 4,2016,Morocco,São Tomé and Príncipe,2,0,African Nations Cup qualifier,in Morocco,2,-2,1582,1107,0,0,63,180,1580,1109,T1
6418,September 4,2016,Mali,Benin,5,2,African Nations Cup qualifier,in Mali,13,-13,1574,1396,1,-2,65,110,1561,1409,T1
6419,September 4,2016,Malawi,Swaziland,1,0,African Nations Cup qualifier,in Malawi,16,-16,1335,1335,5,-3,121,121,1319,1351,T1
6420,September 4,2016,Guinea,Zimbabwe,1,0,African Nations Cup qualifier,in Guinea,8,-8,1539,1395,1,-2,76,111,1531,1403,T1
6421,September 4,2016,Equatorial Guinea,South Sudan,4,0,African Nations Cup qualifier,in Equatorial Guinea,11,-11,1342,1114,3,-1,119,177,1331,1125,T1
6422,September 4,2016,Democratic Republic of Congo,Central African Republic,4,1,African Nations Cup qualifier,in the Democratic Republic of the Congo,9,-9,1546,1295,5,-3,71,134,1537,1304,T1
6423,September 4,2016,Congo,Guinea-Bissau,1,0,African Nations Cup qualifier,in Congo,7,-7,1466,1280,2,-3,94,139,1459,1287,T1
6424,September 4,2016,Burkina Faso,Botswana,2,1,African Nations Cup qualifier,in Burkina Faso,7,-7,1468,1299,0,-4,93,133,1461,1306,T1
6425,September 4,2016,Algeria,Lesotho,6,0,African Nations Cup qualifier,in Algeria,4,-4,1663,1219,1,-2,47,158,1659,1223,T1
6426,September 4,2016,Slovakia,England,0,1,World Cup qualifier,in Slovakia,-17,17,1742,1931,-3,0,30,10,1759,1914,T2
6427,September 4,2016,San Marino,Azerbaijan,0,1,World Cup qualifier,in San Marino,-4,4,880,1393,0,0,203,112,884,1389,T2
6428,September 4,2016,Romania,Montenegro,1,1,World Cup qualifier,in Romania,-13,13,1706,1572,-5,3,42,66,1719,1559,draw
6429,September 4,2016,Norway,Germany,0,3,World Cup qualifier,in Norway,-11,11,1612,2028,-2,0,57,2,1623,2017,T2
6430,September 4,2016,Malta,Scotland,1,5,World Cup qualifier,in Malta,-8,8,1231,1719,-6,5,154,36,1239,1711,T2
6431,September 4,2016,Lithuania,Slovenia,2,2,World Cup qualifier,in Lithuania,4,-4,1448,1609,1,0,99,58,1444,1613,draw
6432,September 4,2016,Kazakhstan,Poland,2,2,World Cup qualifier,in Kazakhstan,15,-15,1416,1809,3,-1,107,18,1401,1824,draw
6433,September 4,2016,Denmark,Armenia,1,0,World Cup qualifier,in Denmark,5,-5,1751,1513,1,-1,29,80,1746,1518,T1
6434,September 4,2016,Czechia,Northern Ireland,0,0,World Cup qualifier,in Czechia,-10,10,1713,1652,-4,1,39,49,1723,1642,draw
6435,September 5,2016,Lebanon,Afghanistan,2,0,Friendly,in Lebanon,4,-4,1377,1143,1,-1,114,171,1373,1147,T1
6436,September 5,2016,Wales,Moldova,4,0,World Cup qualifier,in Wales,3,-3,1782,1350,0,0,23,118,1779,1353,T1
6437,September 5,2016,Ukraine,Iceland,1,1,World Cup qualifier,in Ukraine,-5,5,1733,1747,-1,0,33,30,1738,1742,draw
6438,September 5,2016,Spain,Liechtenstein,8,0,World Cup qualifier,in Spain,1,-1,1958,1191,0,0,8,165,1957,1192,T1
6439,September 5,2016,Serbia,Ireland,2,2,World Cup qualifier,in Serbia,-4,4,1722,1768,-2,1,36,24,1726,1764,draw
6440,September 5,2016,Israel,Italy,1,3,World Cup qualifier,in Israel,-11,11,1559,1944,-3,0,70,9,1570,1933,T2
6441,September 5,2016,Georgia,Austria,1,2,World Cup qualifier,in Georgia,-13,13,1475,1727,-2,4,88,34,1488,1714,T2
6442,September 5,2016,Finland,Kosovo,1,1,World Cup qualifier,in Finland,-13,13,1562,1413,-3,1,67,108,1575,1400,draw
6443,September 5,2016,Croatia,Turkey,1,1,World Cup qualifier,in Croatia,-8,8,1841,1818,0,0,15,17,1849,1810,draw
6444,September 6,2016,South Africa,Egypt,1,0,Friendly,in South Africa,9,-9,1597,1638,1,0,60,50,1588,1647,T1
6445,September 6,2016,Russia,Ghana,1,0,Friendly,in Russia,5,-5,1705,1621,0,-2,43,56,1700,1626,T1
6446,September 6,2016,Palestine,Tajikistan,1,1,Friendly,in Palestine,-6,6,1332,1226,-2,2,122,155,1338,1220,draw
6447,September 6,2016,Kyrgyzstan,Philippines,1,2,Friendly,in Kyrgyzstan,-12,12,1216,1275,-5,0,160,143,1228,1263,T2
6448,September 6,2016,Indonesia,Malaysia,3,0,Friendly,in Indonesia,9,-9,1217,1119,2,-1,159,176,1208,1128,T1
6449,September 6,2016,Cameroon,Gabon,2,1,Friendly,in Cameroon,4,-4,1627,1452,0,-1,55,98,1623,1456,T1
6450,September 6,2016,Maldives,Laos,4,0,Asian Cup qualifier,in the Maldives,14,-14,957,777,4,-1,193,211,943,791,T1
6451,September 6,2016,Bangladesh,Bhutan,0,0,Asian Cup qualifier,in Bangladesh,-17,17,851,564,-1,3,206,231,868,547,draw
6452,September 6,2016,United Arab Emirates,Australia,0,1,World Cup qualifier,in the United Arab Emirates,-19,19,1579,1731,-3,5,63,35,1598,1712,T2
6453,September 6,2016,Thailand,Japan,0,2,World Cup qualifier,in Thailand,-14,14,1404,1733,-3,4,108,33,1418,1719,T2
6454,September 6,2016,Syria,South Korea,0,0,World Cup qualifier,in Malaysia,14,-14,1515,1789,4,-3,80,22,1501,1803,draw
6455,September 6,2016,Qatar,Uzbekistan,0,1,World Cup qualifier,in Qatar,-19,19,1519,1681,-1,2,78,46,1538,1662,T2
6456,September 6,2016,Iraq,Saudi Arabia,1,2,World Cup qualifier,in Malaysia,-16,16,1456,1561,-5,3,95,69,1472,1545,T2
6457,September 6,2016,China,Iran,0,0,World Cup qualifier,in China,5,-5,1565,1747,2,0,67,28,1560,1752,draw
6458,September 6,2016,Switzerland,Portugal,2,0,World Cup qualifier,in Switzerland,35,-35,1838,1925,3,-4,16,10,1803,1960,T1
6459,September 6,2016,Sweden,Netherlands,1,1,World Cup qualifier,in Sweden,4,-4,1740,1903,1,0,31,12,1736,1907,draw
6460,September 6,2016,Gibraltar,Greece,1,4,World Cup qualifier,in Portugal,-3,3,1108,1638,0,1,178,50,1111,1635,T2
6461,September 6,2016,Faroe Islands,Hungary,0,0,World Cup qualifier,in the Faroe Islands,16,-16,1249,1707,5,-6,147,41,1233,1723,draw
6462,September 6,2016,Cyprus,Belgium,0,3,World Cup qualifier,in Cyprus,-8,8,1413,1882,-1,0,105,14,1421,1874,T2
6463,September 6,2016,Bulgaria,Luxembourg,4,3,World Cup qualifier,in Bulgaria,3,-3,1588,1232,1,-3,61,152,1585,1235,T1
6464,September 6,2016,Bosnia and Herzegovina,Estonia,5,0,World Cup qualifier,in Bosnia and Herzegovina,7,-7,1768,1454,1,-2,25,97,1761,1461,T1
6465,September 6,2016,Belarus,France,0,0,World Cup qualifier,in Belarus,14,-14,1614,1988,2,0,57,5,1600,2002,draw
6466,September 6,2016,Andorra,Latvia,0,1,World Cup qualifier,in Andorra,-3,3,958,1487,0,-1,190,87,961,1484,T2
6467,September 6,2016,Albania,Macedonia,2,1,World Cup qualifier,in Albania,6,-6,1636,1425,0,0,52,101,1630,1431,T1
6468,September 6,2016,United States,Trinidad and Tobago,4,0,World Cup qualifier,in the United States,11,-11,1779,1550,0,-4,24,72,1768,1561,T1
6469,September 6,2016,Mexico,Honduras,0,0,World Cup qualifier,in Mexico,-18,18,1896,1559,-2,4,13,70,1914,1541,draw
6470,September 6,2016,Jamaica,Haiti,0,2,World Cup qualifier,in Jamaica,-44,44,1497,1513,-12,10,86,81,1541,1469,T2
6471,September 6,2016,Guatemala,Saint Vincent and the Grenadines,9,3,World Cup qualifier,in Guatemala,5,-5,1511,1106,0,-2,83,180,1506,1111,T1
6472,September 6,2016,Costa Rica,Panama,3,1,World Cup qualifier,in Costa Rica,13,-13,1810,1666,1,-1,20,47,1797,1679,T1
6473,September 6,2016,Canada,El Salvador,3,1,World Cup qualifier,in Canada,15,-15,1523,1402,4,-3,77,109,1508,1417,T1
6474,September 6,2016,Venezuela,Argentina,2,2,World Cup qualifier,in Venezuela,15,-15,1695,2102,1,0,44,1,1680,2117,draw
6475,September 6,2016,Uruguay,Paraguay,4,0,World Cup qualifier,in Uruguay,16,-16,1905,1740,2,-4,11,31,1889,1756,T1
6476,September 6,2016,Peru,Ecuador,2,1,World Cup qualifier,in Peru,16,-16,1813,1811,3,-3,18,19,1797,1827,T1
6477,September 6,2016,Chile,Bolivia,0,0,World Cup qualifier,in Chile,-18,18,1992,1635,0,3,4,53,2010,1617,draw
6478,September 6,2016,Brazil,Colombia,2,1,World Cup qualifier,in Brazil,12,-12,2023,1947,0,0,3,7,2011,1959,T1
6479,September 29,2016,Qatar,Serbia,3,0,Friendly,in Qatar,23,-23,1542,1699,3,-6,75,43,1519,1722,T1
6480,September 30,2016,Botswana,Angola,1,1,Friendly,in Botswana,-5,5,1294,1220,-1,4,134,157,1299,1215,draw
6481,October 4,2016,Togo,Uganda,1,0,Friendly,in Togo,10,-10,1423,1489,1,-1,104,86,1413,1499,T1
6482,October 4,2016,Democratic Republic of Congo,Kenya,0,1,Friendly,in the Democratic Republic of the Congo,-17,17,1529,1377,-4,3,77,114,1546,1360,T2
6483,October 5,2016,Tajikistan,Palestine,3,3,Friendly,in Tajikistan,0,0,1226,1332,1,0,154,122,1226,1332,draw
6484,October 5,2016,Solomon Islands,New Caledonia,0,3,Friendly,in the Solomon Islands,-15,15,1129,1316,-4,5,174,126,1144,1301,T2
6485,October 5,2016,Trinidad and Tobago,Dominican Republic,4,0,CONCACAF Champ &amp; Carib Champ qual,in Trinidad and Tobago,6,-6,1556,1229,0,-3,72,153,1550,1235,T1
6486,October 5,2016,Curaçao,Antigua and Barbuda,3,0,CONCACAF Champ &amp; Carib Champ qual,in Curaçao,32,-32,1195,1200,4,-12,165,164,1163,1232,T1
6487,October 6,2016,Vietnam,North Korea,5,2,Friendly,in Vietnam,26,-26,1279,1504,4,-8,142,84,1253,1530,T1
6488,October 6,2016,Kyrgyzstan,Lebanon,0,0,Friendly,in Kyrgyzstan,2,-2,1218,1375,1,-1,159,115,1216,1377,draw
6489,October 6,2016,Canada,Mauritania,4,0,Friendly,in Morocco,8,-8,1531,1298,1,-2,77,132,1523,1306,T1
6490,October 6,2016,Cambodia,Hong Kong,0,2,Friendly,in Cambodia,-4,4,777,1189,0,2,210,167,781,1185,T2
6491,October 6,2016,Uzbekistan,Iran,0,1,World Cup qualifier,in Uzbekistan,-22,22,1659,1769,-2,2,48,26,1681,1747,T2
6492,October 6,2016,United Arab Emirates,Thailand,3,1,World Cup qualifier,in the United Arab Emirates,10,-10,1589,1394,2,-3,61,111,1579,1404,T1
6493,October 6,2016,South Korea,Qatar,3,2,World Cup qualifier,in South Korea,5,-5,1794,1537,0,-1,22,75,1789,1542,T1
6494,October 6,2016,Saudi Arabia,Australia,2,2,World Cup qualifier,in Saudi Arabia,4,-4,1565,1727,1,1,68,34,1561,1731,draw
6495,October 6,2016,Japan,Iraq,2,1,World Cup qualifier,in Japan,4,-4,1737,1452,0,-2,33,97,1733,1456,T1
6496,October 6,2016,China,Syria,0,1,World Cup qualifier,in China,-28,28,1537,1543,-8,8,75,72,1565,1515,T2
6497,October 6,2016,Turkey,Ukraine,2,2,World Cup qualifier,in Turkey,-10,10,1808,1743,-4,3,21,30,1818,1733,draw
6498,October 6,2016,Moldova,Serbia,0,3,World Cup qualifier,in Moldova,-13,13,1337,1712,-1,4,119,39,1350,1699,T2
6499,October 6,2016,Macedonia,Israel,1,2,World Cup qualifier,in Macedonia,-18,18,1407,1577,-5,6,106,64,1425,1559,T2
6500,October 6,2016,Liechtenstein,Albania,0,2,World Cup qualifier,in Liechtenstein,-7,7,1184,1643,-3,2,169,50,1191,1636,T2
6501,October 6,2016,Italy,Spain,1,1,World Cup qualifier,in Italy,-5,5,1939,1963,0,1,8,5,1944,1958,draw
6502,October 6,2016,Ireland,Georgia,1,0,World Cup qualifier,in Ireland,4,-4,1772,1471,0,-1,25,90,1768,1475,T1
6503,October 6,2016,Iceland,Finland,3,2,World Cup qualifier,in Iceland,6,-6,1753,1556,0,-2,28,70,1747,1562,T1
6504,October 6,2016,Croatia,Kosovo,6,0,World Cup qualifier,in Albania,7,-7,1848,1406,-1,-1,16,107,1841,1413,T1
6505,October 6,2016,Austria,Wales,2,2,World Cup qualifier,in Austria,-3,3,1724,1785,0,0,36,23,1727,1782,draw
6506,October 6,2016,Uruguay,Venezuela,3,0,World Cup qualifier,in Uruguay,10,-10,1915,1685,0,-1,11,45,1905,1695,T1
6507,October 6,2016,Peru,Argentina,2,2,World Cup qualifier,in Peru,10,-10,1823,2092,0,0,18,1,1813,2102,draw
6508,October 6,2016,Paraguay,Colombia,0,1,World Cup qualifier,in Paraguay,-14,14,1726,1961,-4,1,35,6,1740,1947,T2
6509,October 6,2016,Ecuador,Chile,3,0,World Cup qualifier,in Ecuador,43,-43,1854,1949,4,-3,15,7,1811,1992,T1
6510,October 6,2016,Brazil,Bolivia,5,0,World Cup qualifier,in Brazil,5,-5,2028,1630,1,0,2,53,2023,1635,T1
6511,October 7,2016,Singapore,Malaysia,0,0,Friendly,in Singapore,-3,3,1133,1122,-1,1,173,175,1136,1119,draw
6512,October 7,2016,Philippines,Bahrain,1,3,Friendly,in the Philippines,-13,13,1262,1438,-1,2,145,99,1275,1425,T2
6513,October 7,2016,Oman,Jordan,1,1,Friendly,in Oman,-1,1,1468,1519,1,0,90,79,1469,1518,draw
6514,October 7,2016,Cuba,United States,0,2,Friendly,in Cuba,-3,3,1309,1782,-1,0,128,24,1312,1779,T2
6515,October 7,2016,Ghana,Uganda,0,0,World Cup qualifier,in Ghana,-12,12,1609,1501,-1,1,57,85,1621,1489,draw
6516,October 7,2016,Portugal,Andorra,6,0,World Cup qualifier,in Portugal,0,0,1925,958,0,0,10,190,1925,958,T1
6517,October 7,2016,Netherlands,Belarus,4,1,World Cup qualifier,in the Netherlands,7,-7,1910,1607,0,-2,12,59,1903,1614,T1
6518,October 7,2016,Luxembourg,Sweden,0,1,World Cup qualifier,in Luxembourg,-3,3,1229,1743,-1,2,152,30,1232,1740,T2
6519,October 7,2016,Hungary,Switzerland,2,3,World Cup qualifier,in Hungary,-18,18,1689,1856,-2,2,43,15,1707,1838,T2
6520,October 7,2016,Latvia,Faroe Islands,0,2,World Cup qualifier,in Latvia,-52,52,1435,1301,-14,16,101,131,1487,1249,T2
6521,October 7,2016,Greece,Cyprus,2,0,World Cup qualifier,in Greece,8,-8,1646,1405,1,-2,50,107,1638,1413,T1
6522,October 7,2016,France,Bulgaria,4,1,World Cup qualifier,in France,4,-4,1992,1584,0,0,4,62,1988,1588,T1
6523,October 7,2016,Estonia,Gibraltar,4,0,World Cup qualifier,in Estonia,5,-5,1459,1103,2,-3,94,181,1454,1108,T1
6524,October 7,2016,Belgium,Bosnia and Herzegovina,4,0,World Cup qualifier,in Belgium,17,-17,1899,1751,1,-1,13,28,1882,1768,T1
6525,October 8,2016,Solomon Islands,New Caledonia,0,1,Friendly,in the Solomon Islands,-8,8,1121,1324,-1,1,175,125,1129,1316,T2
6526,October 8,2016,Mexico,New Zealand,2,1,Friendly,in the United States,2,-2,1898,1541,0,-2,14,74,1896,1543,T1
6527,October 8,2016,Belize,Honduras,1,2,Friendly,in Belize,-3,3,1183,1562,-1,1,169,68,1186,1559,T2
6528,October 8,2016,Taiwan,East Timor,2,1,Asian Cup qualifier,in Taiwan,10,-10,814,698,0,-1,208,218,804,708,T1
6529,October 8,2016,Senegal,Cape Verde,2,0,World Cup qualifier,in Senegal,9,-9,1695,1470,1,-3,43,90,1686,1479,T1
6530,October 8,2016,Ivory Coast,Mali,3,1,World Cup qualifier,in Ivory Coast,12,-12,1723,1562,3,-3,37,68,1711,1574,T1
6531,October 8,2016,Gabon,Morocco,0,0,World Cup qualifier,in Gabon,2,-2,1454,1580,-1,-1,97,64,1452,1582,draw
6532,October 8,2016,Democratic Republic of Congo,Libya,4,0,World Cup qualifier,in the Democratic Republic of the Congo,25,-25,1554,1483,6,-2,72,85,1529,1508,T1
6533,October 8,2016,Burkina Faso,South Africa,1,1,World Cup qualifier,in Burkina Faso,2,-2,1470,1595,0,1,90,59,1468,1597,draw
6534,October 8,2016,Slovenia,Slovakia,1,0,World Cup qualifier,in Slovenia,22,-22,1631,1720,4,-6,53,38,1609,1742,T1
6535,October 8,2016,Scotland,Lithuania,1,1,World Cup qualifier,in Scotland,-16,16,1703,1464,-5,4,42,94,1719,1448,draw
6536,October 8,2016,Poland,Denmark,3,2,World Cup qualifier,in Poland,11,-11,1820,1740,1,-3,19,31,1809,1751,T1
6537,October 8,2016,Northern Ireland,San Marino,4,0,World Cup qualifier,in Northern Ireland,0,0,1652,880,0,0,49,203,1652,880,T1
6538,October 8,2016,Montenegro,Kazakhstan,5,0,World Cup qualifier,in Montenegro,15,-15,1587,1401,5,-5,61,109,1572,1416,T1
6539,October 8,2016,Germany,Czechia,3,0,World Cup qualifier,in Germany,6,-6,2034,1707,0,-2,2,40,2028,1713,T1
6540,October 8,2016,England,Malta,2,0,World Cup qualifier,in England,1,-1,1932,1230,0,0,9,151,1931,1231,T1
6541,October 8,2016,Azerbaijan,Norway,1,0,World Cup qualifier,in Azerbaijan,27,-27,1420,1585,8,-6,104,62,1393,1612,T1
6542,October 8,2016,Armenia,Romania,0,5,World Cup qualifier,in Armenia,-30,30,1483,1736,-5,8,85,33,1513,1706,T2
6543,October 8,2016,Suriname,Guyana,3,2,CONCACAF Champ &amp; Carib Champ qual,in Suriname,15,-15,1219,1208,8,-7,155,162,1204,1223,T1
6544,October 8,2016,French Guiana,Saint Kitts and Nevis,1,0,CONCACAF Champ &amp; Carib Champ qual,in French Guiana,16,-16,1294,1288,10,-8,134,138,1278,1304,T1
6545,October 8,2016,Dominican Republic,Martinique,1,2,CONCACAF Champ &amp; Carib Champ qual,in the Dominican Republic,-13,13,1216,1474,-8,5,160,88,1229,1461,T2
6546,October 8,2016,Antigua and Barbuda,Puerto Rico,2,0,CONCACAF Champ &amp; Carib Champ qual,in Antigua and Barbuda,12,-12,1212,1048,3,0,161,186,1200,1060,T1
6547,October 9,2016,Togo,Mozambique,2,0,Friendly,in Togo,7,-7,1430,1322,2,-2,101,125,1423,1329,T1
6548,October 9,2016,Russia,Costa Rica,3,4,Friendly,in Russia,-10,10,1695,1820,-1,1,42,19,1705,1810,T2
6549,October 9,2016,Indonesia,Vietnam,2,2,Friendly,in Indonesia,-1,1,1216,1280,0,3,159,141,1217,1279,draw
6550,October 9,2016,Cambodia,Sri Lanka,4,0,Friendly,in Cambodia,12,-12,789,742,0,-1,210,214,777,754,T1
6551,October 9,2016,Zambia,Nigeria,1,2,World Cup qualifier,in Zambia,-15,15,1422,1644,-3,3,103,52,1437,1629,T2
6552,October 9,2016,Tunisia,Guinea,2,0,World Cup qualifier,in Tunisia,19,-19,1585,1520,4,-3,62,78,1566,1539,T1
6553,October 9,2016,Congo,Egypt,1,2,World Cup qualifier,in Congo,-16,16,1450,1654,-5,3,98,49,1466,1638,T2
6554,October 9,2016,Algeria,Cameroon,1,1,World Cup qualifier,in Algeria,-7,7,1656,1634,-1,3,48,53,1663,1627,draw
6555,October 9,2016,Wales,Georgia,1,1,World Cup qualifier,in Wales,-17,17,1768,1488,-4,4,27,85,1785,1471,draw
6556,October 9,2016,Ukraine,Kosovo,3,0,World Cup qualifier,in Poland,9,-9,1752,1397,1,-3,28,109,1743,1406,T1
6557,October 9,2016,Serbia,Austria,3,2,World Cup qualifier,in Serbia,15,-15,1727,1709,5,-3,34,39,1712,1724,T1
6558,October 9,2016,Moldova,Ireland,1,3,World Cup qualifier,in Moldova,-8,8,1329,1780,-3,1,122,24,1337,1772,T2
6559,October 9,2016,Macedonia,Italy,2,3,World Cup qualifier,in Macedonia,-3,3,1404,1942,-1,0,106,8,1407,1939,T2
6560,October 9,2016,Israel,Liechtenstein,2,1,World Cup qualifier,in Israel,2,-2,1579,1182,-1,-1,66,169,1577,1184,T1
6561,October 9,2016,Iceland,Turkey,2,0,World Cup qualifier,in Iceland,26,-26,1779,1782,2,-1,25,22,1753,1808,T1
6562,October 9,2016,Finland,Croatia,0,1,World Cup qualifier,in Finland,-10,10,1546,1858,-2,2,72,15,1556,1848,T2
6563,October 9,2016,Albania,Spain,0,2,World Cup qualifier,in Albania,-13,13,1630,1976,-4,0,55,5,1643,1963,T2
6564,October 10,2016,Philippines,North Korea,1,3,Friendly,in the Philippines,-9,9,1253,1513,-2,3,147,79,1262,1504,T2
6565,October 10,2016,Morocco,Jordan,2,1,Friendly,in Morocco,6,-6,1586,1513,3,0,62,79,1580,1519,T1
6566,October 10,2016,Bhutan,Bangladesh,3,1,Asian Cup qualifier,in Bhutan,45,-45,609,806,3,-2,228,208,564,851,T1
6567,October 10,2016,Sweden,Bulgaria,3,0,World Cup qualifier,in Sweden,13,-13,1756,1571,2,-2,28,66,1743,1584,T1
6568,October 10,2016,Netherlands,France,0,1,World Cup qualifier,in the Netherlands,-21,21,1889,2013,-2,0,14,4,1910,1992,T2
6569,October 10,2016,Latvia,Hungary,0,2,World Cup qualifier,in Latvia,-18,18,1417,1707,-4,4,104,40,1435,1689,T2
6570,October 10,2016,Faroe Islands,Portugal,0,6,World Cup qualifier,in the Faroe Islands,-4,4,1297,1929,-2,0,132,10,1301,1925,T2
6571,October 10,2016,Estonia,Greece,0,2,World Cup qualifier,in Estonia,-23,23,1436,1669,-5,5,99,46,1459,1646,T2
6572,October 10,2016,Bosnia and Herzegovina,Cyprus,2,0,World Cup qualifier,in Bosnia and Herzegovina,4,-4,1755,1401,0,-2,29,107,1751,1405,T1
6573,October 10,2016,Belgium,Gibraltar,6,0,World Cup qualifier,in Portugal,1,-1,1900,1102,1,0,12,181,1899,1103,T1
6574,October 10,2016,Belarus,Luxembourg,1,1,World Cup qualifier,in Belarus,-18,18,1589,1247,-1,4,59,148,1607,1229,draw
6575,October 10,2016,Andorra,Switzerland,1,2,World Cup qualifier,in Andorra,0,0,958,1856,0,0,190,16,958,1856,T2
6576,October 11,2016,United States,New Zealand,1,1,Friendly,in the United States,-8,8,1774,1549,-4,2,26,72,1782,1541,draw
6577,October 11,2016,South Africa,Ghana,1,1,Friendly,in South Africa,-2,2,1593,1611,-2,-1,60,58,1595,1609,draw
6578,October 11,2016,Oman,Bahrain,2,2,Friendly,in Oman,-4,4,1464,1442,-2,0,94,98,1468,1438,draw
6579,October 11,2016,Morocco,Canada,4,0,Friendly,in Morocco,11,-11,1597,1520,3,0,59,77,1586,1531,T1
6580,October 11,2016,Mexico,Panama,1,0,Friendly,in the United States,4,-4,1902,1662,1,-1,12,48,1898,1666,T1
6581,October 11,2016,Malaysia,Afghanistan,1,1,Friendly,in Malaysia,-2,2,1120,1145,-1,0,175,170,1122,1143,draw
6582,October 11,2016,Lebanon,Equatorial Guinea,1,1,Friendly,in Lebanon,-4,4,1371,1346,-1,0,116,118,1375,1342,draw
6583,October 11,2016,Kyrgyzstan,Turkmenistan,1,0,Friendly,in Kyrgyzstan,9,-9,1227,1275,6,-4,152,144,1218,1284,T1
6584,October 11,2016,Hong Kong,Singapore,2,0,Friendly,in Hong Kong,9,-9,1198,1124,2,0,165,173,1189,1133,T1
6585,October 11,2016,Taiwan,East Timor,2,1,Asian Cup qualifier,in Taiwan,9,-9,823,689,0,-2,207,220,814,698,T1
6586,October 11,2016,Laos,Maldives,1,1,Asian Cup qualifier,in Laos,5,-5,782,952,0,0,211,193,777,957,draw
6587,October 11,2016,Uzbekistan,China,2,0,World Cup qualifier,in Uzbekistan,13,-13,1672,1524,2,-1,46,76,1659,1537,T1
6588,October 11,2016,Saudi Arabia,United Arab Emirates,3,0,World Cup qualifier,in Saudi Arabia,27,-27,1592,1562,6,-8,61,67,1565,1589,T1
6589,October 11,2016,Qatar,Syria,1,0,World Cup qualifier,in Qatar,15,-15,1552,1528,4,-1,71,74,1537,1543,T1
6590,October 11,2016,Iraq,Thailand,4,0,World Cup qualifier,in Iran,31,-31,1483,1363,9,-5,87,117,1452,1394,T1
6591,October 11,2016,Iran,South Korea,1,0,World Cup qualifier,in Iran,16,-16,1785,1778,5,-4,21,25,1769,1794,T1
6592,October 11,2016,Australia,Japan,1,1,World Cup qualifier,in Australia,-5,5,1722,1742,-3,-1,37,33,1727,1737,draw
6593,October 11,2016,Slovenia,England,0,0,World Cup qualifier,in Slovenia,10,-10,1641,1922,1,-2,53,11,1631,1932,draw
6594,October 11,2016,Slovakia,Scotland,3,0,World Cup qualifier,in Slovakia,24,-24,1744,1679,6,-2,32,44,1720,1703,T1
6595,October 11,2016,Poland,Armenia,2,1,World Cup qualifier,in Poland,3,-3,1823,1480,1,-3,18,89,1820,1483,T1
6596,October 11,2016,Norway,San Marino,4,1,World Cup qualifier,in Norway,1,-1,1586,879,0,0,63,203,1585,880,T1
6597,October 11,2016,Lithuania,Malta,2,0,World Cup qualifier,in Lithuania,8,-8,1472,1222,2,-2,91,154,1464,1230,T1
6598,October 11,2016,Kazakhstan,Romania,0,0,World Cup qualifier,in Kazakhstan,12,-12,1413,1724,2,-2,105,35,1401,1736,draw
6599,October 11,2016,Germany,Northern Ireland,2,0,World Cup qualifier,in Germany,4,-4,2038,1648,-1,0,3,51,2034,1652,T1
6600,October 11,2016,Denmark,Montenegro,0,1,World Cup qualifier,in Denmark,-32,32,1708,1619,-8,4,39,57,1740,1587,T2
6601,October 11,2016,Czechia,Azerbaijan,0,0,World Cup qualifier,in Czechia,-16,16,1691,1436,-3,4,43,99,1707,1420,draw
6602,October 11,2016,Puerto Rico,Curaçao,2,4,CONCACAF Champ &amp; Carib Champ qual,in Puerto Rico,-26,26,1022,1221,0,10,186,155,1048,1195,T2
6603,October 11,2016,Martinique,Trinidad and Tobago,2,0,CONCACAF Champ &amp; Carib Champ qual,in Martinique,28,-28,1502,1528,5,-4,84,74,1474,1556,T1
6604,October 11,2016,Guyana,Jamaica,2,4,CONCACAF Champ &amp; Carib Champ qual,in Guyana,-15,15,1193,1512,-4,2,166,82,1208,1497,T2
6605,October 11,2016,Venezuela,Brazil,0,2,World Cup qualifier,in Venezuela,-12,12,1673,2040,0,1,45,2,1685,2028,T2
6606,October 11,2016,Colombia,Uruguay,2,2,World Cup qualifier,in Colombia,-8,8,1953,1923,-1,1,7,10,1961,1915,draw
6607,October 11,2016,Chile,Peru,2,1,World Cup qualifier,in Chile,9,-9,1958,1814,1,-2,6,20,1949,1823,T1
6608,October 11,2016,Bolivia,Ecuador,2,2,World Cup qualifier,in Bolivia,7,-7,1637,1847,1,0,54,17,1630,1854,draw
6609,October 11,2016,Argentina,Paraguay,0,1,World Cup qualifier,in Argentina,-37,37,2055,1763,0,8,1,28,2092,1726,T2
6610,October 15,2016,Cambodia,Laos,2,1,Southeast Asian Championship qualifier,in Cambodia,14,-14,803,768,1,0,209,211,789,782,T1
6611,October 15,2016,Brunei,East Timor,2,1,Southeast Asian Championship qualifier,in Cambodia,25,-25,628,664,2,-4,228,224,603,689,T1
6612,October 18,2016,Laos,East Timor,2,1,Southeast Asian Championship qualifier,in Cambodia,14,-14,782,650,0,0,211,224,768,664,T1
6613,October 18,2016,Cambodia,Brunei,3,0,Southeast Asian Championship qualifier,in Cambodia,12,-12,815,616,1,0,208,228,803,628,T1
6614,October 21,2016,Laos,Brunei,4,3,Southeast Asian Championship qualifier,in Cambodia,11,-11,793,605,0,-2,211,230,782,616,T1
6615,October 21,2016,Cambodia,East Timor,3,2,Southeast Asian Championship qualifier,in Cambodia,7,-7,822,643,0,0,208,224,815,650,T1
6616,November 2,2016,Brunei,East Timor,4,0,Asian Solidarity Cup,in Malaysia,42,-42,647,601,6,-6,224,230,605,643,T1
6617,November 2,2016,Honduras,Belize,5,0,Friendly,in Honduras,2,-2,1564,1181,0,-1,67,169,1562,1183,T1
6618,November 3,2016,Macao,Mongolia,2,1,Asian Solidarity Cup,in Malaysia,22,-22,651,647,4,-1,223,224,629,669,T1
6619,November 3,2016,Laos,Sri Lanka,2,1,Asian Solidarity Cup,in Malaysia,17,-17,810,725,2,-1,209,215,793,742,T1
6620,November 4,2016,Myanmar,Indonesia,0,0,Friendly,in Myanmar,2,-2,1065,1214,0,-1,185,161,1063,1216,draw
6621,November 5,2016,Zimbabwe,Zambia,1,0,Friendly,in Zimbabwe,8,-8,1403,1414,4,-1,107,104,1395,1422,T1
6622,November 5,2016,East Timor,Nepal,0,0,Asian Solidarity Cup,in Malaysia,14,-14,615,884,2,-1,228,202,601,898,draw
6623,November 6,2016,North Korea,Taiwan,2,0,East Asian Cup qualifier,in Hong Kong,1,-1,1514,822,0,0,79,207,1513,823,T1
6624,November 6,2016,Hong Kong,Guam,3,2,East Asian Cup qualifier,in Hong Kong,3,-3,1201,868,0,0,165,204,1198,871,T1
6625,November 6,2016,Mongolia,Sri Lanka,2,0,Asian Solidarity Cup,in Malaysia,37,-37,684,688,1,-5,223,220,647,725,T1
6626,November 6,2016,Macao,Laos,4,1,Asian Solidarity Cup,in Malaysia,50,-50,701,760,7,-3,216,212,651,810,T1
6627,November 6,2016,Jordan,Iraq,0,0,Friendly,in Jordan,-4,4,1509,1487,-4,0,83,87,1513,1483,draw
6628,November 7,2016,Tahiti,Solomon Islands,1,0,World Cup qualifier,in Tahiti,9,-9,1244,1112,2,-3,149,177,1235,1121,T1
6629,November 8,2016,Vietnam,Indonesia,3,2,Friendly,in Vietnam,6,-6,1286,1208,1,-1,139,162,1280,1214,T1
6630,November 8,2016,Nepal,Brunei,3,0,Asian Solidarity Cup,in Malaysia,14,-14,898,633,1,0,201,225,884,647,T1
6631,November 8,2016,Uganda,Zambia,0,1,Friendly,in Uganda,-15,15,1486,1429,-2,2,87,102,1501,1414,T2
6632,November 9,2016,North Korea,Guam,2,0,East Asian Cup qualifier,in Hong Kong,1,-1,1515,867,0,0,79,204,1514,868,T1
6633,November 9,2016,Hong Kong,Taiwan,4,2,East Asian Cup qualifier,in Hong Kong,4,-4,1205,818,1,-1,164,208,1201,822,T1
6634,November 9,2016,Macao,Sri Lanka,1,1,Asian Solidarity Cup,in Malaysia,-1,1,700,689,-1,0,217,220,701,688,draw
6635,November 9,2016,Laos,Mongolia,3,0,Asian Solidarity Cup,in Malaysia,27,-27,787,657,1,-1,211,224,760,684,T1
6636,November 9,2016,United Arab Emirates,Bahrain,2,0,Friendly,in the United Arab Emirates,7,-7,1569,1435,1,-2,67,100,1562,1442,T1
6637,November 9,2016,Tajikistan,Turkmenistan,3,0,Friendly,in Tajikistan,15,-15,1241,1260,2,0,151,144,1226,1275,T1
6638,November 9,2016,Syria,Singapore,2,0,Friendly,in Malaysia,3,-3,1531,1121,0,0,74,173,1528,1124,T1
6639,November 9,2016,Philippines,Kyrgyzstan,1,0,Friendly,in the Philippines,7,-7,1260,1220,3,-3,144,155,1253,1227,T1
6640,November 9,2016,Netherlands,Belgium,1,1,Friendly,in the Netherlands,-3,3,1886,1903,0,1,14,12,1889,1900,draw
6641,November 9,2016,Greece,Belarus,0,1,Friendly,in Greece,-15,15,1654,1604,-2,3,49,59,1669,1589,T2
6642,November 9,2016,Haiti,French Guiana,2,5,CONCACAF Champ &amp; Carib Champ qual,in Haiti,-60,60,1453,1354,-16,16,96,118,1513,1294,T2
6643,November 10,2016,Uzbekistan,Jordan,1,0,Friendly,in Uzbekistan,4,-4,1676,1505,0,0,46,82,1672,1509,T1
6644,November 10,2016,Qatar,Russia,2,1,Friendly,in Qatar,11,-11,1563,1684,2,-3,69,44,1552,1695,T1
6645,November 10,2016,Lebanon,Palestine,1,1,Friendly,in Lebanon,-4,4,1367,1336,0,2,116,120,1371,1332,draw
6646,November 10,2016,Iran,Papua New Guinea,8,1,Friendly,in Malaysia,1,-1,1786,1138,0,0,21,171,1785,1139,T1
6647,November 10,2016,Venezuela,Bolivia,5,0,World Cup qualifier,in Venezuela,25,-25,1698,1612,4,-3,41,57,1673,1637,T1
6648,November 10,2016,Uruguay,Ecuador,2,1,World Cup qualifier,in Uruguay,11,-11,1934,1836,1,-1,9,18,1923,1847,T1
6649,November 10,2016,Paraguay,Peru,1,4,World Cup qualifier,in Paraguay,-40,40,1723,1854,-7,3,35,17,1763,1814,T2
6650,November 10,2016,Colombia,Chile,0,0,World Cup qualifier,in Colombia,-5,5,1948,1963,0,0,7,6,1953,1958,draw
6651,November 10,2016,Brazil,Argentina,3,0,World Cup qualifier,in Brazil,27,-27,2067,2028,1,-2,1,3,2040,2055,T1
6652,November 11,2016,South Korea,Canada,2,0,Friendly,in South Korea,3,-3,1781,1517,2,0,23,77,1778,1520,T1
6653,November 11,2016,Japan,Oman,4,0,Friendly,in Japan,4,-4,1746,1460,0,0,32,93,1742,1464,T1
6654,November 11,2016,Comoros,Togo,2,2,Friendly,in Tunisia,9,-9,972,1421,0,-2,189,103,963,1430,draw
6655,November 11,2016,Tunisia,Libya,1,0,World Cup qualifier,in Algeria,14,-14,1599,1469,5,-4,59,91,1585,1483,T1
6656,November 11,2016,Slovakia,Lithuania,4,0,World Cup qualifier,in Slovakia,8,-8,1752,1464,2,-2,29,92,1744,1472,T1
6657,November 11,2016,San Marino,Germany,0,8,World Cup qualifier,in San Marino,0,0,879,2038,0,0,203,2,879,2038,T2
6658,November 11,2016,Romania,Poland,0,3,World Cup qualifier,in Romania,-35,35,1689,1858,-9,4,43,15,1724,1823,T2
6659,November 11,2016,Northern Ireland,Azerbaijan,4,0,World Cup qualifier,in Northern Ireland,11,-11,1659,1425,3,-3,48,101,1648,1436,T1
6660,November 11,2016,Malta,Slovenia,0,1,World Cup qualifier,in Malta,-5,5,1217,1646,-6,1,159,52,1222,1641,T2
6661,November 11,2016,France,Sweden,2,1,World Cup qualifier,in France,5,-5,2018,1751,0,-3,4,31,2013,1756,T1
6662,November 11,2016,England,Scotland,3,0,World Cup qualifier,in England,9,-9,1931,1670,1,-2,10,47,1922,1679,T1
6663,November 11,2016,Denmark,Kazakhstan,4,1,World Cup qualifier,in Denmark,7,-7,1715,1406,2,0,37,105,1708,1413,T1
6664,November 11,2016,Czechia,Norway,2,1,World Cup qualifier,in Czechia,9,-9,1700,1577,3,-2,40,65,1691,1586,T1
6665,November 11,2016,Armenia,Montenegro,3,2,World Cup qualifier,in Armenia,22,-22,1502,1597,5,-4,83,60,1480,1619,T1
6666,November 11,2016,United States,Mexico,1,2,World Cup qualifier,in the United States,-18,18,1756,1920,-1,1,27,12,1774,1902,T2
6667,November 11,2016,Trinidad and Tobago,Costa Rica,0,2,World Cup qualifier,in Trinidad and Tobago,-15,15,1513,1835,-4,0,79,20,1528,1820,T2
6668,November 11,2016,Honduras,Panama,0,1,World Cup qualifier,in Honduras,-20,20,1544,1682,-5,2,73,45,1564,1662,T2
6669,November 12,2016,Taiwan,Guam,2,0,East Asian Cup qualifier,in Hong Kong,34,-34,852,833,3,-3,205,207,818,867,T1
6670,November 12,2016,Hong Kong,North Korea,0,1,East Asian Cup qualifier,in Hong Kong,-9,9,1196,1524,-1,3,165,75,1205,1515,T2
6671,November 12,2016,Laos,Nepal,2,2,Asian Solidarity Cup,in Malaysia,6,-6,793,892,0,0,211,201,787,898,draw
6672,November 12,2016,Brunei,Macao,1,1,Asian Solidarity Cup,in Malaysia,4,-4,637,696,0,0,225,217,633,700,draw
6673,November 12,2016,Kenya,Mozambique,1,0,Friendly,in Kenya,6,-6,1383,1316,1,0,112,126,1377,1322,T1
6674,November 12,2016,New Zealand,New Caledonia,2,0,World Cup qualifier,in New Zealand,8,-8,1557,1316,2,-1,69,126,1549,1324,T1
6675,November 12,2016,Uganda,Congo,1,0,World Cup qualifier,in Uganda,13,-13,1499,1437,1,0,86,97,1486,1450,T1
6676,November 12,2016,South Africa,Senegal,2,1,World Cup qualifier,in South Africa,20,-20,1613,1675,6,-4,56,46,1593,1695,T1
6677,November 12,2016,Nigeria,Algeria,3,1,World Cup qualifier,in Nigeria,23,-23,1667,1633,5,-4,48,53,1644,1656,T1
6678,November 12,2016,Morocco,Ivory Coast,0,0,World Cup qualifier,in Morocco,1,-1,1598,1722,-1,-1,61,35,1597,1723,draw
6679,November 12,2016,Mali,Gabon,0,0,World Cup qualifier,in Mali,-11,11,1551,1465,-2,4,71,91,1562,1454,draw
6680,November 12,2016,Cape Verde,Burkina Faso,0,2,World Cup qualifier,in Cape Verde,-38,38,1432,1508,-11,7,100,82,1470,1470,T2
6681,November 12,2016,Cameroon,Zambia,1,1,World Cup qualifier,in Cameroon,-14,14,1620,1443,-1,4,55,96,1634,1429,draw
6682,November 12,2016,Wales,Serbia,1,1,World Cup qualifier,in Wales,-8,8,1760,1735,0,0,26,33,1768,1727,draw
6683,November 12,2016,Ukraine,Finland,1,0,World Cup qualifier,in Ukraine,6,-6,1758,1540,2,-1,27,73,1752,1546,T1
6684,November 12,2016,Turkey,Kosovo,2,0,World Cup qualifier,in Turkey,3,-3,1785,1394,-1,-1,23,111,1782,1397,T1
6685,November 12,2016,Spain,Macedonia,4,0,World Cup qualifier,in Spain,2,-2,1978,1402,0,-1,5,107,1976,1404,T1
6686,November 12,2016,Liechtenstein,Italy,0,4,World Cup qualifier,in Liechtenstein,-2,2,1180,1944,-1,0,169,8,1182,1942,T2
6687,November 12,2016,Georgia,Moldova,1,1,World Cup qualifier,in Georgia,-13,13,1475,1342,-3,3,88,120,1488,1329,draw
6688,November 12,2016,Croatia,Iceland,2,0,World Cup qualifier,in Croatia,16,-16,1874,1763,0,0,15,25,1858,1779,T1
6689,November 12,2016,Austria,Ireland,0,1,World Cup qualifier,in Austria,-22,22,1687,1802,-4,3,42,21,1709,1780,T2
6690,November 12,2016,Albania,Israel,0,3,World Cup qualifier,in Albania,-49,49,1581,1628,-9,10,64,54,1630,1579,T2
6691,November 13,2016,Solomon Islands,Tahiti,1,0,World Cup qualifier,in the Solomon Islands,22,-22,1134,1222,4,-3,173,152,1112,1244,T1
6692,November 13,2016,Zimbabwe,Tanzania,3,0,Friendly,in Zimbabwe,9,-9,1412,1318,1,-1,105,125,1403,1327,T1
6693,November 13,2016,Tajikistan,Afghanistan,1,0,Friendly,in Tajikistan,5,-5,1246,1140,3,0,148,170,1241,1145,T1
6694,November 13,2016,Singapore,Cambodia,1,0,Friendly,in Singapore,2,-2,1123,820,-1,0,174,208,1121,822,T1
6695,November 13,2016,Guinea,Democratic Republic of Congo,1,2,World Cup qualifier,in Guinea,-24,24,1496,1578,-9,4,86,66,1520,1554,T2
6696,November 13,2016,Egypt,Ghana,2,0,World Cup qualifier,in Egypt,18,-18,1672,1593,3,-3,47,61,1654,1611,T1
6697,November 13,2016,Switzerland,Faroe Islands,2,0,World Cup qualifier,in Switzerland,1,-1,1857,1296,0,0,17,133,1856,1297,T1
6698,November 13,2016,Portugal,Latvia,4,1,World Cup qualifier,in Portugal,2,-2,1931,1415,1,0,10,104,1929,1417,T1
6699,November 13,2016,Hungary,Andorra,4,0,World Cup qualifier,in Hungary,1,-1,1708,957,0,-2,38,192,1707,958,T1
6700,November 13,2016,Luxembourg,Netherlands,1,3,World Cup qualifier,in Luxembourg,-3,3,1244,1889,-1,0,149,14,1247,1886,T2
6701,November 13,2016,Greece,Bosnia and Herzegovina,1,1,World Cup qualifier,in Greece,0,0,1654,1755,-1,0,51,29,1654,1755,draw
6702,November 13,2016,Cyprus,Gibraltar,3,1,World Cup qualifier,in Cyprus,5,-5,1406,1097,3,-2,106,183,1401,1102,T1
6703,November 13,2016,Bulgaria,Belarus,1,0,World Cup qualifier,in Bulgaria,16,-16,1587,1588,2,-4,64,63,1571,1604,T1
6704,November 13,2016,Belgium,Estonia,8,1,World Cup qualifier,in Belgium,3,-3,1906,1433,0,-1,13,99,1903,1436,T1
6705,November 13,2016,Saint Kitts and Nevis,Haiti,0,2,CONCACAF Champ &amp; Carib Champ qual,in Saint Kitts and Nevis,-24,24,1264,1477,-5,7,143,88,1288,1453,T2
6706,November 13,2016,Jamaica,Suriname,1,0,CONCACAF Champ &amp; Carib Champ qual,in Jamaica,4,-4,1516,1215,2,-4,78,160,1512,1219,T1
6707,November 14,2016,Myanmar,Oman,0,3,Friendly,in Myanmar,-5,5,1060,1465,0,2,185,92,1065,1460,T2
6708,November 14,2016,Malaysia,Papua New Guinea,2,1,Friendly,in Malaysia,8,-8,1128,1130,1,-2,174,173,1120,1138,T1
6709,November 14,2016,Laos,Brunei,3,2,Asian Solidarity Cup,in Malaysia,12,-12,805,625,1,-2,210,227,793,637,T1
6710,November 14,2016,Poland,Slovenia,1,1,Friendly,in Poland,-7,7,1851,1653,-2,0,18,52,1858,1646,draw
6711,November 15,2016,Tunisia,Mauritania,0,0,Friendly,in Tunisia,-8,8,1591,1306,-3,1,61,131,1599,1298,draw
6712,November 15,2016,Mozambique,South Africa,1,1,Friendly,in Mozambique,5,-5,1321,1608,1,-1,125,57,1316,1613,draw
6713,November 15,2016,Kenya,Liberia,1,0,Friendly,in Kenya,6,-6,1389,1316,0,-3,112,127,1383,1322,T1
6714,November 15,2016,Jordan,Lebanon,0,0,Friendly,in Jordan,-6,6,1499,1373,-1,0,83,116,1505,1367,draw
6715,November 15,2016,Comoros,Gabon,1,1,Friendly,in Tunisia,9,-9,981,1456,0,-2,189,94,972,1465,draw
6716,November 15,2016,Bahrain,Kyrgyzstan,0,0,Friendly,in Bahrain,-7,7,1428,1227,-2,2,100,152,1435,1220,draw
6717,November 15,2016,Nepal,Macao,1,0,Asian Solidarity Cup,in Malaysia,10,-10,902,686,0,-4,201,221,892,696,T1
6718,November 15,2016,New Caledonia,New Zealand,0,0,World Cup qualifier,in New Caledonia,8,-8,1324,1549,2,-2,124,72,1316,1557,draw
6719,November 15,2016,United Arab Emirates,Iraq,2,0,World Cup qualifier,in the United Arab Emirates,16,-16,1585,1471,4,-3,64,90,1569,1487,T1
6720,November 15,2016,Thailand,Australia,2,2,World Cup qualifier,in Thailand,13,-13,1376,1709,3,-1,114,36,1363,1722,draw
6721,November 15,2016,Syria,Iran,0,0,World Cup qualifier,in Malaysia,13,-13,1544,1773,1,-2,73,24,1531,1786,draw
6722,November 15,2016,South Korea,Uzbekistan,2,1,World Cup qualifier,in South Korea,9,-9,1790,1667,2,-3,22,48,1781,1676,T1
6723,November 15,2016,Japan,Saudi Arabia,2,1,World Cup qualifier,in Japan,8,-8,1754,1584,2,-3,30,65,1746,1592,T1
6724,November 15,2016,China,Qatar,0,0,World Cup qualifier,in China,-3,3,1521,1566,-1,0,76,69,1524,1563,draw
6725,November 15,2016,Ukraine,Serbia,2,0,Friendly,in Ukraine,10,-10,1768,1725,2,-1,25,34,1758,1735,T1
6726,November 15,2016,Russia,Romania,1,0,Friendly,in Russia,7,-7,1691,1682,4,-3,39,44,1684,1689,T1
6727,November 15,2016,Northern Ireland,Croatia,0,3,Friendly,in Northern Ireland,-12,12,1647,1886,-2,0,52,15,1659,1874,T2
6728,November 15,2016,Morocco,Togo,2,1,Friendly,in Morocco,3,-3,1601,1418,1,0,58,103,1598,1421,T1
6729,November 15,2016,Malta,Iceland,0,2,Friendly,in Malta,-2,2,1215,1765,-1,-2,159,27,1217,1763,T2
6730,November 15,2016,Italy,Germany,0,0,Friendly,in Italy,0,0,1944,2038,1,-1,7,3,1944,2038,draw
6731,November 15,2016,Hungary,Sweden,0,2,Friendly,in Hungary,-17,17,1691,1768,-1,6,39,25,1708,1751,T2
6732,November 15,2016,France,Ivory Coast,0,0,Friendly,in France,-8,8,2010,1730,0,2,4,33,2018,1722,draw
6733,November 15,2016,England,Spain,2,2,Friendly,in England,-2,2,1929,1980,0,-1,10,6,1931,1978,draw
6734,November 15,2016,Czechia,Denmark,1,1,Friendly,in Czechia,-2,2,1698,1717,1,2,38,35,1700,1715,draw
6735,November 15,2016,Austria,Slovakia,0,0,Friendly,in Austria,-1,1,1686,1753,0,-1,42,31,1687,1752,draw
6736,November 15,2016,Panama,Mexico,0,0,World Cup qualifier,in Panama,8,-8,1690,1912,3,0,41,12,1682,1920,draw
6737,November 15,2016,Honduras,Trinidad and Tobago,3,1,World Cup qualifier,in Honduras,19,-19,1563,1494,2,-7,70,86,1544,1513,T1
6738,November 15,2016,Costa Rica,United States,4,0,World Cup qualifier,in Costa Rica,20,-20,1855,1736,3,-4,17,32,1835,1756,T1
6739,November 15,2016,Peru,Brazil,0,2,World Cup qualifier,in Peru,-21,21,1833,2088,-3,0,20,1,1854,2067,T2
6740,November 15,2016,Ecuador,Venezuela,3,0,World Cup qualifier,in Ecuador,14,-14,1850,1684,0,-3,19,43,1836,1698,T1
6741,November 15,2016,Chile,Uruguay,3,1,World Cup qualifier,in Chile,19,-19,1982,1915,1,-2,5,11,1963,1934,T1
6742,November 15,2016,Bolivia,Paraguay,1,0,World Cup qualifier,in Bolivia,21,-21,1633,1702,4,-3,53,37,1612,1723,T1
6743,November 15,2016,Argentina,Colombia,3,0,World Cup qualifier,in Argentina,18,-18,2046,1930,1,-2,2,9,2028,1948,T1
6744,November 19,2016,Thailand,Indonesia,4,2,Southeast Asian Championship,in the Philippines,17,-17,1393,1191,2,-4,112,166,1376,1208,T1
6745,November 19,2016,Philippines,Singapore,0,0,Southeast Asian Championship,in the Philippines,-12,12,1248,1135,-3,3,147,172,1260,1123,draw
6746,November 19,2016,Saint Kitts and Nevis,Estonia,1,1,Friendly,in Saint Kitts and Nevis,2,-2,1266,1431,0,-1,143,99,1264,1433,draw
6747,November 20,2016,Myanmar,Vietnam,1,2,Southeast Asian Championship,in Myanmar,-13,13,1047,1299,0,5,185,133,1060,1286,T2
6748,November 20,2016,Malaysia,Cambodia,3,2,Southeast Asian Championship,in Myanmar,6,-6,1134,814,2,0,173,208,1128,820,T1
6749,November 22,2016,Thailand,Singapore,1,0,Southeast Asian Championship,in the Philippines,7,-7,1400,1128,2,-3,110,175,1393,1135,T1
6750,November 22,2016,Philippines,Indonesia,2,2,Southeast Asian Championship,in the Philippines,-8,8,1240,1199,-3,2,150,164,1248,1191,draw
6751,November 22,2016,Antigua and Barbuda,Estonia,0,1,Friendly,in Antigua and Barbuda,-7,7,1205,1438,-1,2,162,97,1212,1431,T2
6752,November 23,2016,Vietnam,Malaysia,1,0,Southeast Asian Championship,in Myanmar,11,-11,1310,1123,4,-3,129,175,1299,1134,T1
6753,November 23,2016,Myanmar,Cambodia,3,1,Southeast Asian Championship,in Myanmar,8,-8,1055,806,0,0,185,208,1047,814,T1
6754,November 25,2016,Philippines,Thailand,0,1,Southeast Asian Championship,in the Philippines,-17,17,1223,1417,-2,6,152,104,1240,1400,T2
6755,November 25,2016,Indonesia,Singapore,2,1,Southeast Asian Championship,in the Philippines,16,-16,1215,1112,5,-3,159,177,1199,1128,T1
6756,November 26,2016,Vietnam,Cambodia,2,1,Southeast Asian Championship,in Myanmar,2,-2,1312,804,1,-2,128,210,1310,806,T1
6757,November 26,2016,Myanmar,Malaysia,1,0,Southeast Asian Championship,in Myanmar,18,-18,1073,1105,0,-5,185,179,1055,1123,T1
6758,December 3,2016,Indonesia,Vietnam,2,1,Southeast Asian Championship,in Indonesia,20,-20,1235,1292,8,-9,151,137,1215,1312,T1
6759,December 4,2016,Myanmar,Thailand,0,2,Southeast Asian Championship,in Myanmar,-12,12,1061,1429,0,4,185,100,1073,1417,T2
6760,December 7,2016,Vietnam,Indonesia,2,2,Southeast Asian Championship,in Vietnam,-8,8,1284,1243,-2,1,139,150,1292,1235,draw
6761,December 8,2016,Thailand,Myanmar,4,0,Southeast Asian Championship,in Thailand,5,-5,1434,1056,1,0,99,185,1429,1061,T1
6762,December 14,2016,Indonesia,Thailand,2,1,Southeast Asian Championship,in Indonesia,25,-25,1268,1409,7,-7,143,106,1243,1434,T1
6763,December 17,2016,Thailand,Indonesia,2,0,Southeast Asian Championship,in Thailand,12,-12,1421,1256,3,-3,103,146,1409,1268,T1
6764,December 26,2016,Ivory Coast,Zimbabwe,0,0,Friendly,in Ivory Coast,-8,8,1722,1420,-1,2,34,104,1730,1412,draw
6765,December 27,2016,Nicaragua,Trinidad and Tobago,2,1,Friendly,in Nicaragua,14,-14,1272,1480,2,0,143,86,1258,1494,T1
6766,January 4,2017,Tunisia,Uganda,2,0,Friendly,in Tunisia,7,-7,1598,1492,2,-2,59,85,1591,1499,T1
6767,January 4,2017,Trinidad and Tobago,Suriname,1,2,CONCACAF Champ &amp; Carib Champ qual,in Trinidad and Tobago,-36,36,1454,1251,-9,12,95,148,1490,1215,T2
6768,January 5,2017,Cameroon,Democratic Republic of Congo,2,0,Friendly,in Cameroon,9,-9,1629,1569,1,-1,55,68,1620,1578,T1
6769,January 6,2017,Haiti,Suriname,4,2,CONCACAF Champ &amp; Carib Champ qual,in Trinidad and Tobago,13,-13,1490,1238,0,-4,86,152,1477,1251,T1
6770,January 7,2017,Burkina Faso,Mali,2,1,Friendly,in Morocco,11,-11,1519,1540,3,-2,77,73,1508,1551,T1
6771,January 7,2017,Algeria,Mauritania,3,1,Friendly,in Algeria,2,-2,1635,1304,0,0,53,131,1633,1306,T1
6772,January 8,2017,Senegal,Libya,2,1,Friendly,in Congo,5,-5,1680,1464,0,-1,45,91,1675,1469,T1
6773,January 8,2017,Ivory Coast,Sweden,2,1,Friendly,in the United Arab Emirates,11,-11,1733,1757,1,-3,33,28,1722,1768,T1
6774,January 8,2017,Egypt,Tunisia,1,0,Friendly,in Egypt,5,-5,1677,1593,0,-1,46,60,1672,1598,T1
6775,January 8,2017,Trinidad and Tobago,Haiti,3,4,CONCACAF Champ &amp; Carib Champ qual,in Trinidad and Tobago,-24,24,1430,1514,-4,6,99,80,1454,1490,T2
6776,January 9,2017,Finland,Morocco,1,0,Friendly,in the United Arab Emirates,12,-12,1552,1589,2,-3,71,61,1540,1601,T1
6777,January 10,2017,Cameroon,Zimbabwe,1,1,Friendly,in Cameroon,-7,7,1622,1427,-1,3,56,101,1629,1420,draw
6778,January 10,2017,Algeria,Mauritania,6,0,Friendly,in Algeria,3,-3,1638,1301,0,0,53,131,1635,1304,T1
6779,January 10,2017,China,Iceland,0,2,Friendly tournament,in China,-14,14,1507,1779,-5,2,81,24,1521,1765,T2
6780,January 11,2017,Chile,Croatia,1,1,Friendly tournament,in China,-4,4,1978,1890,-1,1,6,14,1982,1886,draw
6781,January 11,2017,Ivory Coast,Uganda,3,0,Friendly,in the United Arab Emirates,7,-7,1740,1485,1,0,32,86,1733,1492,T1
6782,January 11,2017,Congo,Senegal,0,2,Friendly,in Congo,-9,9,1428,1689,-2,3,99,42,1437,1680,T2
6783,January 13,2017,Panama,Belize,0,0,CONCACAF Champ q &amp; Central Am Cup,in Panama,-19,19,1671,1200,-5,3,46,165,1690,1181,draw
6784,January 13,2017,Honduras,Nicaragua,2,1,CONCACAF Champ q &amp; Central Am Cup,in Panama,6,-6,1569,1256,2,-1,68,145,1563,1262,T1
6785,January 13,2017,Costa Rica,El Salvador,0,0,CONCACAF Champ q &amp; Central Am Cup,in Panama,-17,17,1838,1419,-2,4,19,105,1855,1402,draw
6786,January 14,2017,China,Croatia,1,1,Friendly tournament,in China,10,-10,1517,1880,4,-1,77,15,1507,1890,draw
6787,January 14,2017,Saudi Arabia,Cambodia,7,2,Friendly,in the United Arab Emirates,0,0,1584,804,0,0,65,210,1584,804,T1
6788,January 14,2017,Gabon,Guinea-Bissau,1,1,African Nations Cup,in Gabon,-17,17,1439,1297,-2,7,95,133,1456,1280,draw
6789,January 14,2017,Burkina Faso,Cameroon,1,1,African Nations Cup,in Gabon,7,-7,1526,1615,1,0,75,56,1519,1622,draw
6790,January 15,2017,Chile,Iceland,1,0,Friendly tournament,in China,7,-7,1985,1772,1,-1,5,25,1978,1779,T1
6791,January 15,2017,Senegal,Tunisia,2,0,African Nations Cup,in Gabon,27,-27,1716,1566,5,-10,36,69,1689,1593,T1
6792,January 15,2017,Algeria,Zimbabwe,2,2,African Nations Cup,in Gabon,-14,14,1624,1441,-2,6,55,95,1638,1427,draw
6793,January 15,2017,Panama,Nicaragua,2,1,CONCACAF Champ q &amp; Central Am Cup,in Panama,2,-2,1673,1254,0,-2,46,147,1671,1256,T1
6794,January 15,2017,Honduras,El Salvador,2,1,CONCACAF Champ q &amp; Central Am Cup,in Panama,12,-12,1581,1407,3,-2,65,107,1569,1419,T1
6795,January 15,2017,Costa Rica,Belize,3,0,CONCACAF Champ q &amp; Central Am Cup,in Panama,2,-2,1840,1198,0,0,19,165,1838,1200,T1
6796,January 16,2017,Ivory Coast,Togo,0,0,African Nations Cup,in Gabon,-18,18,1722,1436,-2,7,34,98,1740,1418,draw
6797,January 16,2017,Democratic Republic of Congo,Morocco,1,0,African Nations Cup,in Gabon,26,-26,1595,1563,9,-10,59,70,1569,1589,T1
6798,January 17,2017,Qatar,Moldova,1,1,Friendly,in Qatar,-7,7,1559,1349,-2,1,70,119,1566,1342,draw
6799,January 17,2017,Ghana,Uganda,1,0,African Nations Cup,in Gabon,17,-17,1610,1468,2,-3,58,89,1593,1485,T1
6800,January 17,2017,Egypt,Mali,0,0,African Nations Cup,in Gabon,-9,9,1668,1549,-1,2,46,72,1677,1540,draw
6801,January 17,2017,Panama,Honduras,0,1,CONCACAF Champ q &amp; Central Am Cup,in Panama,-30,30,1643,1611,-6,8,52,57,1673,1581,T2
6802,January 17,2017,El Salvador,Belize,3,1,CONCACAF Champ q &amp; Central Am Cup,in Panama,14,-14,1421,1184,2,-3,105,168,1407,1198,T1
6803,January 17,2017,Costa Rica,Nicaragua,0,0,CONCACAF Champ q &amp; Central Am Cup,in Panama,-19,19,1821,1273,-1,4,20,143,1840,1254,draw
6804,January 18,2017,Gabon,Burkina Faso,1,1,African Nations Cup,in Gabon,-1,1,1438,1527,0,0,96,75,1439,1526,draw
6805,January 18,2017,Cameroon,Guinea-Bissau,2,1,African Nations Cup,in Gabon,7,-7,1622,1290,0,-4,56,137,1615,1297,T1
6806,January 19,2017,Tunisia,Algeria,2,1,African Nations Cup,in Gabon,29,-29,1595,1595,8,-5,60,60,1566,1624,T1
6807,January 19,2017,Senegal,Zimbabwe,2,0,African Nations Cup,in Gabon,13,-13,1729,1428,3,-5,33,100,1716,1441,T1
6808,January 20,2017,Morocco,Togo,3,1,African Nations Cup,in Gabon,24,-24,1587,1412,5,-10,64,107,1563,1436,T1
6809,January 20,2017,Democratic Republic of Congo,Ivory Coast,2,2,African Nations Cup,in Gabon,9,-9,1604,1713,1,-1,59,36,1595,1722,draw
6810,January 20,2017,Panama,El Salvador,1,0,CONCACAF Champ q &amp; Central Am Cup,in Panama,5,-5,1648,1416,1,0,51,105,1643,1421,T1
6811,January 20,2017,Nicaragua,Belize,3,1,CONCACAF Champ q &amp; Central Am Cup,in Panama,22,-22,1295,1162,9,-1,134,169,1273,1184,T1
6812,January 20,2017,Costa Rica,Honduras,1,1,CONCACAF Champ q &amp; Central Am Cup,in Panama,-11,11,1810,1622,0,1,20,55,1821,1611,draw
6813,January 21,2017,Ghana,Mali,1,0,African Nations Cup,in Gabon,21,-21,1631,1528,3,-2,54,74,1610,1549,T1
6814,January 21,2017,Egypt,Uganda,1,0,African Nations Cup,in Gabon,12,-12,1680,1456,1,-3,45,92,1668,1468,T1
6815,January 22,2017,Gabon,Cameroon,0,0,African Nations Cup,in Gabon,6,-6,1444,1616,1,-1,94,57,1438,1622,draw
6816,January 22,2017,Burkina Faso,Guinea-Bissau,2,0,African Nations Cup,in Gabon,15,-15,1542,1275,1,-5,74,143,1527,1290,T1
6817,January 22,2017,Bermuda,Canada,2,4,Friendly,in Bermuda,-7,7,1199,1524,-2,1,164,76,1206,1517,T2
6818,January 22,2017,Panama,Costa Rica,1,0,CONCACAF Champ q &amp; Central Am Cup,in Panama,24,-24,1672,1786,5,-2,46,22,1648,1810,T1
6819,January 22,2017,Honduras,Belize,1,0,CONCACAF Champ q &amp; Central Am Cup,in Panama,3,-3,1625,1159,0,0,56,169,1622,1162,T1
6820,January 22,2017,El Salvador,Nicaragua,1,0,CONCACAF Champ q &amp; Central Am Cup,in Panama,13,-13,1429,1282,6,-6,99,140,1416,1295,T1
6821,January 23,2017,Tunisia,Zimbabwe,4,2,African Nations Cup,in Gabon,21,-21,1616,1407,4,-7,57,107,1595,1428,T1
6822,January 23,2017,Algeria,Senegal,2,2,African Nations Cup,in Gabon,9,-9,1604,1720,1,-1,60,34,1595,1729,draw
6823,January 23,2017,Georgia,Uzbekistan,2,2,Friendly,in the United Arab Emirates,5,-5,1480,1662,0,-1,86,49,1475,1667,draw
6824,January 24,2017,Morocco,Ivory Coast,1,0,African Nations Cup,in Gabon,34,-34,1621,1679,6,-9,58,45,1587,1713,T1
6825,January 24,2017,Democratic Republic of Congo,Togo,3,1,African Nations Cup,in Gabon,19,-19,1623,1393,3,-6,57,112,1604,1412,T1
6826,January 25,2017,Mali,Uganda,1,1,African Nations Cup,in Gabon,-5,5,1523,1461,-2,0,77,92,1528,1456,draw
6827,January 25,2017,Egypt,Ghana,1,0,African Nations Cup,in Gabon,21,-21,1701,1610,6,-6,38,60,1680,1631,T1
6828,January 25,2017,Jordan,Georgia,1,0,Friendly,in the United Arab Emirates,9,-9,1508,1471,2,-1,82,87,1499,1480,T1
6829,January 25,2017,Brazil,Colombia,1,0,Friendly,in Brazil,4,-4,2092,1926,0,-1,1,10,2088,1930,T1
6830,January 28,2017,Cameroon,Senegal,0,0,African Nations Cup,in Gabon,7,-7,1623,1713,2,-1,56,35,1616,1720,draw
6831,January 28,2017,Burkina Faso,Tunisia,2,0,African Nations Cup,in Gabon,45,-45,1587,1571,10,-12,64,70,1542,1616,T1
6832,January 29,2017,Ghana,Democratic Republic of Congo,2,1,African Nations Cup,in Gabon,26,-26,1636,1597,6,-5,53,61,1610,1623,T1
6833,January 29,2017,Egypt,Morocco,1,0,African Nations Cup,in Gabon,19,-19,1720,1602,4,-2,34,60,1701,1621,T1
6834,January 29,2017,United States,Serbia,0,0,Friendly,in the United States,-3,3,1733,1728,0,0,32,33,1736,1725,draw
6835,February 1,2017,Burkina Faso,Egypt,1,1,African Nations Cup,in Gabon,9,-9,1596,1711,1,-2,63,36,1587,1720,draw
6836,February 2,2017,Cameroon,Ghana,2,0,African Nations Cup,in Gabon,39,-39,1662,1597,8,-7,49,60,1623,1636,T1
6837,February 3,2017,United States,Jamaica,1,0,Friendly,in the United States,3,-3,1736,1513,0,-1,32,80,1733,1516,T1
6838,February 4,2017,Burkina Faso,Ghana,1,0,African Nations Cup,in Gabon,25,-25,1621,1572,6,-9,57,69,1596,1597,T1
6839,February 5,2017,Cameroon,Egypt,2,1,African Nations Cup,in Gabon,29,-29,1691,1682,10,-8,39,44,1662,1711,T1
6840,February 8,2017,Mexico,Iceland,1,0,Friendly,in the United States,6,-6,1918,1766,1,-1,11,26,1912,1772,T1
6841,February 16,2017,Jamaica,Honduras,1,0,Friendly,in the United States,13,-13,1526,1612,5,-1,75,57,1513,1625,T1
6842,February 22,2017,San Marino,Andorra,0,2,Friendly,in San Marino,-16,16,863,973,0,2,203,190,879,957,T2
6843,February 22,2017,Ecuador,Honduras,3,1,Friendly,in Ecuador,4,-4,1854,1608,1,0,17,57,1850,1612,T1
6844,March 9,2017,Qatar,Azerbaijan,1,2,Friendly,in Qatar,-16,16,1543,1441,-3,6,74,96,1559,1425,T2
6845,March 10,2017,Trinidad and Tobago,Barbados,2,0,Friendly,in Trinidad and Tobago,3,-3,1433,1133,1,-1,98,172,1430,1136,T1
6846,March 11,2017,Burundi,Djibouti,7,0,Friendly,in Burundi,1,-1,1312,751,0,0,128,213,1311,752,T1
6847,March 13,2017,Burundi,Djibouti,1,0,Friendly,in Burundi,0,0,1312,751,0,0,128,213,1312,751,T1
6848,March 16,2017,Honduras,Nicaragua,2,0,Friendly,in Honduras,2,-2,1610,1280,0,0,57,140,1608,1282,T1
6849,March 18,2017,Iran,Iraq,0,1,Friendly,in Iran,-18,18,1755,1489,-4,1,28,86,1773,1471,T2
6850,March 19,2017,San Marino,Moldova,0,2,Friendly,in San Marino,-3,3,860,1352,0,0,203,119,863,1349,T2
6851,March 21,2017,Indonesia,Myanmar,1,3,Friendly,in Indonesia,-25,25,1231,1081,-6,1,152,184,1256,1056,T2
6852,March 22,2017,Vietnam,Taiwan,1,1,Friendly,in Vietnam,-9,9,1275,861,-3,2,142,203,1284,852,draw
6853,March 22,2017,Philippines,Malaysia,0,0,Friendly,in the Philippines,-6,6,1217,1111,-5,3,159,176,1223,1105,draw
6854,March 22,2017,Palestine,Yemen,1,0,Friendly,in Qatar,6,-6,1342,1199,0,-1,121,163,1336,1205,T1
6855,March 22,2017,Cambodia,India,2,3,Friendly,in Cambodia,-5,5,799,1106,-1,4,211,177,804,1101,T2
6856,March 22,2017,São Tomé and Príncipe,Madagascar,0,1,African Nations Cup qualifier,in São Tomé and Príncipe,-18,18,1089,1262,-5,3,182,145,1107,1244,T2
6857,March 22,2017,Djibouti,South Sudan,2,0,African Nations Cup qualifier,in Djibouti,49,-49,800,1065,3,-10,210,185,751,1114,T1
6858,March 22,2017,Scotland,Canada,1,1,Friendly,in Scotland,-6,6,1664,1530,-1,1,49,75,1670,1524,draw
6859,March 22,2017,Germany,England,1,0,Friendly,in Germany,5,-5,2043,1924,0,-1,3,10,2038,1929,T1
6860,March 22,2017,Czechia,Lithuania,3,0,Friendly,in Czechia,4,-4,1702,1460,1,-2,37,92,1698,1464,T1
6861,March 22,2017,Cyprus,Kazakhstan,3,1,Friendly,in Cyprus,11,-11,1417,1395,2,-3,105,110,1406,1406,T1
6862,March 22,2017,Curaçao,El Salvador,1,1,Friendly,in Curaçao,3,-3,1224,1426,2,-2,154,102,1221,1429,draw
6863,March 23,2017,Papua New Guinea,Tahiti,1,3,World Cup qualifier,in Papua New Guinea,-31,31,1099,1253,-6,7,179,148,1130,1222,T2
6864,March 23,2017,Nigeria,Senegal,1,1,Friendly,in England,1,-1,1668,1712,0,-1,48,36,1667,1713,draw
6865,March 23,2017,Kenya,Uganda,1,1,Friendly,in Kenya,-1,1,1388,1462,0,0,113,91,1389,1461,draw
6866,March 23,2017,Jordan,Hong Kong,4,0,Friendly,in Jordan,3,-3,1511,1193,1,0,81,165,1508,1196,T1
6867,March 23,2017,Bahrain,Tajikistan,1,1,Friendly,in Bahrain,-7,7,1421,1253,-3,0,103,148,1428,1246,draw
6868,March 23,2017,Afghanistan,Singapore,2,1,Friendly,in Qatar,9,-9,1149,1103,0,-3,170,178,1140,1112,T1
6869,March 23,2017,United Arab Emirates,Japan,0,2,World Cup qualifier,in the United Arab Emirates,-24,24,1561,1778,-6,7,71,23,1585,1754,T2
6870,March 23,2017,Thailand,Saudi Arabia,0,3,World Cup qualifier,in Thailand,-29,29,1392,1613,-8,9,112,57,1421,1584,T2
6871,March 23,2017,Syria,Uzbekistan,1,0,World Cup qualifier,in Malaysia,27,-27,1571,1635,4,-3,69,53,1544,1662,T1
6872,March 23,2017,Qatar,Iran,0,1,World Cup qualifier,in Qatar,-14,14,1529,1769,-2,4,76,24,1543,1755,T2
6873,March 23,2017,Iraq,Australia,1,1,World Cup qualifier,in Iran,11,-11,1500,1698,1,-2,85,38,1489,1709,draw
6874,March 23,2017,China,South Korea,1,0,World Cup qualifier,in China,29,-29,1546,1761,5,-6,74,27,1517,1790,T1
6875,March 23,2017,Venezuela,Peru,2,2,World Cup qualifier,in Venezuela,3,-3,1687,1830,1,0,42,19,1684,1833,draw
6876,March 23,2017,Uruguay,Brazil,1,4,World Cup qualifier,in Uruguay,-27,27,1888,2119,-2,0,14,1,1915,2092,T2
6877,March 23,2017,Paraguay,Ecuador,2,1,World Cup qualifier,in Paraguay,23,-23,1725,1831,3,-1,34,18,1702,1854,T1
6878,March 23,2017,Colombia,Bolivia,1,0,World Cup qualifier,in Colombia,4,-4,1930,1629,0,0,9,54,1926,1633,T1
6879,March 23,2017,Argentina,Chile,1,0,World Cup qualifier,in Argentina,11,-11,2057,1974,0,-1,2,6,2046,1985,T1
6880,March 24,2017,Tunisia,Cameroon,0,1,Friendly,in Tunisia,-9,9,1562,1700,-1,1,70,38,1571,1691,T2
6881,March 24,2017,Russia,Ivory Coast,0,2,Friendly,in Russia,-20,20,1671,1699,-7,7,46,39,1691,1679,T2
6882,March 24,2017,Morocco,Burkina Faso,2,0,Friendly,in Morocco,12,-12,1614,1609,5,-2,56,58,1602,1621,T1
6883,March 24,2017,Mauritania,Benin,1,0,Friendly,in Mauritania,10,-10,1311,1386,2,-5,129,113,1301,1396,T1
6884,March 24,2017,Libya,Togo,0,0,Friendly,in Egypt,-2,2,1462,1395,1,3,89,108,1464,1393,draw
6885,March 24,2017,Gabon,Guinea,2,2,Friendly,in France,1,-1,1445,1495,-1,0,95,86,1444,1496,draw
6886,March 24,2017,Comoros,Mauritius,2,0,African Nations Cup qualifier,in the Comoros,31,-31,1012,1067,2,-4,187,184,981,1098,T1
6887,March 24,2017,Turkey,Finland,2,0,World Cup qualifier,in Turkey,8,-8,1793,1544,1,-2,21,74,1785,1552,T1
6888,March 24,2017,Spain,Israel,4,1,World Cup qualifier,in Spain,5,-5,1985,1623,0,0,5,55,1980,1628,T1
6889,March 24,2017,Liechtenstein,Macedonia,0,3,World Cup qualifier,in Liechtenstein,-23,23,1157,1425,-1,5,169,102,1180,1402,T2
6890,March 24,2017,Kosovo,Iceland,1,2,World Cup qualifier,in Albania,-4,4,1390,1770,-1,2,111,24,1394,1766,T2
6891,March 24,2017,Italy,Albania,2,0,World Cup qualifier,in Italy,4,-4,1948,1577,0,0,7,66,1944,1581,T1
6892,March 24,2017,Ireland,Wales,0,0,World Cup qualifier,in Ireland,-8,8,1794,1768,0,2,20,26,1802,1760,draw
6893,March 24,2017,Georgia,Serbia,1,3,World Cup qualifier,in Georgia,-17,17,1454,1745,-6,0,94,33,1471,1728,T2
6894,March 24,2017,Croatia,Ukraine,1,0,World Cup qualifier,in Croatia,9,-9,1889,1759,2,-3,13,28,1880,1768,T1
6895,March 24,2017,Austria,Moldova,2,0,World Cup qualifier,in Austria,5,-5,1691,1347,2,0,41,119,1686,1352,T1
6896,March 24,2017,Haiti,Nicaragua,3,1,CONCACAF Championship qualifier,in Haiti,8,-8,1522,1272,0,-4,80,143,1514,1280,T1
6897,March 24,2017,United States,Honduras,6,0,World Cup qualifier,in the United States,18,-18,1754,1592,1,-5,31,63,1736,1610,T1
6898,March 24,2017,Trinidad and Tobago,Panama,1,0,World Cup qualifier,in Trinidad and Tobago,28,-28,1461,1644,7,-5,91,52,1433,1672,T1
6899,March 24,2017,Mexico,Costa Rica,2,0,World Cup qualifier,in Mexico,12,-12,1930,1774,2,-2,9,23,1918,1786,T1
6900,March 25,2017,Fiji,New Zealand,0,2,World Cup qualifier,in Fiji,-14,14,1225,1563,-3,2,154,70,1239,1549,T2
6901,March 25,2017,Tanzania,Botswana,2,0,Friendly,in Tanzania,10,-10,1328,1284,2,-3,124,138,1318,1294,T1
6902,March 25,2017,South Africa,Guinea-Bissau,3,1,Friendly,in South Africa,2,-2,1610,1273,0,-1,59,142,1608,1275,T1
6903,March 25,2017,Mozambique,Angola,2,0,Friendly,in Mozambique,7,-7,1328,1213,1,-5,124,161,1321,1220,T1
6904,March 25,2017,Switzerland,Latvia,1,0,World Cup qualifier,in Switzerland,2,-2,1859,1413,1,1,15,105,1857,1415,T1
6905,March 25,2017,Sweden,Belarus,4,0,World Cup qualifier,in Sweden,13,-13,1770,1575,5,-3,24,67,1757,1588,T1
6906,March 25,2017,Portugal,Hungary,3,0,World Cup qualifier,in Portugal,9,-9,1940,1682,0,-2,8,43,1931,1691,T1
6907,March 25,2017,Luxembourg,France,1,3,World Cup qualifier,in Luxembourg,-1,1,1243,2011,0,0,150,4,1244,2010,T2
6908,March 25,2017,Cyprus,Estonia,0,0,World Cup qualifier,in Cyprus,-4,4,1413,1442,0,1,105,97,1417,1438,draw
6909,March 25,2017,Bulgaria,Netherlands,2,0,World Cup qualifier,in Bulgaria,46,-46,1633,1843,11,-4,54,17,1587,1889,T1
6910,March 25,2017,Bosnia and Herzegovina,Gibraltar,5,0,World Cup qualifier,in Bosnia and Herzegovina,1,-1,1756,1096,0,0,30,180,1755,1097,T1
6911,March 25,2017,Belgium,Greece,1,1,World Cup qualifier,in Belgium,-15,15,1891,1669,0,2,12,47,1906,1654,draw
6912,March 25,2017,Andorra,Faroe Islands,0,0,World Cup qualifier,in Andorra,11,-11,984,1285,0,-3,190,136,973,1296,draw
6913,March 26,2017,Zimbabwe,Zambia,0,0,Friendly,in Zimbabwe,-2,2,1405,1445,0,1,107,95,1407,1443,draw
6914,March 26,2017,Kenya,Democratic Republic of Congo,2,1,Friendly,in Kenya,13,-13,1401,1584,4,-2,108,64,1388,1597,T1
6915,March 26,2017,Taiwan,Turkmenistan,1,3,Asian Cup qualifier,in Taiwan,-9,9,852,1269,-2,2,205,144,861,1260,T2
6916,March 26,2017,Madagascar,São Tomé and Príncipe,3,2,African Nations Cup qualifier,in Madagascar,7,-7,1269,1082,1,0,144,181,1262,1089,T1
6917,March 26,2017,Scotland,Slovenia,1,0,World Cup qualifier,in Scotland,14,-14,1678,1639,4,-2,45,52,1664,1653,T1
6918,March 26,2017,San Marino,Czechia,0,6,World Cup qualifier,in San Marino,-1,1,859,1703,0,0,204,37,860,1702,T2
6919,March 26,2017,Romania,Denmark,0,0,World Cup qualifier,in Romania,-4,4,1678,1721,-2,0,45,35,1682,1717,draw
6920,March 26,2017,Northern Ireland,Norway,2,0,World Cup qualifier,in Northern Ireland,16,-16,1663,1561,1,-6,50,71,1647,1577,T1
6921,March 26,2017,Montenegro,Poland,1,2,World Cup qualifier,in Montenegro,-12,12,1585,1863,-1,1,63,15,1597,1851,T2
6922,March 26,2017,Malta,Slovakia,1,3,World Cup qualifier,in Malta,-4,4,1211,1757,-1,2,161,30,1215,1753,T2
6923,March 26,2017,England,Lithuania,2,0,World Cup qualifier,in England,2,-2,1926,1458,0,0,11,92,1924,1460,T1
6924,March 26,2017,Azerbaijan,Germany,1,4,World Cup qualifier,in Azerbaijan,-4,4,1437,2047,0,0,98,3,1441,2043,T2
6925,March 26,2017,Armenia,Kazakhstan,2,0,World Cup qualifier,in Armenia,14,-14,1516,1381,2,-5,81,113,1502,1395,T1
6926,March 26,2017,Barbados,Martinique,2,1,Friendly,in Barbados,16,-16,1149,1486,2,-3,170,86,1133,1502,T1
6927,March 27,2017,Turkey,Moldova,3,1,Friendly,in Turkey,1,-1,1794,1346,1,0,20,119,1793,1347,T1
6928,March 27,2017,Mauritania,Congo,2,1,Friendly,in Mauritania,10,-10,1321,1418,2,-4,127,104,1311,1428,T1
6929,March 27,2017,Ivory Coast,Senegal,1,1,Friendly,in France,0,0,1699,1712,0,0,39,36,1699,1712,draw
6930,March 27,2017,Gambia,Central African Republic,2,1,Friendly,in Morocco,10,-10,1290,1285,5,-3,134,136,1280,1295,T1
6931,March 28,2017,Tanzania,Burundi,2,1,Friendly,in Tanzania,7,-7,1335,1305,2,-3,122,132,1328,1312,T1
6932,March 28,2017,South Africa,Angola,0,0,Friendly,in South Africa,-9,9,1601,1222,-2,5,61,155,1610,1213,draw
6933,March 28,2017,Russia,Belgium,3,3,Friendly,in Russia,3,-3,1674,1888,-1,0,48,12,1671,1891,draw
6934,March 28,2017,Portugal,Sweden,2,3,Friendly,in Portugal,-17,17,1923,1787,-3,3,11,21,1940,1770,T2
6935,March 28,2017,Netherlands,Italy,1,2,Friendly,in the Netherlands,-10,10,1833,1958,-1,-1,18,8,1843,1948,T2
6936,March 28,2017,Mozambique,Lesotho,1,0,Friendly,in Mozambique,5,-5,1333,1214,-1,-5,125,161,1328,1219,T1
6937,March 28,2017,Morocco,Tunisia,1,0,Friendly,in Morocco,6,-6,1620,1556,-1,0,58,70,1614,1562,T1
6938,March 28,2017,Macedonia,Belarus,3,0,Friendly,in Macedonia,20,-20,1445,1555,5,-5,96,71,1425,1575,T1
6939,March 28,2017,Luxembourg,Cape Verde,0,2,Friendly,in Luxembourg,-11,11,1232,1443,1,0,149,99,1243,1432,T2
6940,March 28,2017,Ireland,Iceland,0,1,Friendly,in Ireland,-13,13,1781,1783,-4,2,24,22,1794,1770,T2
6941,March 28,2017,Guyana,Martinique,0,0,Friendly,in Guyana,5,-5,1198,1481,0,1,165,85,1193,1486,draw
6942,March 28,2017,Guinea,Cameroon,2,1,Friendly,in Belgium,15,-15,1510,1685,2,-2,83,40,1495,1700,T1
6943,March 28,2017,Georgia,Latvia,5,0,Friendly,in Georgia,12,-12,1466,1401,5,-2,89,107,1454,1413,T1
6944,March 28,2017,France,Spain,0,2,Friendly,in France,-20,20,1991,2005,-1,2,5,3,2011,1985,T2
6945,March 28,2017,Estonia,Croatia,3,0,Friendly,in Estonia,31,-31,1473,1858,10,-3,87,16,1442,1889,T1
6946,March 28,2017,Egypt,Togo,3,0,Friendly,in Egypt,3,-3,1685,1392,3,0,40,109,1682,1395,T1
6947,March 28,2017,Austria,Finland,1,1,Friendly,in Austria,-6,6,1685,1550,1,2,40,72,1691,1544,draw
6948,March 28,2017,Albania,Bosnia and Herzegovina,1,2,Friendly,in Albania,-8,8,1569,1764,-1,2,66,29,1577,1756,T2
6949,March 28,2017,Yemen,Tajikistan,2,1,Asian Cup qualifier,in Qatar,23,-23,1222,1230,8,-3,155,151,1199,1253,T1
6950,March 28,2017,Philippines,Nepal,4,1,Asian Cup qualifier,in the Philippines,6,-6,1223,896,4,0,154,201,1217,902,T1
6951,March 28,2017,Bahrain,Singapore,0,0,Asian Cup qualifier,in Bahrain,-17,17,1404,1120,-3,3,106,175,1421,1103,draw
6952,March 28,2017,Oman,Bhutan,14,0,Asian Cup qualifier,in Oman,1,-1,1466,608,-1,0,89,229,1465,609,T1
6953,March 28,2017,Maldives,Palestine,0,3,Asian Cup qualifier,in the Maldives,-11,11,941,1353,-4,2,197,119,952,1342,T2
6954,March 28,2017,Jordan,Cambodia,7,0,Asian Cup qualifier,in Jordan,1,-1,1512,798,1,1,81,210,1511,799,T1
6955,March 28,2017,Afghanistan,Vietnam,1,1,Asian Cup qualifier,in Tajikistan,7,-7,1156,1268,0,-4,170,145,1149,1275,draw
6956,March 28,2017,Lebanon,Hong Kong,2,0,Asian Cup qualifier,in Lebanon,10,-10,1383,1183,3,-2,113,167,1373,1193,T1
6957,March 28,2017,Kyrgyzstan,Macao,1,0,Asian Cup qualifier,in Kyrgyzstan,1,-1,1228,685,1,-1,152,222,1227,686,T1
6958,March 28,2017,Myanmar,India,0,1,Asian Cup qualifier,in Myanmar,-24,24,1057,1130,-3,1,185,174,1081,1106,T2
6959,March 28,2017,South Sudan,Djibouti,6,0,African Nations Cup qualifier,in South Sudan,9,-9,1074,791,2,-2,183,212,1065,800,T1
6960,March 28,2017,Mauritius,Comoros,1,1,African Nations Cup qualifier,in Mauritius,-8,8,1059,1020,0,0,184,187,1067,1012,draw
6961,March 28,2017,New Zealand,Fiji,2,0,World Cup qualifier,in New Zealand,4,-4,1567,1221,2,-3,67,157,1563,1225,T1
6962,March 28,2017,Uzbekistan,Qatar,1,0,World Cup qualifier,in Uzbekistan,9,-9,1644,1520,0,-3,53,79,1635,1529,T1
6963,March 28,2017,South Korea,Syria,1,0,World Cup qualifier,in South Korea,6,-6,1767,1565,0,0,28,68,1761,1571,T1
6964,March 28,2017,Saudi Arabia,Iraq,1,0,World Cup qualifier,in Saudi Arabia,9,-9,1622,1491,1,0,57,84,1613,1500,T1
6965,March 28,2017,Japan,Thailand,4,0,World Cup qualifier,in Japan,4,-4,1782,1388,-1,-1,23,111,1778,1392,T1
6966,March 28,2017,Iran,China,1,0,World Cup qualifier,in Iran,5,-5,1774,1541,1,-1,25,74,1769,1546,T1
6967,March 28,2017,Australia,United Arab Emirates,2,0,World Cup qualifier,in Australia,12,-12,1710,1549,3,-2,37,73,1698,1561,T1
6968,March 28,2017,Nicaragua,Haiti,3,0,CONCACAF Championship qualifier,in Nicaragua,49,-49,1321,1473,16,-7,127,87,1272,1522,T1
6969,March 28,2017,Trinidad and Tobago,Mexico,0,1,World Cup qualifier,in Trinidad and Tobago,-4,4,1457,1934,-3,0,94,9,1461,1930,T2
6970,March 28,2017,Panama,United States,1,1,World Cup qualifier,in Panama,1,-1,1645,1753,-1,0,52,32,1644,1754,draw
6971,March 28,2017,Honduras,Costa Rica,1,1,World Cup qualifier,in Honduras,5,-5,1597,1769,0,-3,62,26,1592,1774,draw
6972,March 28,2017,Peru,Uruguay,2,1,World Cup qualifier,in Peru,18,-18,1848,1870,2,1,17,13,1830,1888,T1
6973,March 28,2017,Ecuador,Colombia,0,2,World Cup qualifier,in Ecuador,-30,30,1801,1960,-1,2,19,7,1831,1930,T2
6974,March 28,2017,Chile,Venezuela,3,1,World Cup qualifier,in Chile,6,-6,1980,1681,0,-2,6,44,1974,1687,T1
6975,March 28,2017,Brazil,Paraguay,3,0,World Cup qualifier,in Brazil,4,-4,2123,1721,0,0,1,34,2119,1725,T1
6976,March 28,2017,Bolivia,Argentina,2,0,World Cup qualifier,in Bolivia,52,-52,1681,2005,11,-1,44,3,1629,2057,T1
6977,March 28,2017,Tahiti,Papua New Guinea,1,2,World Cup qualifier,in Tahiti,-32,32,1221,1131,-9,6,157,173,1253,1099,T2
6978,April 26,2017,Martinique,Guadeloupe,4,1,Friendly,in Martinique,5,-5,1486,1275,0,0,85,141,1481,1280,T1
6979,April 29,2017,Vatican,Monaco,0,0,Friendly,in Italy,6,-6,692,903,2,-1,219,200,686,909,draw
6980,April 29,2017,Grenada,Trinidad and Tobago,2,2,Friendly,in Grenada,6,-6,1126,1451,0,-1,175,95,1120,1457,draw
6981,May 6,2017,Saint Kitts and Nevis,Barbados,2,1,Friendly,in Saint Kitts and Nevis,4,-4,1270,1145,3,0,143,171,1266,1149,T1
6982,May 17,2017,Guadeloupe,Dominica,2,2,Friendly,in Guadeloupe,-8,8,1267,966,-5,0,146,191,1275,958,draw
6983,May 25,2017,Fiji,Solomon Islands,1,1,Friendly,in Fiji,-5,5,1216,1139,-2,0,159,172,1221,1134,draw
6984,May 26,2017,Swaziland,Lesotho,1,0,Friendly,in Swaziland,4,-4,1339,1210,0,-1,122,162,1335,1214,T1
6985,May 27,2017,El Salvador,Honduras,2,2,Friendly,in the United States,5,-5,1431,1592,0,0,101,62,1426,1597,draw
6986,May 27,2017,Croatia,Mexico,2,1,Friendly,in the United States,12,-12,1870,1922,3,-2,13,11,1858,1934,T1
6987,May 28,2017,Swaziland,Lesotho,0,1,Friendly,in Swaziland,-16,16,1323,1226,-4,9,126,153,1339,1210,T2
6988,May 28,2017,Fiji,Solomon Islands,1,0,Friendly,in Fiji,5,-5,1221,1134,1,0,158,172,1216,1139,T1
6989,May 31,2017,Morocco,Netherlands,1,2,Friendly,in Morocco,-7,7,1613,1840,0,0,58,18,1620,1833,T2
6990,May 31,2017,Italy,San Marino,8,0,Friendly,in Italy,0,0,1958,859,0,0,8,204,1958,859,T1
6991,June 1,2017,Switzerland,Belarus,1,0,Friendly,in Switzerland,2,-2,1861,1553,0,0,16,71,1859,1555,T1
6992,June 1,2017,Nigeria,Togo,3,0,Friendly,in France,6,-6,1674,1386,2,-2,48,111,1668,1392,T1
6993,June 1,2017,Iraq,Jordan,1,0,Friendly,in Iraq,8,-8,1499,1504,0,-2,84,83,1491,1512,T1
6994,June 1,2017,Mexico,Ireland,3,1,Friendly,in the United States,9,-9,1931,1772,2,-1,9,25,1922,1781,T1
6995,June 2,2017,Oman,Syria,1,1,Friendly,in Oman,0,0,1466,1565,0,1,89,67,1466,1565,draw
6996,June 2,2017,Northern Ireland,New Zealand,1,0,Friendly,in Northern Ireland,5,-5,1668,1562,0,-1,51,68,1663,1567,T1
6997,June 2,2017,France,Paraguay,5,0,Friendly,in France,4,-4,1995,1717,0,-1,5,35,1991,1721,T1
6998,June 2,2017,Nicaragua,Bolivia,0,1,Friendly,in Nicaragua,-4,4,1317,1685,-1,4,128,40,1321,1681,T2
6999,June 2,2017,Chile,Burkina Faso,3,0,Friendly,in Chile,2,-2,1982,1607,0,0,6,59,1980,1609,T1
7000,June 3,2017,Ethiopia,Uganda,0,0,Friendly,in Ethiopia,2,-2,1303,1460,0,-1,133,92,1301,1462,draw
7001,June 3,2017,Portugal,Cyprus,4,0,Friendly,in Portugal,1,-1,1924,1412,0,0,11,104,1923,1413,T1
7002,June 3,2017,United States,Venezuela,1,1,Friendly,in the United States,-5,5,1748,1686,0,5,32,40,1753,1681,draw
7003,June 4,2017,Togo,Comoros,2,0,Friendly,in France,3,-3,1389,1017,1,0,110,187,1386,1020,T1
7004,June 4,2017,Netherlands,Ivory Coast,5,0,Friendly,in the Netherlands,8,-8,1848,1691,1,0,17,39,1840,1699,T1
7005,June 4,2017,Montenegro,Iran,1,2,Friendly,in Montenegro,-7,7,1578,1781,-1,-1,64,25,1585,1774,T2
7006,June 4,2017,Luxembourg,Albania,2,1,Friendly,in Luxembourg,16,-16,1248,1553,1,-4,148,70,1232,1569,T1
7007,June 4,2017,Lesotho,Mauritania,1,0,Friendly,in South Africa,13,-13,1239,1308,4,-3,149,130,1226,1321,T1
7008,June 4,2017,Ireland,Uruguay,3,1,Friendly,in Ireland,15,-15,1787,1855,4,-3,21,16,1772,1870,T1
7009,June 4,2017,Gabon,Zambia,0,0,Friendly,in Gabon,-3,3,1442,1448,-3,0,99,96,1445,1445,draw
7010,June 4,2017,Armenia,Saint Kitts and Nevis,5,0,Friendly,in Armenia,5,-5,1521,1265,1,-4,79,146,1516,1270,T1
7011,June 5,2017,Senegal,Uganda,0,0,Friendly,in Senegal,-8,8,1704,1468,-1,3,37,89,1712,1460,draw
7012,June 5,2017,Macedonia,Turkey,0,0,Friendly,in Macedonia,6,-6,1451,1788,2,0,95,20,1445,1794,draw
7013,June 5,2017,Liberia,Sierra Leone,1,0,Friendly,in Liberia,9,-9,1325,1363,3,0,125,117,1316,1372,T1
7014,June 5,2017,Hungary,Russia,0,3,Friendly,in Hungary,-23,23,1659,1697,-6,9,51,39,1682,1674,T2
7015,June 5,2017,Egypt,Libya,1,0,Friendly,in Egypt,3,-3,1688,1459,0,-1,41,92,1685,1462,T1
7016,June 5,2017,Democratic Republic of Congo,Botswana,2,0,Friendly,in Morocco,5,-5,1589,1279,0,0,63,140,1584,1284,T1
7017,June 5,2017,Belgium,Czechia,2,1,Friendly,in Belgium,3,-3,1891,1700,0,0,12,38,1888,1703,T1
7018,June 6,2017,Uzbekistan,Thailand,2,0,Friendly,in Uzbekistan,3,-3,1647,1385,1,0,52,111,1644,1388,T1
7019,June 6,2017,Ukraine,Malta,0,1,Friendly,in Austria,-19,19,1740,1230,-3,10,33,152,1759,1211,T2
7020,June 6,2017,Singapore,Myanmar,1,1,Friendly,in Singapore,-4,4,1116,1061,0,1,176,184,1120,1057,draw
7021,June 6,2017,Qatar,North Korea,2,2,Friendly,in Qatar,-3,3,1517,1527,0,1,80,76,1520,1524,draw
7022,June 6,2017,Israel,Moldova,1,1,Friendly,in Israel,-8,8,1615,1354,-1,1,57,119,1623,1346,draw
7023,June 6,2017,India,Nepal,2,0,Friendly,in India,4,-4,1134,892,2,0,172,201,1130,896,T1
7024,June 6,2017,Denmark,Germany,1,1,Friendly,in Denmark,6,-6,1727,2041,0,0,34,2,1721,2047,draw
7025,June 6,2017,Bahrain,Palestine,0,2,Friendly,in Bahrain,-21,21,1383,1374,-6,3,112,116,1404,1353,T2
7026,June 6,2017,Algeria,Guinea,2,1,Friendly,in Algeria,5,-5,1609,1505,1,0,59,82,1604,1510,T1
7027,June 6,2017,Afghanistan,Maldives,2,1,Friendly,in the United Arab Emirates,4,-4,1160,937,2,0,168,197,1156,941,T1
7028,June 7,2017,Fiji,New Caledonia,2,2,World Cup qualifier,in Fiji,0,0,1221,1324,1,0,158,126,1221,1324,draw
7029,June 7,2017,United Arab Emirates,Laos,4,0,Friendly,in Malaysia,1,-1,1550,804,1,0,72,209,1549,805,T1
7030,June 7,2017,Spain,Colombia,2,2,Friendly,in Spain,-4,4,2001,1964,-1,-1,4,8,2005,1960,draw
7031,June 7,2017,Japan,Syria,1,1,Friendly,in Japan,-7,7,1775,1572,-1,0,25,66,1782,1565,draw
7032,June 7,2017,Italy,Uruguay,3,0,Friendly,in France,12,-12,1970,1843,1,-2,7,18,1958,1855,T1
7033,June 7,2017,Iraq,South Korea,0,0,Friendly,in the United Arab Emirates,6,-6,1505,1761,2,-1,82,29,1499,1767,draw
7034,June 7,2017,Hong Kong,Jordan,0,0,Friendly,in Hong Kong,6,-6,1189,1498,0,-1,167,84,1183,1504,draw
7035,June 7,2017,Ghana,Gambia,2,1,Friendly,in Ghana,2,-2,1574,1288,0,-1,65,136,1572,1290,T1
7036,June 7,2017,Georgia,Saint Kitts and Nevis,3,0,Friendly,in Georgia,5,-5,1471,1260,1,0,89,146,1466,1265,T1
7037,June 7,2017,Finland,Liechtenstein,1,1,Friendly,in Finland,-9,9,1541,1166,-2,2,74,168,1550,1157,draw
7038,June 7,2017,China,Philippines,8,1,Friendly,in China,4,-4,1545,1219,1,-4,73,160,1541,1223,T1
7039,June 7,2017,Bolivia,Nicaragua,3,2,Friendly,in Bolivia,1,-1,1686,1316,1,0,42,128,1685,1317,T1
7040,June 8,2017,Cambodia,Indonesia,0,2,Friendly,in Cambodia,-4,4,794,1235,-1,0,211,151,798,1231,T2
7041,June 8,2017,Australia,Saudi Arabia,3,2,World Cup qualifier,in Australia,10,-10,1720,1612,1,-2,35,58,1710,1622,T1
7042,June 8,2017,Peru,Paraguay,1,0,Friendly,in Peru,4,-4,1852,1713,0,-1,16,36,1848,1717,T1
7043,June 8,2017,Grenada,Bermuda,2,2,Friendly,in Grenada,-1,1,1125,1200,0,0,175,164,1126,1199,draw
7044,June 8,2017,Ecuador,Venezuela,1,1,Friendly,in the United States,-3,3,1798,1689,0,1,19,41,1801,1686,draw
7045,June 8,2017,United States,Trinidad and Tobago,2,0,World Cup qualifier,in the United States,6,-6,1754,1445,0,-2,31,97,1748,1451,T1
7046,June 8,2017,Mexico,Honduras,3,0,World Cup qualifier,in Mexico,5,-5,1936,1587,0,-1,9,63,1931,1592,T1
7047,June 8,2017,Costa Rica,Panama,0,0,World Cup qualifier,in Costa Rica,-11,11,1758,1656,-3,1,29,52,1769,1645,draw
7048,June 9,2017,Russia,Chile,1,1,Friendly,in Russia,5,-5,1702,1977,1,1,38,5,1697,1982,draw
7049,June 9,2017,Argentina,Brazil,1,0,Friendly,in Australia,13,-13,2018,2110,0,0,3,1,2005,2123,T1
7050,June 9,2017,Sudan,Madagascar,1,3,African Nations Cup qualifier,in Sudan,-40,40,1245,1309,-11,13,148,129,1285,1269,T2
7051,June 9,2017,Libya,Seychelles,5,1,African Nations Cup qualifier,in Egypt,4,-4,1463,954,0,0,92,192,1459,958,T1
7052,June 9,2017,Solomon Islands,Papua New Guinea,3,2,World Cup qualifier,in the Solomon Islands,14,-14,1148,1117,1,-1,171,175,1134,1131,T1
7053,June 9,2017,Sweden,France,2,1,World Cup qualifier,in Sweden,26,-26,1813,1969,2,-2,19,7,1787,1995,T1
7054,June 9,2017,Netherlands,Luxembourg,5,0,World Cup qualifier,in the Netherlands,1,-1,1849,1247,0,1,17,147,1848,1248,T1
7055,June 9,2017,Latvia,Portugal,0,3,World Cup qualifier,in Latvia,-6,6,1395,1930,-1,1,107,10,1401,1924,T2
7056,June 9,2017,Faroe Islands,Switzerland,0,2,World Cup qualifier,in the Faroe Islands,-4,4,1281,1865,-2,1,139,14,1285,1861,T2
7057,June 9,2017,Estonia,Belgium,0,2,World Cup qualifier,in Estonia,-8,8,1465,1899,-4,0,91,12,1473,1891,T2
7058,June 9,2017,Cyprus,Gibraltar,2,1,World Cup qualifier,in Portugal,6,-6,1418,1090,1,0,103,180,1412,1096,T1
7059,June 9,2017,Bosnia and Herzegovina,Greece,0,0,World Cup qualifier,in Bosnia and Herzegovina,-10,10,1754,1679,-3,3,30,46,1764,1669,draw
7060,June 9,2017,Belarus,Bulgaria,2,1,World Cup qualifier,in Belarus,19,-19,1572,1614,4,-1,66,56,1553,1633,T1
7061,June 9,2017,Andorra,Hungary,1,0,World Cup qualifier,in Andorra,39,-39,1023,1620,4,-3,186,54,984,1659,T1
7062,June 10,2017,Singapore,Taiwan,1,2,Asian Cup qualifier,in Singapore,-36,36,1080,888,-5,3,181,202,1116,852,T2
7063,June 10,2017,Zambia,Mozambique,0,1,African Nations Cup qualifier,in Zambia,-31,31,1417,1364,-7,6,103,118,1448,1333,T2
7064,June 10,2017,Tanzania,Lesotho,1,1,African Nations Cup qualifier,in Tanzania,-10,10,1325,1249,-4,2,126,147,1335,1239,draw
7065,June 10,2017,Sierra Leone,Kenya,2,1,African Nations Cup qualifier,in Sierra Leone,16,-16,1379,1385,3,-4,115,110,1363,1401,T1
7066,June 10,2017,Senegal,Equatorial Guinea,3,0,African Nations Cup qualifier,in Senegal,5,-5,1709,1341,0,-1,37,122,1704,1346,T1
7067,June 10,2017,Nigeria,South Africa,0,2,African Nations Cup qualifier,in Nigeria,-44,44,1630,1645,-5,9,54,52,1674,1601,T2
7068,June 10,2017,Niger,Swaziland,0,0,African Nations Cup qualifier,in Niger,-4,4,1289,1327,-1,2,136,125,1293,1323,draw
7069,June 10,2017,Mali,Gabon,2,1,African Nations Cup qualifier,in Mali,10,-10,1533,1432,2,1,76,98,1523,1442,T1
7070,June 10,2017,Malawi,Comoros,1,0,African Nations Cup qualifier,in Malawi,3,-3,1338,1014,-1,0,123,188,1335,1017,T1
7071,June 10,2017,Ivory Coast,Guinea,2,3,African Nations Cup qualifier,in Ivory Coast,-34,34,1657,1539,-9,7,49,75,1691,1505,T2
7072,June 10,2017,Guinea-Bissau,Namibia,1,0,African Nations Cup qualifier,in Guinea-Bissau,20,-20,1293,1354,6,-3,135,119,1273,1374,T1
7073,June 10,2017,Democratic Republic of Congo,Congo,3,1,African Nations Cup qualifier,in the Democratic Republic of the Congo,10,-10,1599,1408,0,-1,62,104,1589,1418,T1
7074,June 10,2017,Cameroon,Morocco,1,0,African Nations Cup qualifier,in Cameroon,11,-11,1696,1602,4,-4,40,61,1685,1613,T1
7075,June 10,2017,Burundi,South Sudan,3,0,African Nations Cup qualifier,in Burundi,9,-9,1314,1065,3,0,130,183,1305,1074,T1
7076,June 10,2017,Burkina Faso,Angola,3,1,African Nations Cup qualifier,in Burkina Faso,3,-3,1610,1219,1,-3,59,159,1607,1222,T1
7077,June 10,2017,Botswana,Mauritania,0,1,African Nations Cup qualifier,in Botswana,-24,24,1255,1332,-6,7,146,124,1279,1308,T2
7078,June 10,2017,Slovenia,Malta,2,0,World Cup qualifier,in Slovenia,3,-3,1642,1227,0,-2,53,154,1639,1230,T1
7079,June 10,2017,Scotland,England,2,2,World Cup qualifier,in Scotland,8,-8,1686,1918,4,0,43,11,1678,1926,draw
7080,June 10,2017,Poland,Romania,3,1,World Cup qualifier,in Poland,10,-10,1873,1668,2,-1,13,48,1863,1678,T1
7081,June 10,2017,Norway,Czechia,1,1,World Cup qualifier,in Norway,2,-2,1563,1698,1,0,68,39,1561,1700,draw
7082,June 10,2017,Montenegro,Armenia,4,1,World Cup qualifier,in Montenegro,20,-20,1598,1501,1,-4,63,83,1578,1521,T1
7083,June 10,2017,Lithuania,Slovakia,1,2,World Cup qualifier,in Lithuania,-10,10,1448,1767,-2,2,95,27,1458,1757,T2
7084,June 10,2017,Kazakhstan,Denmark,1,3,World Cup qualifier,in Kazakhstan,-12,12,1369,1739,-3,0,117,34,1381,1727,T2
7085,June 10,2017,Germany,San Marino,7,0,World Cup qualifier,in Germany,0,0,2041,859,0,-1,2,205,2041,859,T1
7086,June 10,2017,Azerbaijan,Northern Ireland,0,1,World Cup qualifier,in Azerbaijan,-13,13,1424,1681,0,4,100,46,1437,1668,T2
7087,June 10,2017,Grenada,Bermuda,1,2,Friendly,in Grenada,-11,11,1114,1211,-1,1,175,163,1125,1200,T2
7088,June 11,2017,Zimbabwe,Liberia,3,0,African Nations Cup qualifier,in Zimbabwe,18,-18,1423,1307,4,-6,101,132,1405,1325,T1
7089,June 11,2017,Tunisia,Egypt,1,0,African Nations Cup qualifier,in Tunisia,22,-22,1578,1666,4,-6,66,48,1556,1688,T1
7090,June 11,2017,Ghana,Ethiopia,5,0,African Nations Cup qualifier,in Ghana,8,-8,1582,1295,0,0,65,134,1574,1303,T1
7091,June 11,2017,Central African Republic,Rwanda,2,1,African Nations Cup qualifier,in Central African Republic,16,-16,1301,1292,6,-3,133,136,1285,1308,T1
7092,June 11,2017,Cape Verde,Uganda,0,1,African Nations Cup qualifier,in Cape Verde,-24,24,1419,1492,-5,4,102,85,1443,1468,T2
7093,June 11,2017,Benin,Gambia,1,0,African Nations Cup qualifier,in Benin,10,-10,1396,1278,3,-2,106,140,1386,1288,T1
7094,June 11,2017,Algeria,Togo,1,0,African Nations Cup qualifier,in Algeria,5,-5,1614,1384,4,-2,56,110,1609,1389,T1
7095,June 11,2017,New Caledonia,Fiji,2,1,World Cup qualifier,in New Caledonia,9,-9,1333,1212,4,-5,124,162,1324,1221,T1
7096,June 11,2017,Serbia,Wales,1,1,World Cup qualifier,in Serbia,-4,4,1741,1772,-1,0,33,26,1745,1768,draw
7097,June 11,2017,Moldova,Georgia,2,2,World Cup qualifier,in Moldova,1,-1,1355,1470,0,-1,119,89,1354,1471,draw
7098,June 11,2017,Macedonia,Spain,1,2,World Cup qualifier,in Macedonia,-3,3,1448,2004,0,0,94,4,1451,2001,T2
7099,June 11,2017,Kosovo,Turkey,1,4,World Cup qualifier,in Albania,-6,6,1384,1794,-3,-1,110,22,1390,1788,T2
7100,June 11,2017,Italy,Liechtenstein,5,0,World Cup qualifier,in Italy,0,0,1970,1166,0,0,6,168,1970,1166,T1
7101,June 11,2017,Israel,Albania,0,3,World Cup qualifier,in Israel,-50,50,1565,1603,-13,11,69,60,1615,1553,T2
7102,June 11,2017,Ireland,Austria,1,1,World Cup qualifier,in Ireland,-10,10,1777,1695,-2,4,24,41,1787,1685,draw
7103,June 11,2017,Iceland,Croatia,1,0,World Cup qualifier,in Iceland,19,-19,1802,1851,3,-2,20,16,1783,1870,T1
7104,June 11,2017,Finland,Ukraine,1,2,World Cup qualifier,in Finland,-14,14,1527,1754,-3,2,77,31,1541,1740,T2
7105,June 11,2017,Mexico,United States,1,1,World Cup qualifier,in Mexico,-13,13,1923,1767,-1,3,10,27,1936,1754,draw
7106,June 12,2017,Latvia,Estonia,1,2,Friendly,in Latvia,-11,11,1384,1476,-2,4,109,87,1395,1465,T2
7107,June 12,2017,Belarus,New Zealand,1,0,Friendly,in Belarus,7,-7,1579,1555,1,0,66,71,1572,1562,T1
7108,June 12,2017,Iran,Uzbekistan,2,0,World Cup qualifier,in Iran,12,-12,1793,1635,0,-2,23,53,1781,1647,T1
7109,June 13,2017,South Africa,Zambia,1,2,Friendly,in South Africa,-17,17,1628,1434,-3,7,54,97,1645,1417,T2
7110,June 13,2017,Singapore,Argentina,0,6,Friendly,in Singapore,0,0,1080,2018,0,0,181,3,1080,2018,T2
7111,June 13,2017,Romania,Chile,3,2,Friendly,in Romania,15,-15,1683,1962,2,-3,45,8,1668,1977,T1
7112,June 13,2017,Peru,Jamaica,3,1,Friendly,in Peru,2,-2,1854,1524,0,0,15,79,1852,1526,T1
7113,June 13,2017,Norway,Sweden,1,1,Friendly,in Norway,4,-4,1567,1809,1,0,69,19,1563,1813,draw
7114,June 13,2017,Indonesia,Puerto Rico,0,0,Friendly,in Indonesia,-7,7,1228,1029,-1,1,152,186,1235,1022,draw
7115,June 13,2017,France,England,3,2,Friendly,in France,6,-6,1975,1912,2,0,5,11,1969,1918,T1
7116,June 13,2017,Ecuador,El Salvador,3,0,Friendly,in the United States,4,-4,1802,1427,1,-1,20,99,1798,1431,T1
7117,June 13,2017,Colombia,Cameroon,4,0,Friendly,in Spain,7,-7,1971,1689,2,-1,6,41,1964,1696,T1
7118,June 13,2017,Canada,Curaçao,2,1,Friendly,in Canada,2,-2,1532,1222,-1,1,77,154,1530,1224,T1
7119,June 13,2017,Australia,Brazil,0,4,Friendly,in Australia,-6,6,1714,2116,0,0,35,1,1720,2110,T2
7120,June 13,2017,Vietnam,Jordan,0,0,Asian Cup qualifier,in Vietnam,7,-7,1275,1491,1,-1,141,85,1268,1498,draw
7121,June 13,2017,Turkmenistan,Bahrain,1,2,Asian Cup qualifier,in Turkmenistan,-19,19,1250,1402,-5,6,146,106,1269,1383,T2
7122,June 13,2017,Tajikistan,Philippines,3,4,Asian Cup qualifier,in Tajikistan,-26,26,1204,1245,-12,9,164,149,1230,1219,T2
7123,June 13,2017,Palestine,Oman,2,1,Asian Cup qualifier,in Palestine,20,-20,1394,1446,8,-4,108,95,1374,1466,T1
7124,June 13,2017,Nepal,Yemen,0,0,Asian Cup qualifier,in Nepal,12,-12,904,1210,1,-5,200,161,892,1222,draw
7125,June 13,2017,Malaysia,Lebanon,1,2,Asian Cup qualifier,in Malaysia,-11,11,1100,1394,-1,4,177,108,1111,1383,T2
7126,June 13,2017,Macao,Myanmar,0,4,Asian Cup qualifier,in Macao,-13,13,672,1074,-1,1,223,183,685,1061,T2
7127,June 13,2017,India,Kyrgyzstan,1,0,Asian Cup qualifier,in India,20,-20,1154,1208,2,-9,171,162,1134,1228,T1
7128,June 13,2017,Hong Kong,North Korea,1,1,Asian Cup qualifier,in Hong Kong,12,-12,1201,1515,2,-4,165,81,1189,1527,draw
7129,June 13,2017,Cambodia,Afghanistan,1,0,Asian Cup qualifier,in Cambodia,33,-33,827,1127,3,-4,208,173,794,1160,T1
7130,June 13,2017,Bhutan,Maldives,0,2,Asian Cup qualifier,in Bhutan,-13,13,595,950,-1,4,230,193,608,937,T2
7131,June 13,2017,Papua New Guinea,Solomon Islands,1,2,World Cup qualifier,in Papua New Guinea,-24,24,1093,1172,-4,3,178,168,1117,1148,T2
7132,June 13,2017,Thailand,United Arab Emirates,1,1,World Cup qualifier,in Thailand,4,-4,1389,1546,-3,-1,110,73,1385,1550,draw
7133,June 13,2017,Syria,China,2,2,World Cup qualifier,in Malaysia,-2,2,1570,1547,0,1,68,72,1572,1545,draw
7134,June 13,2017,Qatar,South Korea,3,2,World Cup qualifier,in Qatar,28,-28,1545,1733,6,-5,74,34,1517,1761,T1
7135,June 13,2017,Iraq,Japan,1,1,World Cup qualifier,in Iran,13,-13,1518,1762,2,-3,80,28,1505,1775,draw
7136,June 13,2017,Panama,Honduras,2,2,World Cup qualifier,in Panama,-9,9,1647,1596,0,0,50,64,1656,1587,draw
7137,June 13,2017,Costa Rica,Trinidad and Tobago,2,1,World Cup qualifier,in Costa Rica,3,-3,1761,1442,1,0,29,96,1758,1445,T1
7138,June 17,2017,French Guiana,Barbados,3,0,Friendly,in French Guiana,5,-5,1359,1140,1,0,119,172,1354,1145,T1
7139,June 17,2017,Curaçao,Nicaragua,0,0,Friendly,in Curaçao,0,0,1222,1316,0,0,154,128,1222,1316,draw
7140,June 17,2017,Russia,New Zealand,2,0,Confederations Cup,in Russia,15,-15,1717,1540,3,-3,35,74,1702,1555,T1
7141,June 18,2017,Chile,Cameroon,2,0,Confederations Cup,in Russia,13,-13,1975,1676,3,-6,5,47,1962,1689,T1
7142,June 18,2017,Mexico,Portugal,2,2,Confederations Cup,in Russia,1,-1,1924,1929,0,0,10,9,1923,1930,draw
7143,June 19,2017,Germany,Australia,3,2,Confederations Cup,in Russia,7,-7,2048,1707,0,-2,2,38,2041,1714,T1
7144,June 21,2017,Russia,Portugal,0,1,Confederations Cup,in Russia,-17,17,1700,1946,-3,0,38,9,1717,1929,T2
7145,June 21,2017,Mexico,New Zealand,2,1,Confederations Cup,in Russia,5,-5,1929,1535,0,-1,10,75,1924,1540,T1
7146,June 22,2017,Chile,Germany,1,1,Confederations Cup,in Russia,5,-5,1980,2043,0,0,5,2,1975,2048,draw
7147,June 22,2017,Australia,Cameroon,1,1,Confederations Cup,in Russia,-2,2,1705,1678,0,0,37,47,1707,1676,draw
7148,June 22,2017,Martinique,Curaçao,1,2,Caribbean Championship,in Martinique,-36,36,1450,1258,-6,10,92,144,1486,1222,T2
7149,June 22,2017,Jamaica,French Guiana,1,1,Caribbean Championship,in Martinique,-9,9,1515,1368,-1,1,80,118,1524,1359,draw
7150,June 24,2017,Russia,Mexico,1,2,Confederations Cup,in Russia,-16,16,1684,1945,-5,0,43,10,1700,1929,T2
7151,June 24,2017,Portugal,New Zealand,4,0,Confederations Cup,in Russia,8,-8,1954,1527,0,-2,9,77,1946,1535,T1
7152,June 25,2017,Tanzania,Malawi,2,0,COSAFA Cup,in South Africa,31,-31,1356,1307,7,-8,120,131,1325,1338,T1
7153,June 25,2017,Angola,Mauritius,1,0,COSAFA Cup,in South Africa,11,-11,1230,1048,3,0,153,185,1219,1059,T1
7154,June 25,2017,Germany,Cameroon,3,1,Confederations Cup,in Russia,8,-8,2051,1670,0,0,2,47,2043,1678,T1
7155,June 25,2017,Australia,Chile,1,1,Confederations Cup,in Russia,16,-16,1721,1964,2,-3,35,8,1705,1980,draw
7156,June 25,2017,Martinique,French Guiana,0,1,Caribbean Championship,in Martinique,-30,30,1420,1398,-10,11,102,107,1450,1368,T2
7157,June 25,2017,Curaçao,Jamaica,2,1,Caribbean Championship,in Martinique,33,-33,1291,1482,7,-5,137,85,1258,1515,T1
7158,June 26,2017,Zimbabwe,Mozambique,4,0,COSAFA Cup,in South Africa,31,-31,1454,1333,9,-4,92,123,1423,1364,T1
7159,June 26,2017,Madagascar,Seychelles,2,0,COSAFA Cup,in South Africa,7,-7,1316,947,2,-2,127,194,1309,954,T1
7160,June 27,2017,Malawi,Mauritius,0,0,COSAFA Cup,in South Africa,-13,13,1294,1061,-3,0,134,185,1307,1048,draw
7161,June 27,2017,Angola,Tanzania,0,0,COSAFA Cup,in South Africa,7,-7,1237,1349,0,-2,153,121,1230,1356,draw
7162,June 28,2017,Mozambique,Seychelles,2,1,COSAFA Cup,in South Africa,4,-4,1337,943,0,-3,123,197,1333,947,T1
7163,June 28,2017,Madagascar,Zimbabwe,0,0,COSAFA Cup,in South Africa,8,-8,1324,1446,0,-2,127,94,1316,1454,draw
7164,June 28,2017,Saint Lucia,Saint Vincent and the Grenadines,2,1,Windward Islands Championship,in Grenada,15,-15,1120,1091,2,-3,174,178,1105,1106,T1
7165,June 28,2017,Grenada,Dominica,1,1,Windward Islands Championship,in Grenada,-9,9,1105,975,-1,0,175,191,1114,966,draw
7166,June 28,2017,Mexico,Ghana,1,0,Friendly,in the United States,2,-2,1947,1580,0,0,10,65,1945,1582,T1
7167,June 28,2017,Chile,Portugal,0,0,Confederations Cup,in Russia,-1,1,1963,1955,0,0,8,9,1964,1954,draw
7168,June 29,2017,Mauritius,Tanzania,1,1,COSAFA Cup,in South Africa,14,-14,1075,1335,2,-2,183,123,1061,1349,draw
7169,June 29,2017,Angola,Malawi,0,0,COSAFA Cup,in South Africa,3,-3,1240,1291,1,-2,152,136,1237,1294,draw
7170,June 29,2017,Germany,Mexico,4,1,Confederations Cup,in Russia,31,-31,2082,1916,0,0,2,10,2051,1947,T1
7171,June 30,2017,Zimbabwe,Seychelles,6,0,COSAFA Cup,in South Africa,4,-4,1450,939,2,0,92,197,1446,943,T1
7172,June 30,2017,Madagascar,Mozambique,4,1,COSAFA Cup,in South Africa,36,-36,1360,1301,8,-9,119,131,1324,1337,T1
7173,June 30,2017,Grenada,Saint Lucia,2,0,Windward Islands Championship,in Grenada,17,-17,1122,1103,2,-1,173,175,1105,1120,T1
7174,June 30,2017,Dominica,Barbados,2,1,Windward Islands Championship,in Grenada,22,-22,997,1118,1,-2,190,174,975,1140,T1
7175,July 1,2017,Zambia,Botswana,2,1,COSAFA Cup,in South Africa,11,-11,1445,1244,1,-5,96,151,1434,1255,T1
7176,July 1,2017,Lesotho,Namibia,0,0,COSAFA Cup,in South Africa,6,-6,1255,1348,2,0,146,121,1249,1354,draw
7177,July 1,2017,United States,Ghana,2,1,Friendly,in the United States,3,-3,1770,1577,0,-2,26,67,1767,1580,T1
7178,July 1,2017,Mexico,Paraguay,2,1,Friendly,in the United States,5,-5,1921,1708,0,-1,10,37,1916,1713,T1
7179,July 2,2017,Zimbabwe,Swaziland,2,1,COSAFA Cup,in South Africa,13,-13,1463,1314,2,-1,90,127,1450,1327,T1
7180,July 2,2017,South Africa,Tanzania,0,1,COSAFA Cup,in South Africa,-36,36,1592,1371,-10,5,64,118,1628,1335,T2
7181,July 2,2017,Portugal,Mexico,2,1,Confederations Cup,in Russia,23,-23,1978,1898,4,-2,5,12,1955,1921,T1
7182,July 2,2017,Germany,Chile,1,0,Confederations Cup,in Russia,17,-17,2099,1946,0,-1,2,9,2082,1963,T1
7183,July 3,2017,Nicaragua,Canada,3,1,Friendly,in the United States,23,-23,1339,1509,2,-5,124,81,1316,1532,T1
7184,July 3,2017,Grenada,Saint Vincent and the Grenadines,4,3,Windward Islands Championship,in Grenada,10,-10,1132,1081,1,-2,172,180,1122,1091,T1
7185,July 3,2017,Barbados,Saint Lucia,1,1,Windward Islands Championship,in Grenada,-1,1,1117,1104,0,0,174,175,1118,1103,draw
7186,July 4,2017,Namibia,Swaziland,1,0,COSAFA Cup,in South Africa,18,-18,1366,1296,2,-5,120,132,1348,1314,T1
7187,July 4,2017,South Africa,Botswana,2,0,COSAFA Cup,in South Africa,4,-4,1596,1240,1,0,63,151,1592,1244,T1
7188,July 4,2017,Saint Vincent and the Grenadines,Barbados,4,2,Windward Islands Championship,in Grenada,25,-25,1106,1092,6,-4,174,178,1081,1117,T1
7189,July 4,2017,Dominica,Saint Lucia,0,0,Windward Islands Championship,in Grenada,4,-4,1001,1100,0,0,190,175,997,1104,draw
7190,July 5,2017,Zimbabwe,Lesotho,4,3,COSAFA Cup,in South Africa,9,-9,1472,1246,1,-2,89,148,1463,1255,T1
7191,July 5,2017,Zambia,Tanzania,4,2,COSAFA Cup,in South Africa,24,-24,1469,1347,5,-4,91,122,1445,1371,T1
7192,July 6,2017,Grenada,Barbados,0,2,Windward Islands Championship,in Grenada,-31,31,1101,1123,-3,5,175,173,1132,1092,T2
7193,July 6,2017,Dominica,Saint Vincent and the Grenadines,2,2,Windward Islands Championship,in Grenada,4,-4,1005,1102,1,0,189,174,1001,1106,draw
7194,July 7,2017,South Africa,Namibia,1,0,COSAFA Cup,in South Africa,5,-5,1601,1361,2,0,61,119,1596,1366,T1
7195,July 7,2017,Lesotho,Tanzania,0,0,COSAFA Cup,in South Africa,6,-6,1252,1341,2,0,146,122,1246,1347,draw
7196,July 7,2017,Costa Rica,Honduras,1,0,CONCACAF Championship,in the United States,14,-14,1775,1582,4,-1,25,64,1761,1596,T1
7197,July 7,2017,Canada,French Guiana,4,2,CONCACAF Championship,in the United States,26,-26,1535,1372,6,-10,75,117,1509,1398,T1
7198,July 8,2017,United States,Panama,1,1,CONCACAF Championship,in the United States,-14,14,1756,1661,-2,1,29,49,1770,1647,draw
7199,July 8,2017,Martinique,Nicaragua,2,0,CONCACAF Championship,in the United States,29,-29,1449,1310,8,-3,94,127,1420,1339,T1
7200,July 9,2017,Zimbabwe,Zambia,3,1,COSAFA Cup,in South Africa,30,-30,1502,1439,7,-7,82,98,1472,1469,T1
7201,July 9,2017,Mexico,El Salvador,3,1,CONCACAF Championship,in the United States,5,-5,1903,1422,1,-2,11,102,1898,1427,T1
7202,July 9,2017,Jamaica,Curaçao,2,0,CONCACAF Championship,in the United States,19,-19,1501,1272,2,-6,83,142,1482,1291,T1
7203,July 11,2017,French Guiana,Honduras,0,0,CONCACAF Championship,in the United States,14,-14,1386,1568,6,-4,111,68,1372,1582,draw
7204,July 11,2017,Canada,Costa Rica,1,1,CONCACAF Championship,in the United States,15,-15,1550,1760,4,-3,71,28,1535,1775,draw
7205,July 12,2017,United States,Martinique,3,2,CONCACAF Championship,in the United States,4,-4,1760,1445,1,-3,28,96,1756,1449,T1
7206,July 12,2017,Panama,Nicaragua,2,1,CONCACAF Championship,in the United States,6,-6,1667,1304,1,-2,48,129,1661,1310,T1
7207,July 13,2017,Jamaica,Mexico,0,0,CONCACAF Championship,in the United States,21,-21,1522,1882,4,-1,79,12,1501,1903,draw
7208,July 13,2017,El Salvador,Curaçao,2,0,CONCACAF Championship,in the United States,22,-22,1444,1250,5,-4,97,146,1422,1272,T1
7209,July 14,2017,Thailand,North Korea,3,0,King's Cup,in Thailand,28,-28,1417,1487,5,-5,105,86,1389,1515,T1
7210,July 14,2017,Costa Rica,French Guiana,3,0,CONCACAF Championship,in the United States,9,-9,1769,1377,2,-6,26,117,1760,1386,T1
7211,July 14,2017,Canada,Honduras,0,0,CONCACAF Championship,in the United States,1,-1,1551,1567,0,0,71,68,1550,1568,draw
7212,July 15,2017,United States,Nicaragua,3,0,CONCACAF Championship,in the United States,3,-3,1763,1301,1,0,28,129,1760,1304,T1
7213,July 15,2017,Panama,Martinique,3,0,CONCACAF Championship,in the United States,19,-19,1686,1426,7,-4,41,100,1667,1445,T1
7214,July 16,2017,Mexico,Curaçao,2,0,CONCACAF Championship,in the United States,2,-2,1884,1248,0,-1,12,147,1882,1250,T1
7215,July 16,2017,El Salvador,Jamaica,1,1,CONCACAF Championship,in the United States,6,-6,1450,1516,3,-1,93,80,1444,1522,draw
7216,July 19,2017,United States,El Salvador,2,0,CONCACAF Championship,in the United States,6,-6,1769,1444,1,-3,27,96,1763,1450,T1
7217,July 19,2017,Costa Rica,Panama,1,0,CONCACAF Championship,in the United States,19,-19,1788,1667,2,-7,24,48,1769,1686,T1
7218,July 20,2017,Mexico,Honduras,1,0,CONCACAF Championship,in the United States,7,-7,1891,1560,0,-2,12,70,1884,1567,T1
7219,July 20,2017,Jamaica,Canada,2,1,CONCACAF Championship,in the United States,28,-28,1544,1523,6,-8,74,79,1516,1551,T1
7220,July 22,2017,United States,Costa Rica,2,0,CONCACAF Championship,in the United States,29,-29,1798,1759,5,-5,22,29,1769,1788,T1
7221,July 23,2017,Jamaica,Mexico,1,0,CONCACAF Championship,in the United States,44,-44,1588,1847,10,-5,64,17,1544,1891,T1
7222,July 26,2017,United States,Jamaica,2,1,CONCACAF Championship,in the United States,7,-7,1805,1581,2,0,20,64,1798,1588,T1
7223,July 26,2017,Ecuador,Trinidad and Tobago,3,1,Friendly,in Ecuador,2,-2,1804,1440,-1,0,21,97,1802,1442,T1
7224,July 28,2017,Solomon Islands,Vanuatu,0,0,Friendly,in the Solomon Islands,-2,2,1170,1193,0,0,168,167,1172,1191,draw
7225,August 16,2017,Qatar,Andorra,1,0,Friendly,in England,1,-1,1546,1022,1,0,73,187,1545,1023,T1
7226,August 19,2017,India,Mauritius,2,1,Friendly tournament,in India,8,-8,1162,1067,1,-1,170,184,1154,1075,T1
7227,August 22,2017,Mauritius,Saint Kitts and Nevis,1,1,Friendly tournament,in India,8,-8,1075,1252,1,-1,183,144,1067,1260,draw
7228,August 22,2017,Malaysia,Syria,1,2,Friendly,in Malaysia,-2,2,1098,1572,-1,0,177,68,1100,1570,T2
7229,August 23,2017,Qatar,Turkmenistan,2,1,Friendly,in Qatar,2,-2,1548,1248,1,0,72,146,1546,1250,T1
7230,August 24,2017,India,Saint Kitts and Nevis,1,1,Friendly tournament,in India,0,0,1162,1252,0,0,170,144,1162,1252,draw
7231,August 24,2017,Trinidad and Tobago,Jamaica,1,2,Friendly,in Trinidad and Tobago,-9,9,1431,1590,-2,0,99,64,1440,1581,T2
7232,August 25,2017,Uzbekistan,Kyrgyzstan,5,0,Friendly,in Uzbekistan,2,-2,1637,1206,0,0,52,162,1635,1208,T1
7233,August 26,2017,Iraq,Syria,1,1,Friendly,in Malaysia,2,-2,1520,1570,0,0,80,68,1518,1572,draw
7234,August 29,2017,Myanmar,Malaysia,1,0,Friendly,in Myanmar,8,-8,1082,1090,4,-1,180,178,1074,1098,T1
7235,August 29,2017,Bahrain,Jordan,0,0,Friendly,in Bahrain,0,0,1402,1491,0,0,107,85,1402,1491,draw
7236,August 29,2017,United Arab Emirates,Saudi Arabia,2,1,World Cup qualifier,in the United Arab Emirates,18,-18,1564,1594,3,-6,71,63,1546,1612,T1
7237,August 30,2017,Oman,Afghanistan,2,0,Friendly,in Oman,2,-2,1448,1125,2,0,93,172,1446,1127,T1
7238,August 31,2017,Togo,Niger,2,0,Friendly,in Morocco,11,-11,1395,1278,3,-3,109,140,1384,1289,T1
7239,August 31,2017,Singapore,Hong Kong,1,1,Friendly,in Singapore,1,-1,1081,1200,0,0,182,165,1080,1201,draw
7240,August 31,2017,Thailand,Iraq,1,2,World Cup qualifier,in Thailand,-20,20,1397,1540,-2,5,107,75,1417,1520,T2
7241,August 31,2017,Syria,Qatar,3,1,World Cup qualifier,in Malaysia,28,-28,1598,1520,6,-7,62,80,1570,1548,T1
7242,August 31,2017,South Korea,Iran,0,0,World Cup qualifier,in South Korea,-2,2,1731,1795,0,2,34,22,1733,1793,draw
7243,August 31,2017,Japan,Australia,2,0,World Cup qualifier,in Japan,18,-18,1780,1703,3,-2,25,37,1762,1721,T1
7244,August 31,2017,China,Uzbekistan,1,0,World Cup qualifier,in China,19,-19,1566,1618,5,-3,69,55,1547,1637,T1
7245,August 31,2017,Uganda,Egypt,1,0,World Cup qualifier,in Uganda,24,-24,1516,1642,3,-1,81,50,1492,1666,T1
7246,August 31,2017,Guinea,Libya,3,2,World Cup qualifier,in Guinea,11,-11,1550,1452,2,-1,73,92,1539,1463,T1
7247,August 31,2017,Switzerland,Andorra,3,0,World Cup qualifier,in Switzerland,0,0,1865,1022,0,0,13,187,1865,1022,T1
7248,August 31,2017,Portugal,Faroe Islands,5,1,World Cup qualifier,in Portugal,1,-1,1979,1280,-1,1,6,138,1978,1281,T1
7249,August 31,2017,Luxembourg,Belarus,1,0,World Cup qualifier,in Luxembourg,32,-32,1279,1547,9,-9,139,74,1247,1579,T1
7250,August 31,2017,Hungary,Latvia,3,1,World Cup qualifier,in Hungary,8,-8,1628,1376,0,-5,54,117,1620,1384,T1
7251,August 31,2017,Greece,Estonia,0,0,World Cup qualifier,in Greece,-14,14,1665,1490,-2,1,48,86,1679,1476,draw
7252,August 31,2017,France,Netherlands,4,0,World Cup qualifier,in France,16,-16,1991,1833,1,-2,5,18,1975,1849,T1
7253,August 31,2017,Cyprus,Bosnia and Herzegovina,3,2,World Cup qualifier,in Cyprus,32,-32,1450,1722,11,-5,93,35,1418,1754,T1
7254,August 31,2017,Bulgaria,Sweden,3,2,World Cup qualifier,in Bulgaria,25,-25,1639,1784,3,-5,52,24,1614,1809,T1
7255,August 31,2017,Belgium,Gibraltar,9,0,World Cup qualifier,in Belgium,1,-1,1900,1089,1,-1,10,179,1899,1090,T1
7256,August 31,2017,Venezuela,Colombia,0,0,World Cup qualifier,in Venezuela,10,-10,1699,1961,2,-1,38,8,1689,1971,draw
7257,August 31,2017,Uruguay,Argentina,0,0,World Cup qualifier,in Uruguay,4,-4,1847,2014,2,0,16,3,1843,2018,draw
7258,August 31,2017,Peru,Bolivia,2,1,World Cup qualifier,in Peru,7,-7,1861,1679,0,-4,14,45,1854,1686,T1
7259,August 31,2017,Chile,Paraguay,0,3,World Cup qualifier,in Chile,-61,61,1885,1769,-2,9,11,28,1946,1708,T2
7260,August 31,2017,Brazil,Ecuador,2,0,World Cup qualifier,in Brazil,5,-5,2121,1799,0,0,1,21,2116,1804,T1
7261,September 1,2017,New Zealand,Solomon Islands,6,1,World Cup qualifier,in New Zealand,5,-5,1532,1165,1,-1,76,169,1527,1170,T1
7262,September 1,2017,Tunisia,Democratic Republic of Congo,2,1,World Cup qualifier,in Tunisia,16,-16,1594,1583,4,-4,62,65,1578,1599,T1
7263,September 1,2017,Nigeria,Cameroon,4,0,World Cup qualifier,in Nigeria,31,-31,1661,1639,6,-5,47,51,1630,1670,T1
7264,September 1,2017,Morocco,Mali,6,0,World Cup qualifier,in Morocco,23,-23,1625,1510,4,-6,55,82,1602,1533,T1
7265,September 1,2017,Ghana,Congo,1,1,World Cup qualifier,in Ghana,-13,13,1564,1421,-4,2,71,103,1577,1408,draw
7266,September 1,2017,Cape Verde,South Africa,2,1,World Cup qualifier,in Cape Verde,25,-25,1444,1576,8,-8,96,68,1419,1601,T1
7267,September 1,2017,Slovakia,Slovenia,1,0,World Cup qualifier,in Slovakia,9,-9,1776,1633,1,-3,28,53,1767,1642,T1
7268,September 1,2017,San Marino,Northern Ireland,0,3,World Cup qualifier,in San Marino,-1,1,858,1682,0,0,205,44,859,1681,T2
7269,September 1,2017,Romania,Armenia,1,0,World Cup qualifier,in Romania,7,-7,1690,1494,1,0,42,84,1683,1501,T1
7270,September 1,2017,Norway,Azerbaijan,2,0,World Cup qualifier,in Norway,12,-12,1579,1412,2,-3,66,105,1567,1424,T1
7271,September 1,2017,Malta,England,0,4,World Cup qualifier,in Malta,-2,2,1225,1914,0,0,155,9,1227,1912,T2
7272,September 1,2017,Lithuania,Scotland,0,3,World Cup qualifier,in Lithuania,-22,22,1426,1708,-6,4,100,37,1448,1686,T2
7273,September 1,2017,Kazakhstan,Montenegro,0,3,World Cup qualifier,in Kazakhstan,-23,23,1346,1621,-3,6,121,56,1369,1598,T2
7274,September 1,2017,Denmark,Poland,4,0,World Cup qualifier,in Denmark,41,-41,1780,1832,8,-6,25,18,1739,1873,T1
7275,September 1,2017,Czechia,Germany,1,2,World Cup qualifier,in Czechia,-6,6,1692,2105,-2,0,41,2,1698,2099,T2
7276,September 1,2017,United States,Costa Rica,0,2,World Cup qualifier,in the United States,-42,42,1763,1801,-12,10,31,20,1805,1759,T2
7277,September 1,2017,Trinidad and Tobago,Honduras,1,2,World Cup qualifier,in Trinidad and Tobago,-18,18,1413,1578,-4,5,104,67,1431,1560,T2
7278,September 1,2017,Mexico,Panama,1,0,World Cup qualifier,in Mexico,7,-7,1854,1660,2,-1,14,48,1847,1667,T1
7279,September 2,2017,Tanzania,Botswana,2,0,Friendly,in Tanzania,7,-7,1348,1233,1,-2,121,153,1341,1240,T1
7280,September 2,2017,Mozambique,Kenya,1,1,Friendly,in Mozambique,0,0,1301,1385,0,0,129,112,1301,1385,draw
7281,September 2,2017,Indonesia,Fiji,0,0,Friendly,in Indonesia,-3,3,1225,1215,0,0,154,159,1228,1212,draw
7282,September 2,2017,Zambia,Algeria,3,1,World Cup qualifier,in Zambia,36,-36,1475,1578,8,-7,90,65,1439,1614,T1
7283,September 2,2017,Senegal,Burkina Faso,0,0,World Cup qualifier,in Senegal,-10,10,1699,1620,-2,2,38,57,1709,1610,draw
7284,September 2,2017,Gabon,Ivory Coast,0,3,World Cup qualifier,in Gabon,-23,23,1409,1680,-6,4,105,45,1432,1657,T2
7285,September 2,2017,Wales,Austria,1,0,World Cup qualifier,in Wales,11,-11,1783,1684,6,-2,23,42,1772,1695,T1
7286,September 2,2017,Ukraine,Turkey,2,0,World Cup qualifier,in Ukraine,25,-25,1779,1769,6,-6,26,29,1754,1794,T1
7287,September 2,2017,Spain,Italy,3,0,World Cup qualifier,in Spain,22,-22,2026,1948,1,-1,3,8,2004,1970,T1
7288,September 2,2017,Serbia,Moldova,3,0,World Cup qualifier,in Serbia,4,-4,1745,1351,0,0,33,120,1741,1355,T1
7289,September 2,2017,Israel,Macedonia,0,1,World Cup qualifier,in Israel,-31,31,1534,1479,-7,5,77,89,1565,1448,T2
7290,September 2,2017,Georgia,Ireland,1,1,World Cup qualifier,in Georgia,11,-11,1481,1766,2,-4,88,31,1470,1777,draw
7291,September 2,2017,Finland,Iceland,1,0,World Cup qualifier,in Finland,29,-29,1556,1773,5,-9,72,28,1527,1802,T1
7292,September 2,2017,Albania,Liechtenstein,2,0,World Cup qualifier,in Albania,3,-3,1606,1163,1,-1,59,169,1603,1166,T1
7293,September 2,2017,Canada,Jamaica,2,0,Friendly,in Canada,14,-14,1537,1576,2,-3,76,67,1523,1590,T1
7294,September 3,2017,Equatorial Guinea,Benin,1,2,Friendly,in Equatorial Guinea,-11,11,1330,1407,-2,2,125,106,1341,1396,T2
7295,September 3,2017,Netherlands,Bulgaria,3,1,World Cup qualifier,in the Netherlands,9,-9,1842,1630,0,-2,17,53,1833,1639,T1
7296,September 3,2017,Latvia,Switzerland,0,3,World Cup qualifier,in Latvia,-7,7,1369,1872,0,0,117,12,1376,1865,T2
7297,September 3,2017,Hungary,Portugal,0,1,World Cup qualifier,in Hungary,-8,8,1620,1987,-2,1,56,5,1628,1979,T2
7298,September 3,2017,Greece,Belgium,1,2,World Cup qualifier,in Greece,-13,13,1652,1913,-2,0,49,10,1665,1900,T2
7299,September 3,2017,Gibraltar,Bosnia and Herzegovina,0,4,World Cup qualifier,in Portugal,-2,2,1087,1724,0,0,179,35,1089,1722,T2
7300,September 3,2017,France,Luxembourg,0,0,World Cup qualifier,in France,-20,20,1971,1299,-1,7,6,132,1991,1279,draw
7301,September 3,2017,Faroe Islands,Andorra,1,0,World Cup qualifier,in the Faroe Islands,5,-5,1285,1017,-1,0,139,187,1280,1022,T1
7302,September 3,2017,Estonia,Cyprus,1,0,World Cup qualifier,in Estonia,12,-12,1502,1438,3,-3,83,98,1490,1450,T1
7303,September 3,2017,Croatia,Kosovo,1,0,World Cup qualifier,in Croatia,1,-1,1852,1383,0,0,15,113,1851,1384,T1
7304,September 3,2017,Belarus,Sweden,0,4,World Cup qualifier,in Belarus,-23,23,1524,1807,-4,3,78,19,1547,1784,T2
7305,September 4,2017,Malawi,Togo,1,0,Friendly,in Morocco,13,-13,1304,1382,8,-4,129,113,1291,1395,T1
7306,September 4,2017,Libya,Guinea,1,0,World Cup qualifier,in Tunisia,25,-25,1477,1525,5,-4,89,77,1452,1550,T1
7307,September 4,2017,Cameroon,Nigeria,1,1,World Cup qualifier,in Cameroon,-4,4,1635,1665,-2,0,53,47,1639,1661,draw
7308,September 4,2017,Slovenia,Lithuania,4,0,World Cup qualifier,in Slovenia,11,-11,1644,1415,2,-3,50,102,1633,1426,T1
7309,September 4,2017,Scotland,Malta,2,0,World Cup qualifier,in Scotland,2,-2,1710,1223,0,-1,36,155,1708,1225,T1
7310,September 4,2017,Poland,Kazakhstan,3,0,World Cup qualifier,in Poland,2,-2,1834,1344,0,0,18,122,1832,1346,T1
7311,September 4,2017,Northern Ireland,Czechia,2,0,World Cup qualifier,in Northern Ireland,22,-22,1704,1670,7,-6,37,46,1682,1692,T1
7312,September 4,2017,Montenegro,Romania,1,0,World Cup qualifier,in Montenegro,18,-18,1639,1672,3,-4,52,45,1621,1690,T1
7313,September 4,2017,Germany,Norway,6,0,World Cup qualifier,in Germany,2,-2,2107,1577,0,-2,2,66,2105,1579,T1
7314,September 4,2017,England,Slovakia,2,1,World Cup qualifier,in England,8,-8,1922,1768,0,-3,9,30,1914,1776,T1
7315,September 4,2017,Azerbaijan,San Marino,5,1,World Cup qualifier,in Azerbaijan,2,-2,1414,856,1,0,103,205,1412,858,T1
7316,September 4,2017,Armenia,Denmark,1,4,World Cup qualifier,in Armenia,-18,18,1476,1798,-5,2,90,22,1494,1780,T2
7317,September 5,2017,Niger,Mauritania,2,0,Friendly,in Morocco,17,-17,1295,1315,5,-1,135,125,1278,1332,T1
7318,September 5,2017,Singapore,Turkmenistan,1,1,Asian Cup qualifier,in Singapore,4,-4,1085,1244,2,-2,180,149,1081,1248,draw
7319,September 5,2017,Philippines,Yemen,2,2,Asian Cup qualifier,in the Philippines,-7,7,1238,1217,-2,3,151,158,1245,1210,draw
7320,September 5,2017,Oman,Maldives,5,0,Asian Cup qualifier,in Oman,2,-2,1450,948,-1,-1,96,193,1448,950,T1
7321,September 5,2017,North Korea,Lebanon,2,2,Asian Cup qualifier,in North Korea,-10,10,1477,1404,-3,3,89,106,1487,1394,draw
7322,September 5,2017,Nepal,Tajikistan,1,2,Asian Cup qualifier,in Nepal,-10,10,894,1214,-1,3,201,161,904,1204,T2
7323,September 5,2017,Malaysia,Hong Kong,1,1,Asian Cup qualifier,in Malaysia,1,-1,1091,1199,0,0,178,165,1090,1200,draw
7324,September 5,2017,Macao,India,0,2,Asian Cup qualifier,in Macao,-6,6,666,1168,0,1,223,169,672,1162,T2
7325,September 5,2017,Jordan,Afghanistan,4,1,Asian Cup qualifier,in Jordan,4,-4,1495,1121,-1,-1,86,173,1491,1125,T1
7326,September 5,2017,Cambodia,Vietnam,1,2,Asian Cup qualifier,in Cambodia,-5,5,822,1280,0,1,208,141,827,1275,T2
7327,September 5,2017,Bhutan,Palestine,0,2,Asian Cup qualifier,in Bhutan,-1,1,594,1395,0,1,230,108,595,1394,T2
7328,September 5,2017,Bahrain,Taiwan,5,0,Asian Cup qualifier,in Bahrain,2,-2,1404,886,1,0,106,202,1402,888,T1
7329,September 5,2017,Solomon Islands,New Zealand,2,2,World Cup qualifier,in the Solomon Islands,13,-13,1178,1519,0,-2,168,78,1165,1532,draw
7330,September 5,2017,Uzbekistan,South Korea,0,0,World Cup qualifier,in Uzbekistan,1,-1,1619,1730,1,0,57,34,1618,1731,draw
7331,September 5,2017,Saudi Arabia,Japan,1,0,World Cup qualifier,in Saudi Arabia,25,-25,1619,1755,4,-6,57,31,1594,1780,T1
7332,September 5,2017,Qatar,China,1,2,World Cup qualifier,in Qatar,-23,23,1497,1589,-6,5,85,64,1520,1566,T2
7333,September 5,2017,Iraq,United Arab Emirates,1,0,World Cup qualifier,in Jordan,21,-21,1561,1543,3,-3,70,73,1540,1564,T1
7334,September 5,2017,Iran,Syria,2,2,World Cup qualifier,in Iran,-14,14,1781,1612,-2,0,25,60,1795,1598,draw
7335,September 5,2017,Australia,Thailand,2,1,World Cup qualifier,in Australia,4,-4,1707,1393,0,-1,38,109,1703,1397,T1
7336,September 5,2017,South Africa,Cape Verde,1,2,World Cup qualifier,in South Africa,-32,32,1544,1476,-5,5,72,91,1576,1444,T2
7337,September 5,2017,Mali,Morocco,0,0,World Cup qualifier,in Mali,1,-1,1511,1624,3,0,79,55,1510,1625,draw
7338,September 5,2017,Ivory Coast,Gabon,1,2,World Cup qualifier,in Ivory Coast,-36,36,1644,1445,-7,8,50,97,1680,1409,T2
7339,September 5,2017,Egypt,Uganda,1,0,World Cup qualifier,in Egypt,9,-9,1651,1507,2,-1,49,81,1642,1516,T1
7340,September 5,2017,Democratic Republic of Congo,Tunisia,2,2,World Cup qualifier,in the Democratic Republic of the Congo,-5,5,1578,1599,-3,-1,66,62,1583,1594,draw
7341,September 5,2017,Congo,Ghana,1,5,World Cup qualifier,in Congo,-33,33,1388,1597,-9,7,110,63,1421,1564,T2
7342,September 5,2017,Burkina Faso,Senegal,2,2,World Cup qualifier,in Burkina Faso,-1,1,1619,1700,-1,-2,57,41,1620,1699,draw
7343,September 5,2017,Algeria,Zambia,0,1,World Cup qualifier,in Algeria,-31,31,1547,1506,-7,9,71,82,1578,1475,T2
7344,September 5,2017,Turkey,Croatia,1,0,World Cup qualifier,in Turkey,19,-19,1788,1833,4,-3,24,18,1769,1852,T1
7345,September 5,2017,Moldova,Wales,0,2,World Cup qualifier,in Moldova,-8,8,1343,1791,-2,1,122,23,1351,1783,T2
7346,September 5,2017,Macedonia,Albania,1,1,World Cup qualifier,in Macedonia,2,-2,1481,1604,0,-2,88,61,1479,1606,draw
7347,September 5,2017,Liechtenstein,Spain,0,8,World Cup qualifier,in Liechtenstein,-1,1,1162,2027,-1,0,170,3,1163,2026,T2
7348,September 5,2017,Italy,Israel,1,0,World Cup qualifier,in Italy,2,-2,1950,1532,0,0,8,75,1948,1534,T1
7349,September 5,2017,Ireland,Serbia,0,1,World Cup qualifier,in Ireland,-27,27,1739,1772,-2,6,33,27,1766,1745,T2
7350,September 5,2017,Iceland,Ukraine,2,0,World Cup qualifier,in Iceland,22,-22,1795,1757,5,-4,22,30,1773,1779,T1
7351,September 5,2017,Finland,Kosovo,1,0,World Cup qualifier,in Albania,11,-11,1567,1372,3,-4,69,116,1556,1383,T1
7352,September 5,2017,Austria,Georgia,1,1,World Cup qualifier,in Austria,-14,14,1670,1495,-3,1,44,86,1684,1481,draw
7353,September 5,2017,Panama,Trinidad and Tobago,3,0,World Cup qualifier,in Panama,8,-8,1668,1405,2,-1,46,105,1660,1413,T1
7354,September 5,2017,Honduras,United States,1,1,World Cup qualifier,in Honduras,5,-5,1583,1758,-1,3,65,29,1578,1763,draw
7355,September 5,2017,Costa Rica,Mexico,1,1,World Cup qualifier,in Costa Rica,-3,3,1798,1857,0,-1,20,15,1801,1854,draw
7356,September 5,2017,Paraguay,Uruguay,1,2,World Cup qualifier,in Paraguay,-21,21,1748,1868,-4,3,32,13,1769,1847,T2
7357,September 5,2017,Ecuador,Peru,1,2,World Cup qualifier,in Ecuador,-22,22,1777,1883,-5,2,26,11,1799,1861,T2
7358,September 5,2017,Colombia,Brazil,1,1,World Cup qualifier,in Colombia,3,-3,1964,2118,0,0,7,1,1961,2121,draw
7359,September 5,2017,Bolivia,Chile,1,0,World Cup qualifier,in Bolivia,26,-26,1705,1859,5,-3,39,14,1679,1885,T1
7360,September 5,2017,Argentina,Venezuela,1,1,World Cup qualifier,in Argentina,-17,17,1997,1716,0,3,4,36,2014,1699,draw
7361,September 30,2017,Botswana,Ethiopia,2,0,Friendly,in Botswana,13,-13,1246,1282,5,-5,148,140,1233,1295,T1
7362,October 2,2017,Macao,Laos,3,1,Friendly,in Macao,17,-17,683,787,1,-2,222,212,666,804,T1
7363,October 4,2017,Uganda,Madagascar,1,2,Friendly,in Uganda,-16,16,1491,1376,-6,3,87,116,1507,1360,T2
7364,October 4,2017,Jordan,Oman,1,1,Friendly,in the United Arab Emirates,-1,1,1494,1451,0,0,86,96,1495,1450,draw
7365,October 4,2017,Indonesia,Cambodia,3,1,Friendly,in Indonesia,2,-2,1227,820,0,0,154,208,1225,822,T1
7366,October 5,2017,Taiwan,Mongolia,4,2,Friendly,in Taiwan,4,-4,890,653,0,0,202,224,886,657,T1
7367,October 5,2017,Qatar,Singapore,3,1,Friendly,in Qatar,1,-1,1498,1084,0,0,84,180,1497,1085,T1
7368,October 5,2017,Myanmar,Thailand,1,3,Friendly,in Myanmar,-7,7,1075,1400,-2,1,183,108,1082,1393,T2
7369,October 5,2017,Iraq,Kenya,2,1,Friendly,in Iraq,3,-3,1564,1382,0,0,70,111,1561,1385,T1
7370,October 5,2017,Iran,Togo,2,0,Friendly,in Iran,2,-2,1783,1380,0,-1,25,113,1781,1382,T1
7371,October 5,2017,Hong Kong,Laos,4,0,Friendly,in Hong Kong,2,-2,1201,785,0,0,165,212,1199,787,T1
7372,October 5,2017,Syria,Australia,1,1,World Cup qualifier,in Malaysia,5,-5,1617,1702,0,-1,60,39,1612,1707,draw
7373,October 5,2017,Scotland,Slovakia,1,0,World Cup qualifier,in Scotland,18,-18,1728,1750,2,-4,35,32,1710,1768,T1
7374,October 5,2017,San Marino,Norway,0,8,World Cup qualifier,in San Marino,-3,3,853,1580,0,1,205,66,856,1577,T2
7375,October 5,2017,Romania,Kazakhstan,3,1,World Cup qualifier,in Romania,5,-5,1677,1339,-1,-1,44,122,1672,1344,T1
7376,October 5,2017,Northern Ireland,Germany,1,3,World Cup qualifier,in Northern Ireland,-9,9,1695,2116,-1,1,41,1,1704,2107,T2
7377,October 5,2017,Montenegro,Denmark,0,1,World Cup qualifier,in Montenegro,-17,17,1622,1815,-3,1,55,19,1639,1798,T2
7378,October 5,2017,Malta,Lithuania,1,1,World Cup qualifier,in Malta,5,-5,1228,1410,1,0,154,102,1223,1415,draw
7379,October 5,2017,England,Slovenia,1,0,World Cup qualifier,in England,4,-4,1926,1640,0,-1,9,51,1922,1644,T1
7380,October 5,2017,Azerbaijan,Czechia,1,2,World Cup qualifier,in Azerbaijan,-12,12,1402,1682,-4,1,107,43,1414,1670,T2
7381,October 5,2017,Armenia,Poland,1,6,World Cup qualifier,in Armenia,-15,15,1461,1849,-3,1,94,16,1476,1834,T2
7382,October 5,2017,Venezuela,Uruguay,0,0,World Cup qualifier,in Venezuela,3,-3,1719,1865,-1,-1,37,14,1716,1868,draw
7383,October 5,2017,Colombia,Paraguay,1,2,World Cup qualifier,in Colombia,-34,34,1930,1782,-1,6,8,26,1964,1748,T2
7384,October 5,2017,Chile,Ecuador,2,1,World Cup qualifier,in Chile,10,-10,1869,1767,1,-2,13,28,1859,1777,T1
7385,October 5,2017,Bolivia,Brazil,0,0,World Cup qualifier,in Bolivia,14,-14,1719,2104,2,-1,37,2,1705,2118,draw
7386,October 5,2017,Argentina,Peru,0,0,World Cup qualifier,in Argentina,-11,11,1986,1894,-1,0,5,11,1997,1883,draw
7387,October 6,2017,Japan,New Zealand,2,1,Friendly,in Japan,3,-3,1758,1516,2,0,29,78,1755,1519,T1
7388,October 6,2017,Comoros,Mauritania,1,0,Friendly,in Tunisia,17,-17,1031,1298,2,-8,186,133,1014,1315,T1
7389,October 6,2017,Mali,Ivory Coast,0,0,World Cup qualifier,in Mali,2,-2,1513,1642,0,0,79,50,1511,1644,draw
7390,October 6,2017,Turkey,Iceland,0,3,World Cup qualifier,in Turkey,-44,44,1744,1839,-8,4,32,18,1788,1795,T2
7391,October 6,2017,Spain,Albania,3,0,World Cup qualifier,in Spain,3,-3,2030,1601,0,0,3,61,2027,1604,T1
7392,October 6,2017,Liechtenstein,Israel,0,1,World Cup qualifier,in Liechtenstein,-7,7,1155,1539,-1,1,171,74,1162,1532,T2
7393,October 6,2017,Kosovo,Ukraine,0,2,World Cup qualifier,in Albania,-6,6,1366,1763,-1,2,118,28,1372,1757,T2
7394,October 6,2017,Italy,Macedonia,1,1,World Cup qualifier,in Italy,-19,19,1931,1500,0,4,7,84,1950,1481,draw
7395,October 6,2017,Ireland,Moldova,2,0,World Cup qualifier,in Ireland,3,-3,1742,1340,0,0,33,121,1739,1343,T1
7396,October 6,2017,Georgia,Wales,0,1,World Cup qualifier,in Georgia,-10,10,1485,1801,-3,1,88,22,1495,1791,T2
7397,October 6,2017,Croatia,Finland,1,1,World Cup qualifier,in Croatia,-16,16,1817,1583,-1,4,19,65,1833,1567,draw
7398,October 6,2017,Austria,Serbia,3,2,World Cup qualifier,in Austria,20,-20,1690,1752,3,-3,42,30,1670,1772,T1
7399,October 6,2017,United States,Panama,4,0,World Cup qualifier,in the United States,19,-19,1777,1649,3,-3,26,49,1758,1668,T1
7400,October 6,2017,Mexico,Trinidad and Tobago,3,1,World Cup qualifier,in Mexico,2,-2,1859,1403,0,-2,15,106,1857,1405,T1
7401,October 7,2017,Tanzania,Malawi,1,1,Friendly,in Tanzania,-4,4,1344,1308,0,1,120,127,1348,1304,draw
7402,October 7,2017,Saudi Arabia,Jamaica,5,2,Friendly,in Saudi Arabia,11,-11,1630,1565,2,-1,55,70,1619,1576,T1
7403,October 7,2017,Russia,South Korea,4,2,Friendly,in Russia,13,-13,1697,1717,2,-4,41,38,1684,1730,T1
7404,October 7,2017,Uganda,Ghana,0,0,World Cup qualifier,in Uganda,0,0,1491,1597,1,1,86,62,1491,1597,draw
7405,October 7,2017,South Africa,Burkina Faso,3,1,World Cup qualifier,in South Africa,28,-28,1572,1591,3,-8,69,65,1544,1619,T1
7406,October 7,2017,Nigeria,Zambia,1,0,World Cup qualifier,in Nigeria,7,-7,1672,1499,0,-2,46,83,1665,1506,T1
7407,October 7,2017,Morocco,Gabon,3,0,World Cup qualifier,in Morocco,12,-12,1636,1433,0,-1,54,98,1624,1445,T1
7408,October 7,2017,Libya,Democratic Republic of Congo,1,2,World Cup qualifier,in Tunisia,-14,14,1463,1592,-3,4,92,64,1477,1578,T2
7409,October 7,2017,Guinea,Tunisia,1,4,World Cup qualifier,in Guinea,-38,38,1487,1637,-11,9,87,53,1525,1599,T2
7410,October 7,2017,Cape Verde,Senegal,0,2,World Cup qualifier,in Cape Verde,-20,20,1456,1720,-3,5,94,35,1476,1700,T2
7411,October 7,2017,Cameroon,Algeria,2,0,World Cup qualifier,in Cameroon,15,-15,1650,1532,3,-4,49,75,1635,1547,T1
7412,October 7,2017,Switzerland,Hungary,5,2,World Cup qualifier,in Switzerland,8,-8,1880,1612,0,-4,12,60,1872,1620,T1
7413,October 7,2017,Sweden,Luxembourg,8,0,World Cup qualifier,in Sweden,3,-3,1810,1296,0,-1,21,133,1807,1299,T1
7414,October 7,2017,Gibraltar,Estonia,0,6,World Cup qualifier,in Portugal,-7,7,1080,1509,-2,2,181,80,1087,1502,T2
7415,October 7,2017,Faroe Islands,Latvia,0,0,World Cup qualifier,in the Faroe Islands,-1,1,1284,1370,0,0,139,117,1285,1369,draw
7416,October 7,2017,Cyprus,Greece,1,2,World Cup qualifier,in Cyprus,-14,14,1424,1666,-1,0,100,47,1438,1652,T2
7417,October 7,2017,Bulgaria,France,0,1,World Cup qualifier,in Bulgaria,-8,8,1622,1979,-3,0,56,6,1630,1971,T2
7418,October 7,2017,Bosnia and Herzegovina,Belgium,3,4,World Cup qualifier,in Bosnia and Herzegovina,-15,15,1709,1928,-3,1,39,9,1724,1913,T2
7419,October 7,2017,Belarus,Netherlands,1,3,World Cup qualifier,in Belarus,-13,13,1511,1855,-1,1,78,16,1524,1842,T2
7420,October 7,2017,Andorra,Portugal,0,2,World Cup qualifier,in Andorra,0,0,1017,1987,0,0,188,4,1017,1987,T2
7421,October 7,2017,Grenada,Guyana,1,0,Friendly,in Grenada,10,-10,1111,1188,1,-1,174,167,1101,1198,T1
7422,October 7,2017,Costa Rica,Honduras,1,1,World Cup qualifier,in Costa Rica,-14,14,1784,1597,0,3,23,62,1798,1583,draw
7423,October 8,2017,Thailand,Kenya,1,0,Friendly,in Thailand,7,-7,1407,1375,6,-5,102,116,1400,1382,T1
7424,October 8,2017,El Salvador,Canada,1,0,Friendly,in the United States,13,-13,1457,1524,3,-1,94,75,1444,1537,T1
7425,October 8,2017,Egypt,Congo,2,1,World Cup qualifier,in Egypt,4,-4,1655,1384,0,0,48,110,1651,1388,T1
7426,October 8,2017,Slovenia,Scotland,2,2,World Cup qualifier,in Slovenia,-1,1,1639,1729,0,0,52,34,1640,1728,draw
7427,October 8,2017,Slovakia,Malta,3,0,World Cup qualifier,in Slovakia,2,-2,1752,1226,1,-1,30,155,1750,1228,T1
7428,October 8,2017,Poland,Montenegro,4,2,World Cup qualifier,in Poland,8,-8,1857,1614,1,-3,16,59,1849,1622,T1
7429,October 8,2017,Norway,Northern Ireland,1,0,World Cup qualifier,in Norway,21,-21,1601,1674,7,-3,61,45,1580,1695,T1
7430,October 8,2017,Lithuania,England,0,1,World Cup qualifier,in Lithuania,-3,3,1407,1929,0,1,102,9,1410,1926,T2
7431,October 8,2017,Kazakhstan,Armenia,1,1,World Cup qualifier,in Kazakhstan,1,-1,1340,1460,1,0,121,93,1339,1461,draw
7432,October 8,2017,Germany,Azerbaijan,5,1,World Cup qualifier,in Germany,1,-1,2117,1401,0,-1,1,108,2116,1402,T1
7433,October 8,2017,Denmark,Romania,1,1,World Cup qualifier,in Denmark,-12,12,1803,1689,-1,2,21,43,1815,1677,draw
7434,October 8,2017,Czechia,San Marino,5,0,World Cup qualifier,in Czechia,0,0,1682,853,0,0,44,205,1682,853,T1
7435,October 9,2017,Equatorial Guinea,Mauritius,3,1,Friendly,in Equatorial Guinea,3,-3,1333,1072,2,-1,122,184,1330,1075,T1
7436,October 9,2017,Wales,Ireland,0,1,World Cup qualifier,in Wales,-29,29,1772,1771,-4,6,26,27,1801,1742,T2
7437,October 9,2017,Ukraine,Croatia,0,2,World Cup qualifier,in Ukraine,-34,34,1729,1851,-5,1,33,18,1763,1817,T2
7438,October 9,2017,Serbia,Georgia,1,0,World Cup qualifier,in Serbia,4,-4,1756,1481,0,0,30,88,1752,1485,T1
7439,October 9,2017,Moldova,Austria,0,1,World Cup qualifier,in Moldova,-8,8,1332,1698,-3,1,124,41,1340,1690,T2
7440,October 9,2017,Macedonia,Liechtenstein,4,0,World Cup qualifier,in Macedonia,5,-5,1505,1150,1,0,81,171,1500,1155,T1
7441,October 9,2017,Israel,Spain,0,1,World Cup qualifier,in Israel,-4,4,1535,2034,0,0,73,3,1539,2030,T2
7442,October 9,2017,Iceland,Kosovo,2,0,World Cup qualifier,in Iceland,2,-2,1841,1364,-1,0,19,118,1839,1366,T1
7443,October 9,2017,Finland,Turkey,2,2,World Cup qualifier,in Finland,3,-3,1586,1741,0,0,68,32,1583,1744,draw
7444,October 9,2017,Albania,Italy,0,1,World Cup qualifier,in Albania,-8,8,1593,1939,-3,0,64,7,1601,1931,T2
7445,October 10,2017,Saudi Arabia,Ghana,0,3,Friendly,in Saudi Arabia,-24,24,1606,1621,-7,6,62,56,1630,1597,T2
7446,October 10,2017,Russia,Iran,1,1,Friendly,in Russia,0,0,1697,1783,0,1,42,22,1697,1783,draw
7447,October 10,2017,Qatar,Curaçao,1,2,Friendly,in Qatar,-18,18,1480,1266,-4,3,88,144,1498,1248,T2
7448,October 10,2017,Mozambique,Cape Verde,1,0,Friendly,in Portugal,14,-14,1315,1442,4,-1,125,96,1301,1456,T1
7449,October 10,2017,Morocco,South Korea,3,1,Friendly,in Switzerland,18,-18,1654,1699,4,-2,50,40,1636,1717,T1
7450,October 10,2017,Japan,Haiti,3,3,Friendly,in Japan,-8,8,1750,1481,0,5,29,86,1758,1473,draw
7451,October 10,2017,Benin,Gabon,1,0,Friendly,in France,11,-11,1418,1422,-2,-4,104,102,1407,1433,T1
7452,October 10,2017,Vietnam,Cambodia,5,0,Asian Cup qualifier,in Vietnam,3,-3,1283,817,2,0,139,208,1280,820,T1
7453,October 10,2017,Turkmenistan,Singapore,2,1,Asian Cup qualifier,in Turkmenistan,7,-7,1251,1077,2,-1,148,180,1244,1084,T1
7454,October 10,2017,Tajikistan,Nepal,3,0,Asian Cup qualifier,in Tajikistan,6,-6,1220,888,4,-1,157,202,1214,894,T1
7455,October 10,2017,Taiwan,Bahrain,2,1,Asian Cup qualifier,in Taiwan,37,-37,927,1367,4,-12,198,117,890,1404,T1
7456,October 10,2017,Philippines,Yemen,1,1,Asian Cup qualifier,in Qatar,-1,1,1237,1218,-1,-1,153,159,1238,1217,draw
7457,October 10,2017,Palestine,Bhutan,10,0,Asian Cup qualifier,in Palestine,1,-1,1396,593,1,-1,108,231,1395,594,T1
7458,October 10,2017,Myanmar,Kyrgyzstan,2,2,Asian Cup qualifier,in Myanmar,2,-2,1077,1204,3,-2,180,165,1075,1206,draw
7459,October 10,2017,Maldives,Oman,1,3,Asian Cup qualifier,in the Maldives,-5,5,943,1456,-3,3,196,94,948,1451,T2
7460,October 10,2017,Lebanon,North Korea,5,0,Asian Cup qualifier,in Lebanon,37,-37,1441,1440,8,-9,97,98,1404,1477,T1
7461,October 10,2017,Hong Kong,Malaysia,2,0,Asian Cup qualifier,in Hong Kong,14,-14,1215,1077,4,-2,161,180,1201,1091,T1
7462,October 10,2017,Afghanistan,Jordan,3,3,Asian Cup qualifier,in Tajikistan,16,-16,1137,1478,1,-4,172,89,1121,1494,draw
7463,October 10,2017,Australia,Syria,2,1,World Cup qualifier,in Australia,10,-10,1712,1607,2,-3,38,61,1702,1617,T1
7464,October 10,2017,Portugal,Switzerland,2,0,World Cup qualifier,in Portugal,14,-14,2001,1866,-1,-2,5,14,1987,1880,T1
7465,October 10,2017,Netherlands,Sweden,2,0,World Cup qualifier,in the Netherlands,18,-18,1873,1792,4,-1,13,21,1855,1810,T1
7466,October 10,2017,Luxembourg,Bulgaria,1,1,World Cup qualifier,in Luxembourg,11,-11,1307,1611,4,-4,129,60,1296,1622,draw
7467,October 10,2017,Latvia,Andorra,4,0,World Cup qualifier,in Latvia,5,-5,1375,1012,2,0,115,188,1370,1017,T1
7468,October 10,2017,Hungary,Faroe Islands,1,0,World Cup qualifier,in Hungary,3,-3,1615,1281,2,-2,58,141,1612,1284,T1
7469,October 10,2017,Greece,Gibraltar,4,0,World Cup qualifier,in Greece,1,-1,1667,1079,-1,2,48,179,1666,1080,T1
7470,October 10,2017,France,Belarus,2,1,World Cup qualifier,in France,1,-1,1980,1510,0,-1,6,79,1979,1511,T1
7471,October 10,2017,Estonia,Bosnia and Herzegovina,1,2,World Cup qualifier,in Estonia,-14,14,1495,1723,-3,3,83,36,1509,1709,T2
7472,October 10,2017,Belgium,Cyprus,4,0,World Cup qualifier,in Belgium,2,-2,1930,1422,1,-2,9,102,1928,1424,T1
7473,October 10,2017,Trinidad and Tobago,United States,2,1,World Cup qualifier,in Trinidad and Tobago,33,-33,1436,1744,8,-7,99,32,1403,1777,T1
7474,October 10,2017,Panama,Costa Rica,2,1,World Cup qualifier,in Panama,22,-22,1671,1762,3,-3,47,25,1649,1784,T1
7475,October 10,2017,Honduras,Mexico,3,2,World Cup qualifier,in Honduras,29,-29,1626,1830,7,-4,55,19,1597,1859,T1
7476,October 10,2017,Uruguay,Bolivia,4,2,World Cup qualifier,in Uruguay,12,-12,1877,1707,2,-3,12,39,1865,1719,T1
7477,October 10,2017,Peru,Colombia,1,1,World Cup qualifier,in Peru,-4,4,1890,1934,0,0,11,8,1894,1930,draw
7478,October 10,2017,Paraguay,Venezuela,0,1,World Cup qualifier,in Paraguay,-29,29,1753,1748,-3,6,27,30,1782,1719,T2
7479,October 10,2017,Ecuador,Argentina,1,3,World Cup qualifier,in Ecuador,-20,20,1747,2006,-3,1,31,4,1767,1986,T2
7480,October 10,2017,Brazil,Chile,3,0,World Cup qualifier,in Brazil,9,-9,2113,1860,0,-2,2,15,2104,1869,T1
7481,October 11,2017,India,Macao,4,1,Asian Cup qualifier,in India,2,-2,1170,681,0,0,169,222,1168,683,T1
7482,October 24,2017,Grenada,Panama,0,5,Friendly,in Grenada,-3,3,1108,1674,0,2,174,45,1111,1671,T2
7483,October 28,2017,Bermuda,Barbados,2,3,Friendly,in Bermuda,-15,15,1196,1138,-2,1,165,172,1211,1123,T2
7484,November 7,2017,Saudi Arabia,Latvia,2,0,Friendly,in Portugal,6,-6,1612,1369,2,-1,60,116,1606,1375,T1
7485,November 8,2017,Nicaragua,Dominican Republic,0,3,Friendly,in Nicaragua,-26,26,1275,1242,-11,9,142,151,1301,1216,T2
7486,November 8,2017,Lesotho,Zimbabwe,1,0,Friendly,in Lesotho,14,-14,1266,1488,2,-3,144,84,1252,1502,T1
7487,November 8,2017,Congo,Benin,1,1,Friendly,in Congo,-2,2,1382,1420,0,0,109,104,1384,1418,draw
7488,November 8,2017,Czechia,Iceland,2,1,Friendly tournament,in Qatar,21,-21,1703,1820,4,-1,40,19,1682,1841,T1
7489,November 9,2017,Singapore,Lebanon,0,1,Friendly,in Singapore,-4,4,1073,1445,-3,1,183,96,1077,1441,T2
7490,November 9,2017,Scotland,Netherlands,0,1,Friendly,in Scotland,-9,9,1720,1882,-2,1,36,12,1729,1873,T2
7491,November 9,2017,Romania,Turkey,2,0,Friendly,in Romania,13,-13,1702,1728,3,-1,41,34,1689,1741,T1
7492,November 9,2017,Luxembourg,Hungary,2,1,Friendly,in Luxembourg,15,-15,1322,1600,4,-5,125,63,1307,1615,T1
7493,November 9,2017,Iran,Panama,2,1,Friendly,in Austria,7,-7,1790,1667,0,-1,22,46,1783,1674,T1
7494,November 9,2017,Hong Kong,Bahrain,0,2,Friendly,in Hong Kong,-13,13,1202,1380,-3,6,164,111,1215,1367,T2
7495,November 9,2017,Finland,Estonia,3,0,Friendly,in Finland,9,-9,1595,1486,4,-3,64,85,1586,1495,T1
7496,November 9,2017,Cambodia,Myanmar,1,2,Friendly,in Cambodia,-6,6,811,1083,0,2,208,178,817,1077,T2
7497,November 9,2017,Armenia,Belarus,4,1,Friendly,in Armenia,15,-15,1475,1495,2,-2,90,81,1460,1510,T1
7498,November 9,2017,Northern Ireland,Switzerland,0,1,World Cup qualifier,in Northern Ireland,-15,15,1659,1881,-2,1,47,13,1674,1866,T2
7499,November 9,2017,Croatia,Greece,4,1,World Cup qualifier,in Croatia,11,-11,1862,1656,2,0,15,48,1851,1667,T1
7500,November 10,2017,Ukraine,Slovakia,2,1,Friendly,in Ukraine,8,-8,1737,1744,-1,-4,34,32,1729,1752,T1
7501,November 10,2017,United Arab Emirates,Haiti,0,1,Friendly,in the United Arab Emirates,-14,14,1529,1495,-2,5,74,81,1543,1481,T2
7502,November 10,2017,South Korea,Colombia,2,1,Friendly,in South Korea,14,-14,1713,1920,4,-1,38,9,1699,1934,T1
7503,November 10,2017,Portugal,Saudi Arabia,3,0,Friendly,in Portugal,2,-2,2003,1610,0,-1,5,60,2001,1612,T1
7504,November 10,2017,Poland,Uruguay,0,0,Friendly,in Poland,-2,2,1855,1879,0,0,17,14,1857,1877,draw
7505,November 10,2017,Georgia,Cyprus,1,0,Friendly,in Georgia,6,-6,1487,1416,1,-2,85,104,1481,1422,T1
7506,November 10,2017,France,Wales,2,0,Friendly,in France,4,-4,1984,1768,0,-1,6,24,1980,1772,T1
7507,November 10,2017,England,Germany,0,0,Friendly,in England,2,-2,1931,2115,3,-1,7,2,1929,2117,draw
7508,November 10,2017,China,Serbia,0,2,Friendly,in China,-12,12,1577,1768,0,2,68,24,1589,1756,T2
7509,November 10,2017,Brazil,Japan,3,1,Friendly,in France,3,-3,2116,1747,1,0,1,29,2113,1750,T1
7510,November 10,2017,Belgium,Mexico,3,3,Friendly,in Belgium,-5,5,1925,1835,1,0,8,18,1930,1830,draw
7511,November 10,2017,North Korea,Malaysia,4,1,Asian Cup qualifier,in Thailand,8,-8,1448,1069,2,-3,96,184,1440,1077,T1
7512,November 10,2017,South Africa,Senegal,0,2,World Cup qualifier,in South Africa,-26,26,1546,1746,-2,5,71,31,1572,1720,T2
7513,November 10,2017,Algeria,Nigeria,1,1,World Cup qualifier,in Algeria,2,-2,1534,1670,1,0,73,45,1532,1672,draw
7514,November 10,2017,Sweden,Italy,1,0,World Cup qualifier,in Sweden,23,-23,1815,1916,1,-3,20,10,1792,1939,T1
7515,November 10,2017,Honduras,Australia,0,0,World Cup qualifier,in Honduras,-1,1,1625,1713,0,0,55,38,1626,1712,draw
7516,November 11,2017,Namibia,Zimbabwe,3,1,Friendly,in Namibia,16,-16,1377,1472,5,-7,114,91,1361,1488,T1
7517,November 11,2017,Malawi,Lesotho,1,1,Friendly,in Malawi,-4,4,1304,1270,-1,2,130,142,1308,1266,draw
7518,November 11,2017,Comoros,Madagascar,1,1,Friendly,in France,8,-8,1039,1368,0,-3,186,118,1031,1376,draw
7519,November 11,2017,Trinidad and Tobago,Grenada,2,2,Friendly,in Trinidad and Tobago,-8,8,1428,1116,0,0,99,174,1436,1108,draw
7520,November 11,2017,Spain,Costa Rica,5,0,Friendly,in Spain,4,-4,2038,1758,0,0,3,26,2034,1762,T1
7521,November 11,2017,Russia,Argentina,0,1,Friendly,in Russia,-5,5,1692,2011,0,0,44,4,1697,2006,T2
7522,November 11,2017,Macedonia,Norway,2,0,Friendly,in Macedonia,15,-15,1520,1586,2,-5,77,67,1505,1601,T1
7523,November 11,2017,Dominican Republic,Nicaragua,1,0,Friendly,in the Dominican Republic,8,-8,1250,1267,2,-1,149,143,1242,1275,T1
7524,November 11,2017,Qatar,Czechia,0,1,Friendly tournament,in Qatar,-10,10,1470,1713,-4,3,92,38,1480,1703,T2
7525,November 11,2017,New Zealand,Peru,0,0,World Cup qualifier,in New Zealand,13,-13,1529,1877,2,-3,74,14,1516,1890,draw
7526,November 11,2017,Zambia,Cameroon,2,2,World Cup qualifier,in Zambia,3,-3,1502,1647,0,0,80,51,1499,1650,draw
7527,November 11,2017,Tunisia,Libya,0,0,World Cup qualifier,in Tunisia,-13,13,1624,1476,0,5,54,87,1637,1463,draw
7528,November 11,2017,Ivory Coast,Morocco,0,2,World Cup qualifier,in Ivory Coast,-37,37,1605,1691,-10,5,62,45,1642,1654,T2
7529,November 11,2017,Gabon,Mali,0,0,World Cup qualifier,in Gabon,-1,1,1421,1514,0,-1,102,78,1422,1513,draw
7530,November 11,2017,Democratic Republic of Congo,Guinea,3,1,World Cup qualifier,in the Democratic Republic of the Congo,14,-14,1606,1473,5,-5,61,90,1592,1487,T1
7531,November 11,2017,Denmark,Ireland,0,0,World Cup qualifier,in Denmark,-7,7,1796,1778,0,0,21,23,1803,1771,draw
7532,November 12,2017,Togo,Mauritius,6,0,Friendly,in Togo,4,-4,1384,1068,2,-1,109,184,1380,1072,T1
7533,November 12,2017,Benin,Tanzania,1,1,Friendly,in Benin,-5,5,1415,1349,-1,0,104,120,1420,1344,draw
7534,November 12,2017,Malta,Estonia,0,3,Friendly,in Malta,-10,10,1216,1496,-4,4,160,81,1226,1486,T2
7535,November 12,2017,Ghana,Egypt,1,1,World Cup qualifier,in Ghana,-4,4,1617,1659,-1,0,56,50,1621,1655,draw
7536,November 12,2017,Congo,Uganda,1,1,World Cup qualifier,in Congo,1,-1,1383,1490,-1,-1,110,84,1382,1491,draw
7537,November 12,2017,Switzerland,Northern Ireland,0,0,World Cup qualifier,in Switzerland,-15,15,1866,1674,-2,2,14,46,1881,1659,draw
7538,November 12,2017,Greece,Croatia,0,0,World Cup qualifier,in Greece,6,-6,1662,1856,0,-1,49,16,1656,1862,draw
7539,November 13,2017,Turkey,Albania,2,3,Friendly,in Turkey,-16,16,1712,1609,-5,6,40,59,1728,1593,T2
7540,November 13,2017,Poland,Mexico,0,1,Friendly,in Poland,-13,13,1842,1848,-1,1,18,17,1855,1835,T2
7541,November 13,2017,Kosovo,Latvia,4,3,Friendly,in Kosovo,7,-7,1371,1362,2,-2,117,119,1364,1369,T1
7542,November 13,2017,Iraq,Syria,1,1,Friendly,in Iraq,-2,2,1562,1609,0,1,70,59,1564,1607,draw
7543,November 13,2017,Iran,Venezuela,1,0,Friendly,in the Netherlands,9,-9,1799,1739,1,-5,21,33,1790,1748,T1
7544,November 13,2017,Georgia,Belarus,2,2,Friendly,in Georgia,-3,3,1484,1498,0,1,85,81,1487,1495,draw
7545,November 13,2017,Bulgaria,Saudi Arabia,1,0,Friendly,in Portugal,10,-10,1621,1600,3,-4,55,63,1611,1610,T1
7546,November 13,2017,Armenia,Cyprus,3,2,Friendly,in Armenia,6,-6,1481,1410,2,-1,86,104,1475,1416,T1
7547,November 13,2017,North Korea,Malaysia,4,1,Asian Cup qualifier,in Thailand,7,-7,1455,1062,1,-2,95,185,1448,1069,T1
7548,November 13,2017,Italy,Sweden,0,0,World Cup qualifier,in Italy,-10,10,1906,1825,0,1,10,19,1916,1815,draw
7549,November 14,2017,Wales,Panama,1,1,Friendly,in Wales,-5,5,1763,1672,0,0,24,48,1768,1667,draw
7550,November 14,2017,United Arab Emirates,Uzbekistan,1,0,Friendly,in the United Arab Emirates,10,-10,1539,1609,2,-3,72,59,1529,1619,T1
7551,November 14,2017,Trinidad and Tobago,Guyana,1,1,Friendly,in Trinidad and Tobago,-8,8,1420,1196,-2,3,101,164,1428,1188,draw
7552,November 14,2017,South Korea,Serbia,1,1,Friendly,in South Korea,-1,1,1712,1769,-2,1,39,23,1713,1768,draw
7553,November 14,2017,Slovakia,Norway,1,0,Friendly,in Slovakia,4,-4,1748,1582,3,0,28,67,1744,1586,T1
7554,November 14,2017,Russia,Spain,3,3,Friendly,in Russia,6,-6,1698,2032,1,0,43,3,1692,2038,draw
7555,November 14,2017,Romania,Netherlands,0,3,Friendly,in Romania,-14,14,1688,1896,-4,0,46,11,1702,1882,T2
7556,November 14,2017,Portugal,United States,1,1,Friendly,in Portugal,-8,8,1995,1752,1,5,4,26,2003,1744,draw
7557,November 14,2017,Nigeria,Argentina,4,2,Friendly,in Russia,26,-26,1696,1985,3,-2,44,6,1670,2011,T1
7558,November 14,2017,Hungary,Costa Rica,1,0,Friendly,in Hungary,12,-12,1612,1746,5,-4,58,30,1600,1758,T1
7559,November 14,2017,Germany,France,2,2,Friendly,in Germany,-6,6,2109,1990,0,1,2,5,2115,1984,draw
7560,November 14,2017,Gabon,Botswana,0,0,Friendly,in Gabon,-7,7,1414,1253,-1,2,103,148,1421,1246,draw
7561,November 14,2017,England,Brazil,0,0,Friendly,in England,2,-2,1933,2114,0,0,7,1,1931,2116,draw
7562,November 14,2017,China,Colombia,0,4,Friendly,in China,-7,7,1570,1927,0,0,68,9,1577,1920,T2
7563,November 14,2017,Belgium,Japan,1,0,Friendly,in Belgium,3,-3,1928,1744,0,-3,8,31,1925,1747,T1
7564,November 14,2017,Austria,Uruguay,2,1,Friendly,in Austria,12,-12,1710,1867,2,-1,41,13,1698,1879,T1
7565,November 14,2017,Algeria,Central African Republic,3,0,Friendly,in Algeria,4,-4,1538,1297,0,-1,73,132,1534,1301,T1
7566,November 14,2017,Qatar,Iceland,1,1,Friendly tournament,in Qatar,9,-9,1479,1811,5,-1,87,21,1470,1820,draw
7567,November 14,2017,Vietnam,Afghanistan,0,0,Asian Cup qualifier,in Vietnam,-12,12,1271,1149,-3,1,141,172,1283,1137,draw
7568,November 14,2017,Turkmenistan,Taiwan,2,1,Asian Cup qualifier,in Turkmenistan,3,-3,1254,924,1,0,147,198,1251,927,T1
7569,November 14,2017,Tajikistan,Yemen,0,0,Asian Cup qualifier,in Tajikistan,-6,6,1214,1224,-4,3,161,156,1220,1218,draw
7570,November 14,2017,Singapore,Bahrain,0,3,Asian Cup qualifier,in Singapore,-16,16,1057,1396,-3,3,185,109,1073,1380,T2
7571,November 14,2017,Palestine,Maldives,8,1,Asian Cup qualifier,in Palestine,4,-4,1400,939,0,0,108,196,1396,943,T1
7572,November 14,2017,Nepal,Philippines,0,0,Asian Cup qualifier,in Nepal,12,-12,900,1225,0,-1,202,155,888,1237,draw
7573,November 14,2017,Macao,Kyrgyzstan,3,4,Asian Cup qualifier,in Macao,-3,3,678,1207,0,1,222,162,681,1204,T2
7574,November 14,2017,India,Myanmar,2,2,Asian Cup qualifier,in India,-10,10,1160,1093,0,1,169,177,1170,1083,draw
7575,November 14,2017,Hong Kong,Lebanon,0,1,Asian Cup qualifier,in Hong Kong,-12,12,1190,1457,-3,4,167,93,1202,1445,T2
7576,November 14,2017,Cambodia,Jordan,0,1,Asian Cup qualifier,in Cambodia,-1,1,810,1479,0,0,208,87,811,1478,T2
7577,November 14,2017,Bhutan,Oman,2,4,Asian Cup qualifier,in Bhutan,-1,1,592,1457,0,1,231,93,593,1456,T2
7578,November 14,2017,Senegal,South Africa,2,1,World Cup qualifier,in Senegal,6,-6,1752,1540,4,0,26,71,1746,1546,T1
7579,November 14,2017,Burkina Faso,Cape Verde,4,0,World Cup qualifier,in Burkina Faso,14,-14,1605,1428,3,0,63,98,1591,1442,T1
7580,November 14,2017,Ireland,Denmark,1,5,World Cup qualifier,in Ireland,-46,46,1732,1842,-11,4,34,18,1778,1796,T2
7581,November 15,2017,Australia,Honduras,3,1,World Cup qualifier,in Australia,15,-15,1728,1610,2,-5,35,58,1713,1625,T1
7582,November 15,2017,Peru,New Zealand,2,0,World Cup qualifier,in Peru,4,-4,1881,1525,0,0,12,75,1877,1529,T1
7583,November 19,2017,Fiji,Estonia,0,2,Friendly,in Fiji,-8,8,1207,1504,-1,2,161,80,1215,1496,T2
7584,November 23,2017,Vanuatu,Estonia,0,1,Friendly,in Vanuatu,-5,5,1188,1509,-1,0,167,80,1193,1504,T2
7585,November 25,2017,Indonesia,Guyana,2,1,Friendly,in Indonesia,6,-6,1233,1190,0,-1,154,165,1227,1196,T1
7586,November 26,2017,New Caledonia,Estonia,1,1,Friendly,in New Caledonia,2,-2,1335,1507,0,0,122,80,1333,1509,draw
7587,December 1,2017,Philippines,Laos,3,1,Friendly tournament,in Taiwan,3,-3,1228,782,0,0,155,212,1225,785,T1
7588,December 2,2017,Vanuatu,New Caledonia,2,1,Pacific Mini Games,in Vanuatu,23,-23,1211,1312,5,-5,162,127,1188,1335,T1
7589,December 2,2017,Solomon Islands,Tonga,8,0,Pacific Mini Games,in Vanuatu,3,-3,1181,561,0,-2,168,234,1178,564,T1
7590,December 2,2017,Fiji,Tuvalu,8,0,Pacific Mini Games,in Vanuatu,6,-6,1213,720,0,-1,161,215,1207,726,T1
7591,December 2,2017,Saint Kitts and Nevis,Grenada,1,0,Friendly,in Saint Kitts and Nevis,4,-4,1256,1112,3,0,146,174,1252,1116,T1
7592,December 3,2017,Taiwan,Philippines,3,0,Friendly tournament,in Taiwan,40,-40,964,1188,6,-12,192,167,924,1228,T1
7593,December 3,2017,Laos,East Timor,2,1,Friendly tournament,in Taiwan,8,-8,790,607,0,-1,212,229,782,615,T1
7594,December 3,2017,Libya,Tanzania,0,0,CECAFA Cup,in Kenya,-7,7,1469,1356,-3,0,92,120,1476,1349,draw
7595,December 3,2017,Kenya,Rwanda,2,0,CECAFA Cup,in Kenya,16,-16,1391,1276,6,-4,110,140,1375,1292,T1
7596,December 4,2017,Taiwan,East Timor,3,1,Friendly tournament,in Taiwan,3,-3,967,604,0,0,192,229,964,607,T1
7597,December 4,2017,Burundi,Uganda,0,0,CECAFA Cup,in Kenya,9,-9,1323,1481,2,-1,124,85,1314,1490,draw
7598,December 5,2017,Taiwan,Laos,2,0,Friendly tournament,in Taiwan,8,-8,975,782,0,0,192,212,967,790,T1
7599,December 5,2017,East Timor,Philippines,1,0,Friendly tournament,in Taiwan,29,-29,633,1159,4,-2,225,169,604,1188,T1
7600,December 5,2017,Tuvalu,New Caledonia,2,1,Pacific Mini Games,in Vanuatu,39,-39,759,1273,1,-12,214,139,720,1312,T1
7601,December 5,2017,Zanzibar,Rwanda,3,1,CECAFA Cup,in Kenya,29,-29,1318,1247,10,-10,126,150,1289,1276,T1
7602,December 5,2017,Kenya,Libya,0,0,CECAFA Cup,in Kenya,-1,1,1390,1470,0,0,110,92,1391,1469,draw
7603,December 5,2017,Ethiopia,South Sudan,3,0,CECAFA Cup,in Kenya,16,-16,1298,1049,6,-2,131,185,1282,1065,T1
7604,December 6,2017,Vanuatu,Tonga,5,0,Pacific Mini Games,in Vanuatu,1,-1,1212,560,1,0,160,234,1211,561,T1
7605,December 6,2017,Fiji,Solomon Islands,0,0,Pacific Mini Games,in Vanuatu,-2,2,1211,1183,-1,0,161,167,1213,1181,draw
7606,December 7,2017,Zanzibar,Tanzania,2,1,CECAFA Cup,in Kenya,22,-22,1340,1334,5,-3,121,123,1318,1356,T1
7607,December 7,2017,Libya,Rwanda,0,0,CECAFA Cup,in Kenya,-11,11,1459,1258,0,5,92,145,1470,1247,draw
7608,December 7,2017,Burundi,Ethiopia,4,1,CECAFA Cup,in Kenya,32,-32,1355,1266,4,-12,120,143,1323,1298,T1
7609,December 8,2017,Uganda,South Sudan,5,1,CECAFA Cup,in Kenya,6,-6,1487,1043,1,0,84,185,1481,1049,T1
7610,December 9,2017,Vanuatu,Fiji,1,1,Pacific Mini Games,in Vanuatu,-6,6,1206,1217,-2,3,162,158,1212,1211,draw
7611,December 9,2017,Solomon Islands,Tuvalu,6,0,Pacific Mini Games,in Vanuatu,7,-7,1190,752,2,0,165,214,1183,759,T1
7612,December 9,2017,New Caledonia,Tonga,4,2,Pacific Mini Games,in Vanuatu,1,-1,1274,559,-1,0,139,234,1273,560,T1
7613,December 9,2017,Japan,North Korea,1,0,East Asian Cup,in Japan,4,-4,1748,1451,3,-1,28,97,1744,1455,T1
7614,December 9,2017,China,South Korea,2,2,East Asian Cup,in Japan,8,-8,1578,1704,0,-3,68,42,1570,1712,draw
7615,December 9,2017,Rwanda,Tanzania,2,1,CECAFA Cup,in Kenya,24,-24,1282,1310,9,-4,136,127,1258,1334,T1
7616,December 9,2017,Kenya,Zanzibar,0,0,CECAFA Cup,in Kenya,-8,8,1382,1348,-2,0,112,121,1390,1340,draw
7617,December 10,2017,Ethiopia,Uganda,1,1,CECAFA Cup,in Kenya,11,-11,1277,1476,5,-4,139,88,1266,1487,draw
7618,December 11,2017,South Sudan,Burundi,0,0,CECAFA Cup,in Kenya,14,-14,1057,1341,1,0,184,120,1043,1355,draw
7619,December 11,2017,Libya,Zanzibar,1,0,CECAFA Cup,in Kenya,14,-14,1473,1334,2,-1,90,122,1459,1348,T1
7620,December 11,2017,Kenya,Tanzania,1,0,CECAFA Cup,in Kenya,11,-11,1393,1299,2,-3,110,130,1382,1310,T1
7621,December 12,2017,Vanuatu,Tuvalu,10,0,Pacific Mini Games,in Vanuatu,4,-4,1210,748,0,0,162,214,1206,752,T1
7622,December 12,2017,Solomon Islands,New Caledonia,1,0,Pacific Mini Games,in Vanuatu,25,-25,1215,1249,5,-10,160,150,1190,1274,T1
7623,December 12,2017,Fiji,Tonga,4,0,Pacific Mini Games,in Vanuatu,2,-2,1219,557,1,0,157,234,1217,559,T1
7624,December 12,2017,South Korea,North Korea,1,0,East Asian Cup,in Japan,8,-8,1712,1443,3,0,39,97,1704,1451,T1
7625,December 12,2017,Japan,China,2,1,East Asian Cup,in Japan,7,-7,1755,1571,3,0,25,68,1748,1578,T1
7626,December 14,2017,Kenya,Burundi,1,0,CECAFA Cup,in Kenya,12,-12,1405,1329,3,-4,107,124,1393,1341,T1
7627,December 14,2017,Qatar,Liechtenstein,1,2,Friendly,in Qatar,-18,18,1461,1168,-6,3,92,168,1479,1150,T2
7628,December 15,2017,Vanuatu,Solomon Islands,3,2,Pacific Mini Games,in Vanuatu,15,-15,1225,1200,7,-4,155,164,1210,1215,T1
7629,December 15,2017,Tuvalu,Tonga,4,3,Pacific Mini Games,in Vanuatu,10,-10,758,547,0,0,214,234,748,557,T1
7630,December 15,2017,Fiji,New Caledonia,4,1,Pacific Mini Games,in Vanuatu,38,-38,1257,1211,12,-11,145,161,1219,1249,T1
7631,December 15,2017,Oman,Yemen,1,0,Friendly,in Oman,3,-3,1460,1221,1,-1,92,156,1457,1224,T1
7632,December 15,2017,Zanzibar,Uganda,2,1,CECAFA Cup,in Kenya,28,-28,1362,1448,2,-9,119,96,1334,1476,T1
7633,December 16,2017,Japan,South Korea,1,4,East Asian Cup,in Japan,-49,49,1706,1761,-17,14,42,25,1755,1712,T2
7634,December 16,2017,China,North Korea,1,1,East Asian Cup,in Japan,-7,7,1564,1450,-1,1,69,96,1571,1443,draw
7635,December 17,2017,United Arab Emirates,Iraq,1,0,Friendly,in the United Arab Emirates,8,-8,1547,1554,1,0,71,70,1539,1562,T1
7636,December 17,2017,Uganda,Burundi,2,1,CECAFA Cup,in Kenya,13,-13,1461,1316,6,-1,91,125,1448,1329,T1
7637,December 17,2017,Kenya,Zanzibar,2,2,CECAFA Cup,in Kenya,-8,8,1397,1370,-2,1,109,118,1405,1362,draw
7638,December 18,2017,Bahrain,Kuwait,0,0,Friendly,in Bahrain,-1,1,1395,1476,0,0,110,87,1396,1475,draw
7639,December 22,2017,United Arab Emirates,Oman,1,0,Gulf Cup,in Kuwait,15,-15,1562,1445,1,-4,70,97,1547,1460,T1
7640,December 22,2017,Kuwait,Saudi Arabia,1,2,Gulf Cup,in Kuwait,-19,19,1457,1619,-5,10,92,55,1476,1600,T2
7641,December 23,2017,Qatar,Yemen,4,0,Gulf Cup,in Kuwait,15,-15,1476,1206,3,-6,87,162,1461,1221,T1
7642,December 23,2017,Bahrain,Iraq,1,1,Gulf Cup,in Kuwait,9,-9,1404,1545,3,0,107,71,1395,1554,draw
7643,December 25,2017,Jordan,Libya,1,1,Friendly,in Jordan,-3,3,1476,1476,0,2,86,86,1479,1473,draw
7644,December 25,2017,Saudi Arabia,United Arab Emirates,0,0,Gulf Cup,in Kuwait,-3,3,1616,1565,-1,2,56,68,1619,1562,draw
7645,December 25,2017,Kuwait,Oman,0,1,Gulf Cup,in Kuwait,-26,26,1431,1471,-5,6,97,91,1457,1445,T2
7646,December 26,2017,Iraq,Qatar,2,1,Gulf Cup,in Kuwait,16,-16,1561,1460,0,-6,71,92,1545,1476,T1
7647,December 26,2017,Bahrain,Yemen,1,0,Gulf Cup,in Kuwait,10,-10,1414,1196,4,-2,103,164,1404,1206,T1
7648,December 28,2017,Oman,Saudi Arabia,2,0,Gulf Cup,in Kuwait,42,-42,1513,1574,11,-11,79,67,1471,1616,T1
7649,December 28,2017,Kuwait,United Arab Emirates,0,0,Gulf Cup,in Kuwait,2,-2,1433,1563,0,-2,97,70,1431,1565,draw
7650,December 29,2017,Iraq,Yemen,3,0,Gulf Cup,in Kuwait,8,-8,1569,1188,3,-3,68,167,1561,1196,T1
7651,January 2,2018,Oman,Bahrain,1,0,Gulf Cup,in Kuwait,15,-15,1528,1402,4,-5,75,107,1513,1417,T1
7652,January 2,2018,Iraq,United Arab Emirates,0,0,Gulf Cup,in Kuwait,0,0,1569,1563,0,0,68,71,1569,1563,draw
7653,January 5,2018,Oman,United Arab Emirates,0,0,Gulf Cup,in Kuwait,2,-2,1530,1561,0,0,75,71,1528,1563,draw
7654,January 7,2018,Estonia,Sweden,1,1,Friendly,in the United Arab Emirates,7,-7,1514,1818,2,0,79,20,1507,1825,draw
7655,January 11,2018,Finland,Jordan,2,1,Friendly,in the United Arab Emirates,7,-7,1602,1469,0,-3,65,90,1595,1476,T1
7656,January 14,2018,Indonesia,Iceland,1,4,Friendly,in Indonesia,-2,2,1231,1813,0,0,154,21,1233,1811,T2
7657,January 27,2018,South Korea,Moldova,1,0,Friendly,in Turkey,2,-2,1763,1330,1,0,24,123,1761,1332,T1
7658,January 28,2018,United States,Bosnia and Herzegovina,0,0,Friendly,in the United States,-4,4,1748,1727,-1,0,28,36,1752,1723,draw
7659,January 30,2018,Jamaica,South Korea,2,2,Friendly,in Turkey,5,-5,1570,1758,1,-1,68,25,1565,1763,draw
7660,January 30,2018,Azerbaijan,Moldova,0,0,Friendly,in Turkey,-2,2,1399,1332,-1,0,109,123,1401,1330,draw
7661,January 31,2018,Mexico,Bosnia and Herzegovina,1,0,Friendly,in the United States,7,-7,1855,1720,0,0,17,36,1848,1727,T1
7662,February 3,2018,South Korea,Latvia,1,0,Friendly,in Turkey,2,-2,1760,1360,0,0,25,120,1758,1362,T1
7663,February 26,2018,Saudi Arabia,Moldova,3,0,Friendly,in Saudi Arabia,4,-4,1578,1328,0,0,67,123,1574,1332,T1
7664,February 28,2018,Iraq,Saudi Arabia,4,1,Friendly,in Iraq,13,-13,1582,1565,3,-2,66,69,1569,1578,T1
7665,March 17,2018,Iran,Sierra Leone,4,0,Friendly,in Iran,2,-2,1801,1377,0,0,22,114,1799,1379,T1
7666,March 20,2018,Tahiti,New Caledonia,0,0,Friendly,in Tahiti,-3,3,1218,1214,-1,1,157,159,1221,1211,draw
7667,March 21,2018,Zambia,Zimbabwe,2,2,Friendly tournament,in Zambia,-5,5,1497,1477,-1,1,83,88,1502,1472,draw
7668,March 21,2018,Madagascar,Togo,0,0,Friendly,in France,0,0,1368,1384,0,0,119,111,1368,1384,draw
7669,March 21,2018,Laos,Cambodia,0,1,Friendly,in Laos,-12,12,770,822,0,0,212,208,782,810,T2
7670,March 21,2018,Jordan,Kuwait,1,0,Friendly,in Jordan,6,-6,1475,1427,0,-1,90,98,1469,1433,T1
7671,March 21,2018,Iraq,Qatar,2,3,Friendly tournament,in Iraq,-24,24,1558,1481,-5,6,71,86,1582,1457,T2
7672,March 21,2018,Antigua and Barbuda,Bermuda,3,2,Friendly,in Antigua and Barbuda,7,-7,1212,1189,1,-2,161,166,1205,1196,T1
7673,March 21,2018,Angola,South Africa,1,1,Friendly tournament,in Zambia,10,-10,1250,1530,2,-2,150,74,1240,1540,draw
7674,March 21,2018,Andorra,Liechtenstein,1,0,Friendly,in Spain,14,-14,1026,1154,0,-3,188,171,1012,1168,T1
7675,March 22,2018,Thailand,Gabon,0,0,King's Cup,in Thailand,-4,4,1403,1418,-1,1,106,102,1407,1414,draw
7676,March 22,2018,Slovakia,United Arab Emirates,2,1,King's Cup,in Thailand,8,-8,1756,1553,2,0,26,70,1748,1561,T1
7677,March 22,2018,Philippines,Fiji,3,2,Friendly,in the Philippines,10,-10,1169,1247,1,-6,168,151,1159,1257,T1
7678,March 22,2018,Nicaragua,Cuba,3,1,Friendly,in Nicaragua,13,-13,1280,1296,4,-4,138,131,1267,1309,T1
7679,March 22,2018,Malta,Luxembourg,0,1,Friendly,in Malta,-10,10,1206,1332,-4,1,162,123,1216,1322,T2
7680,March 22,2018,Malaysia,Mongolia,2,2,Friendly,in Malaysia,-9,9,1053,662,-2,0,185,224,1062,653,draw
7681,March 22,2018,Macao,Mauritius,0,1,Friendly,in Macao,-3,3,675,1071,-1,1,223,181,678,1068,T2
7682,March 22,2018,Kyrgyzstan,Myanmar,5,1,Asian Cup qualifier,in South Korea,26,-26,1233,1067,8,-5,154,182,1207,1093,T1
7683,March 22,2018,Faroe Islands,Latvia,1,1,Friendly,in Spain,2,-2,1283,1358,1,0,136,120,1281,1360,draw
7684,March 22,2018,Dominican Republic,Turks and Caicos,4,0,Friendly,in the Dominican Republic,1,-1,1251,763,1,0,149,213,1250,764,T1
7685,March 22,2018,Denmark,Panama,1,0,Friendly,in Denmark,3,-3,1845,1669,0,0,18,48,1842,1672,T1
7686,March 22,2018,China,Wales,0,6,Friendly tournament,in China,-23,23,1541,1786,-3,1,72,23,1564,1763,T2
7687,March 22,2018,Burkina Faso,Guinea-Bissau,2,0,Friendly,in France,4,-4,1609,1289,4,0,59,135,1605,1293,T1
7688,March 22,2018,Belize,Grenada,4,2,Friendly,in Belize,9,-9,1168,1103,0,0,169,174,1159,1112,T1
7689,March 22,2018,Bahrain,Palestine,0,0,Friendly,in Bahrain,-3,3,1399,1403,-1,2,108,106,1402,1400,draw
7690,March 22,2018,Algeria,Tanzania,4,1,Friendly,in Algeria,4,-4,1542,1295,1,-3,71,133,1538,1299,T1
7691,March 23,2018,Uruguay,Czechia,2,0,Friendly tournament,in China,13,-13,1880,1700,0,-5,13,43,1867,1713,T1
7692,March 23,2018,Turkey,Ireland,1,0,Friendly,in Turkey,8,-8,1720,1724,3,-1,36,35,1712,1732,T1
7693,March 23,2018,Tunisia,Iran,1,0,Friendly,in Tunisia,12,-12,1636,1789,1,0,52,22,1624,1801,T1
7694,March 23,2018,Tahiti,New Caledonia,4,3,Friendly,in Tahiti,7,-7,1225,1207,2,-2,156,161,1218,1214,T1
7695,March 23,2018,Singapore,Maldives,3,2,Friendly,in Singapore,4,-4,1061,935,0,-1,183,198,1057,939,T1
7696,March 23,2018,Senegal,Uzbekistan,1,1,Friendly,in Morocco,-4,4,1748,1613,-1,4,29,55,1752,1609,draw
7697,March 23,2018,Scotland,Costa Rica,0,1,Friendly,in Scotland,-12,12,1708,1758,-3,6,39,25,1720,1746,T2
7698,March 23,2018,Saudi Arabia,Ukraine,1,1,Friendly,in Spain,5,-5,1570,1732,1,0,67,33,1565,1737,draw
7699,March 23,2018,Russia,Brazil,0,3,Friendly,in Russia,-5,5,1693,2119,-2,0,45,1,1698,2114,T2
7700,March 23,2018,Portugal,Egypt,2,1,Friendly,in Switzerland,3,-3,1998,1656,0,1,4,49,1995,1659,T1
7701,March 23,2018,Poland,Nigeria,0,1,Friendly,in Poland,-16,16,1826,1712,0,6,19,38,1842,1696,T2
7702,March 23,2018,Peru,Croatia,2,0,Friendly,in the United States,14,-14,1895,1842,2,-2,10,18,1881,1856,T1
7703,March 23,2018,Norway,Australia,4,1,Friendly,in Norway,20,-20,1602,1708,2,-4,64,39,1582,1728,T1
7704,March 23,2018,Netherlands,England,0,1,Friendly,in the Netherlands,-12,12,1884,1945,-1,0,12,7,1896,1933,T2
7705,March 23,2018,Morocco,Serbia,2,1,Friendly,in Italy,12,-12,1703,1757,4,-2,41,26,1691,1769,T1
7706,March 23,2018,Mexico,Iceland,3,0,Friendly,in the United States,15,-15,1870,1798,2,0,15,21,1855,1813,T1
7707,March 23,2018,Japan,Mali,1,1,Friendly,in Belgium,-5,5,1701,1519,0,0,42,79,1706,1514,draw
7708,March 23,2018,Hungary,Kazakhstan,2,3,Friendly,in Hungary,-18,18,1594,1358,-9,1,66,120,1612,1340,T2
7709,March 23,2018,Guadeloupe,Trinidad and Tobago,0,1,Friendly,in Guadeloupe,-8,8,1259,1428,-1,4,144,97,1267,1420,T2
7710,March 23,2018,Greece,Switzerland,0,1,Friendly,in Greece,-7,7,1655,1873,-1,0,50,14,1662,1866,T2
7711,March 23,2018,Germany,Spain,1,1,Friendly,in Germany,-5,5,2104,2037,0,0,2,3,2109,2032,draw
7712,March 23,2018,Gambia,Central African Republic,1,1,Friendly,in The Gambia,-2,2,1276,1299,-1,1,140,129,1278,1297,draw
7713,March 23,2018,France,Colombia,2,3,Friendly,in France,-14,14,1976,1941,-1,1,6,8,1990,1927,T2
7714,March 23,2018,Finland,Macedonia,0,0,Friendly,in Turkey,-2,2,1600,1522,0,0,65,78,1602,1520,draw
7715,March 23,2018,Cyprus,Montenegro,0,0,Friendly,in Cyprus,3,-3,1413,1611,0,0,104,56,1410,1614,draw
7716,March 23,2018,Curaçao,Bolivia,1,1,Friendly,in Curaçao,8,-8,1274,1699,3,-3,141,44,1266,1707,draw
7717,March 23,2018,Bulgaria,Bosnia and Herzegovina,0,1,Friendly,in Bulgaria,-10,10,1611,1730,-2,2,56,34,1621,1720,T2
7718,March 23,2018,Azerbaijan,Belarus,0,1,Friendly,in Azerbaijan,-10,10,1389,1508,-2,0,110,82,1399,1498,T2
7719,March 23,2018,Austria,Slovenia,3,0,Friendly,in Austria,10,-10,1720,1629,4,-1,36,53,1710,1639,T1
7720,March 23,2018,Argentina,Italy,2,0,Friendly,in England,12,-12,1997,1894,1,-1,5,11,1985,1906,T1
7721,March 24,2018,Zambia,South Africa,0,2,Friendly tournament,in Zambia,-27,27,1470,1557,-6,4,89,70,1497,1530,T2
7722,March 24,2018,Uganda,São Tomé and Príncipe,3,1,Friendly,in Uganda,2,-2,1463,1080,1,0,91,178,1461,1082,T1
7723,March 24,2018,Sweden,Chile,1,2,Friendly,in Sweden,-12,12,1806,1872,0,1,20,15,1818,1860,T2
7724,March 24,2018,Qatar,Syria,2,2,Friendly tournament,in Iraq,5,-5,1486,1604,1,-3,85,62,1481,1609,draw
7725,March 24,2018,Northern Ireland,South Korea,2,1,Friendly,in Northern Ireland,10,-10,1684,1750,0,-4,47,28,1674,1760,T1
7726,March 24,2018,Mauritania,Guinea,2,0,Friendly,in Mauritania,18,-18,1316,1455,5,-3,125,94,1298,1473,T1
7727,March 24,2018,Kosovo,Madagascar,1,0,Friendly,in France,10,-10,1381,1358,4,0,113,119,1371,1368,T1
7728,March 24,2018,Kenya,Comoros,2,2,Friendly,in Morocco,-8,8,1389,1047,-1,0,110,186,1397,1039,draw
7729,March 24,2018,Ivory Coast,Togo,2,2,Friendly,in France,-6,6,1599,1390,-2,2,65,109,1605,1384,draw
7730,March 24,2018,Israel,Romania,1,2,Friendly,in Israel,-8,8,1527,1696,-3,1,76,45,1535,1688,T2
7731,March 24,2018,Georgia,Lithuania,4,0,Friendly,in Georgia,10,-10,1494,1397,1,-3,84,108,1484,1407,T1
7732,March 24,2018,Canada,New Zealand,1,0,Friendly,in Spain,10,-10,1534,1515,3,-4,74,80,1524,1525,T1
7733,March 24,2018,Botswana,Lesotho,1,0,Friendly,in Botswana,8,-8,1261,1262,4,0,144,143,1253,1270,T1
7734,March 24,2018,Armenia,Estonia,0,0,Friendly,in Armenia,-2,2,1479,1516,0,1,86,79,1481,1514,draw
7735,March 24,2018,Angola,Zimbabwe,2,2,Friendly tournament,in Zambia,9,-9,1259,1468,5,-2,145,90,1250,1477,draw
7736,March 25,2018,Thailand,Slovakia,2,3,King's Cup,in Thailand,-6,6,1397,1762,-2,2,107,24,1403,1756,T2
7737,March 25,2018,Nicaragua,Cuba,3,3,Friendly,in Nicaragua,-2,2,1278,1298,1,0,137,131,1280,1296,draw
7738,March 25,2018,Martinique,Trinidad and Tobago,0,0,Friendly,in Martinique,-3,3,1423,1431,-1,-1,101,98,1426,1428,draw
7739,March 25,2018,Kuwait,Cameroon,1,3,Friendly,in Kuwait,-10,10,1417,1657,-3,2,102,49,1427,1647,T2
7740,March 25,2018,Jamaica,Antigua and Barbuda,1,1,Friendly,in Jamaica,-9,9,1561,1221,-1,2,68,158,1570,1212,draw
7741,March 25,2018,Gibraltar,Latvia,1,0,Friendly,in Gibraltar,15,-15,1094,1343,2,-2,177,121,1079,1358,T1
7742,March 25,2018,Gabon,United Arab Emirates,1,0,King's Cup,in Thailand,21,-21,1439,1532,5,-3,97,74,1418,1553,T1
7743,March 25,2018,Faroe Islands,Liechtenstein,3,0,Friendly,in Spain,11,-11,1294,1143,1,-1,135,172,1283,1154,T1
7744,March 25,2018,Dominican Republic,Saint Kitts and Nevis,2,1,Friendly,in the Dominican Republic,7,-7,1258,1249,3,-3,147,150,1251,1256,T1
7745,March 25,2018,Congo,Guinea-Bissau,2,0,Friendly,in France,11,-11,1394,1278,3,-2,109,137,1383,1289,T1
7746,March 25,2018,Barbados,Bermuda,0,0,Friendly,in Barbados,-1,1,1137,1190,0,2,173,164,1138,1189,draw
7747,March 26,2018,Uruguay,Wales,1,0,Friendly tournament,in China,11,-11,1891,1775,0,0,13,23,1880,1786,T1
7748,March 26,2018,Netherlands,Portugal,3,0,Friendly,in Switzerland,23,-23,1907,1975,2,-2,10,6,1884,1998,T1
7749,March 26,2018,Finland,Malta,5,0,Friendly,in Turkey,4,-4,1604,1202,2,0,62,162,1600,1206,T1
7750,March 26,2018,Curaçao,Bolivia,1,0,Friendly,in Curaçao,17,-17,1291,1682,5,-3,136,47,1274,1699,T1
7751,March 26,2018,China,Czechia,1,4,Friendly tournament,in China,-22,22,1519,1722,-5,7,77,36,1541,1700,T2
7752,March 26,2018,Bulgaria,Kazakhstan,2,1,Friendly,in Hungary,4,-4,1615,1354,1,-1,55,120,1611,1358,T1
7753,March 26,2018,Albania,Norway,0,1,Friendly,in Albania,-13,13,1596,1615,-6,8,65,55,1609,1602,T2
7754,March 27,2018,United States,Paraguay,1,0,Friendly,in the United States,7,-7,1755,1746,3,-2,26,29,1748,1753,T1
7755,March 27,2018,Ukraine,Japan,2,1,Friendly,in Belgium,9,-9,1741,1692,1,-1,32,44,1732,1701,T1
7756,March 27,2018,Uganda,Malawi,0,0,Friendly,in Uganda,-6,6,1457,1310,-1,-1,92,130,1463,1304,draw
7757,March 27,2018,Tunisia,Costa Rica,1,0,Friendly,in France,13,-13,1649,1745,1,-5,51,30,1636,1758,T1
7758,March 27,2018,Tanzania,Democratic Republic of Congo,2,0,Friendly,in Tanzania,23,-23,1318,1583,8,-5,125,66,1295,1606,T1
7759,March 27,2018,Switzerland,Panama,6,0,Friendly,in Switzerland,6,-6,1879,1663,0,-1,14,49,1873,1669,T1
7760,March 27,2018,Spain,Argentina,6,1,Friendly,in Spain,12,-12,2049,1985,0,0,3,4,2037,1997,T1
7761,March 27,2018,Slovenia,Belarus,0,2,Friendly,in Slovenia,-23,23,1606,1531,-5,7,58,75,1629,1508,T2
7762,March 27,2018,Seychelles,Swaziland,0,0,Friendly,in the Seychelles,6,-6,945,1290,0,-4,197,136,939,1296,draw
7763,March 27,2018,Serbia,Nigeria,2,0,Friendly,in England,13,-13,1770,1699,2,-4,24,43,1757,1712,T1
7764,March 27,2018,Russia,France,1,3,Friendly,in Russia,-8,8,1685,1984,0,0,45,5,1693,1976,T2
7765,March 27,2018,Romania,Sweden,1,0,Friendly,in Romania,10,-10,1706,1796,2,0,42,20,1696,1806,T1
7766,March 27,2018,Poland,South Korea,3,2,Friendly,in Poland,5,-5,1831,1745,0,-2,19,30,1826,1750,T1
7767,March 27,2018,Peru,Iceland,3,1,Friendly,in the United States,11,-11,1906,1787,0,-1,11,22,1895,1798,T1
7768,March 27,2018,Namibia,Lesotho,2,1,Friendly,in Namibia,4,-4,1381,1258,2,-3,113,146,1377,1262,T1
7769,March 27,2018,Morocco,Uzbekistan,2,0,Friendly,in Morocco,8,-8,1711,1605,1,-3,41,60,1703,1613,T1
7770,March 27,2018,Montenegro,Turkey,2,2,Friendly,in Montenegro,0,0,1611,1720,2,-1,56,38,1611,1720,draw
7771,March 27,2018,Mongolia,Mauritius,0,2,Friendly,in Mongolia,-4,4,658,1075,0,0,224,181,662,1071,T2
7772,March 27,2018,Luxembourg,Austria,0,4,Friendly,in Luxembourg,-6,6,1326,1726,0,2,123,35,1332,1720,T2
7773,March 27,2018,Laos,Bangladesh,2,2,Friendly,in Laos,-2,2,768,808,0,0,212,209,770,806,draw
7774,March 27,2018,Kosovo,Burkina Faso,2,0,Friendly,in France,24,-24,1405,1585,6,-4,107,64,1381,1609,T1
7775,March 27,2018,Ivory Coast,Moldova,2,1,Friendly,in France,3,-3,1602,1325,2,0,62,124,1599,1328,T1
7776,March 27,2018,Iraq,Syria,1,1,Friendly tournament,in Iraq,-2,2,1556,1606,-1,4,70,58,1558,1604,draw
7777,March 27,2018,Iran,Algeria,2,1,Friendly,in Austria,4,-4,1793,1538,1,-1,21,72,1789,1542,T1
7778,March 27,2018,Hungary,Scotland,0,1,Friendly,in Hungary,-10,10,1584,1718,1,1,65,39,1594,1708,T2
7779,March 27,2018,Greece,Egypt,1,0,Friendly,in Switzerland,10,-10,1665,1646,3,-2,48,52,1655,1656,T1
7780,March 27,2018,Germany,Brazil,0,1,Friendly,in Germany,-12,12,2092,2131,0,0,2,1,2104,2119,T2
7781,March 27,2018,Georgia,Estonia,2,0,Friendly,in Georgia,12,-12,1506,1504,2,-4,82,83,1494,1516,T1
7782,March 27,2018,England,Italy,1,1,Friendly,in England,-4,4,1941,1898,0,0,7,12,1945,1894,draw
7783,March 27,2018,Denmark,Chile,0,0,Friendly,in Denmark,-2,2,1843,1874,-1,0,18,15,1845,1872,draw
7784,March 27,2018,Croatia,Mexico,1,0,Friendly,in the United States,11,-11,1853,1859,1,0,17,16,1842,1870,T1
7785,March 27,2018,Central African Republic,Kenya,3,2,Friendly,in Morocco,13,-13,1312,1376,1,-6,129,117,1299,1389,T1
7786,March 27,2018,Bosnia and Herzegovina,Senegal,0,0,Friendly,in France,1,-1,1731,1747,0,2,34,27,1730,1748,draw
7787,March 27,2018,Belgium,Saudi Arabia,4,0,Friendly,in Belgium,3,-3,1931,1567,0,0,9,67,1928,1570,T1
7788,March 27,2018,Azerbaijan,Macedonia,1,1,Friendly,in Turkey,4,-4,1393,1518,0,-3,111,79,1389,1522,draw
7789,March 27,2018,Australia,Colombia,0,0,Friendly,in England,6,-6,1714,1935,0,0,40,8,1708,1941,draw
7790,March 27,2018,Armenia,Lithuania,0,1,Friendly,in Armenia,-15,15,1464,1412,-3,1,89,106,1479,1397,T2
7791,March 27,2018,Yemen,Nepal,2,1,Asian Cup qualifier,in Qatar,6,-6,1194,894,3,0,164,202,1188,900,T1
7792,March 27,2018,Taiwan,Singapore,1,0,Asian Cup qualifier,in Taiwan,19,-19,994,1042,0,-3,192,186,975,1061,T1
7793,March 27,2018,Philippines,Tajikistan,2,1,Asian Cup qualifier,in the Philippines,17,-17,1186,1197,1,-3,167,163,1169,1214,T1
7794,March 27,2018,Oman,Palestine,1,0,Asian Cup qualifier,in Oman,9,-9,1539,1394,3,-4,71,109,1530,1403,T1
7795,March 27,2018,North Korea,Hong Kong,2,0,Asian Cup qualifier,in North Korea,7,-7,1457,1183,4,-4,92,168,1450,1190,T1
7796,March 27,2018,Myanmar,Macao,1,0,Asian Cup qualifier,in Myanmar,2,-2,1069,673,0,0,182,223,1067,675,T1
7797,March 27,2018,Maldives,Bhutan,7,0,Asian Cup qualifier,in the Maldives,7,-7,942,585,0,0,198,231,935,592,T1
7798,March 27,2018,Lebanon,Malaysia,2,1,Asian Cup qualifier,in Lebanon,2,-2,1459,1051,1,1,91,184,1457,1053,T1
7799,March 27,2018,Kyrgyzstan,India,2,1,Asian Cup qualifier,in Kyrgyzstan,11,-11,1244,1149,2,-1,152,171,1233,1160,T1
7800,March 27,2018,Jordan,Vietnam,1,1,Asian Cup qualifier,in Jordan,-14,14,1461,1285,-2,5,90,137,1475,1271,draw
7801,March 27,2018,Bahrain,Turkmenistan,4,0,Asian Cup qualifier,in Bahrain,15,-15,1414,1239,2,-4,104,153,1399,1254,T1
7802,March 27,2018,Afghanistan,Cambodia,2,1,Asian Cup qualifier,in Tajikistan,5,-5,1154,817,1,0,170,208,1149,822,T1
7803,April 1,2018,Malaysia,Bhutan,7,0,Friendly,in Malaysia,2,-2,1053,583,0,0,184,231,1051,585,T1
7804,April 1,2018,Antigua and Barbuda,Dominica,0,0,Friendly,in Antigua and Barbuda,-7,7,1214,1012,-1,0,159,189,1221,1005,draw
7805,April 17,2018,Trinidad and Tobago,Panama,0,1,Friendly,in Trinidad and Tobago,-6,6,1425,1669,-1,1,99,48,1431,1663,T2
7806,April 18,2018,Zimbabwe,Botswana,0,1,Friendly,in Zimbabwe,-17,17,1451,1278,-8,4,96,139,1468,1261,T2
7807,April 19,2018,Swatini,Namibia,1,0,Friendly,in Swatini,10,-10,1300,1371,4,-4,132,117,1290,1381,T1
7808,April 26,2018,Saint Kitts and Nevis,Jamaica,1,3,Friendly,in Saint Kitts and Nevis,-7,7,1242,1568,-3,1,152,67,1249,1561,T2
7809,April 29,2018,Antigua and Barbuda,Jamaica,0,2,Friendly,in Antigua and Barbuda,-6,6,1208,1574,0,0,159,67,1214,1568,T2
7810,April 29,2018,Saint Barthélemy,Saint Martin,3,1,Friendly,in Saint Barthélemy,18,-18,712,842,1,-2,216,206,694,860,T1
7811,May 8,2018,Iraq,Palestine,0,0,Friendly,in Iraq,-6,6,1550,1400,0,1,70,108,1556,1394,draw
7812,May 9,2018,Saudi Arabia,Algeria,2,0,Friendly,in Spain,14,-14,1581,1524,1,-4,67,76,1567,1538,T1
7813,May 11,2018,Kuwait,Palestine,2,0,Friendly,in Kuwait,10,-10,1427,1390,3,-3,99,111,1417,1400,T1
7814,May 15,2018,Saudi Arabia,Greece,2,0,Friendly,in Spain,19,-19,1600,1646,4,-2,63,51,1581,1665,T1
7815,May 19,2018,Iran,Uzbekistan,1,0,Friendly,in Iran,3,-3,1796,1602,1,-1,20,61,1793,1605,T1
7816,May 20,2018,Jordan,Cyprus,3,0,Friendly,in Jordan,10,-10,1471,1403,2,-2,87,107,1461,1413,T1
7817,May 25,2018,Kuwait,Egypt,1,1,Friendly,in Kuwait,3,-3,1430,1643,1,-1,98,52,1427,1646,draw
7818,May 25,2018,Kenya,Swatini,0,1,Friendly,in Kenya,-15,15,1361,1315,-2,4,118,128,1376,1300,T2
7819,May 26,2018,China,Myanmar,1,0,Friendly,in China,1,-1,1520,1068,0,0,77,182,1519,1069,T1
7820,May 26,2018,Saint Barthélemy,Sint Maarten,5,3,Friendly,in Saint Barthélemy,18,-18,730,868,1,0,215,203,712,886,T1
7821,May 27,2018,Niger,Central African Republic,3,3,Friendly tournament,in Niger,-4,4,1291,1316,-1,4,135,126,1295,1312,draw
7822,May 27,2018,Burkina Faso,Cameroon,1,0,Friendly,in France,12,-12,1597,1645,1,-2,64,51,1585,1657,T1
7823,May 27,2018,Madagascar,Mozambique,2,1,COSAFA Cup,in South Africa,18,-18,1376,1297,3,-5,116,133,1358,1315,T1
7824,May 27,2018,Comoros,Seychelles,1,1,COSAFA Cup,in South Africa,-6,6,1041,951,-1,4,186,193,1047,945,draw
7825,May 28,2018,Mauritius,Malawi,1,0,COSAFA Cup,in South Africa,32,-32,1107,1278,7,-9,174,139,1075,1310,T1
7826,May 28,2018,Botswana,Angola,2,1,COSAFA Cup,in South Africa,19,-19,1297,1240,7,-8,132,152,1278,1259,T1
7827,May 28,2018,United States,Bolivia,3,0,Friendly,in the United States,9,-9,1764,1673,1,0,25,47,1755,1682,T1
7828,May 28,2018,Turkey,Iran,2,1,Friendly,in Turkey,9,-9,1729,1787,4,-1,34,21,1720,1796,T1
7829,May 28,2018,South Korea,Honduras,2,0,Friendly,in South Korea,6,-6,1751,1604,3,-2,27,59,1745,1610,T1
7830,May 28,2018,Portugal,Tunisia,2,2,Friendly,in Portugal,-8,8,1967,1657,0,0,6,49,1975,1649,draw
7831,May 28,2018,Nigeria,Democratic Republic of Congo,1,1,Friendly,in Nigeria,-6,6,1693,1589,0,1,43,66,1699,1583,draw
7832,May 28,2018,Mexico,Wales,0,0,Friendly,in the United States,-2,2,1857,1777,0,0,16,23,1859,1775,draw
7833,May 28,2018,Kenya,Equatorial Guinea,1,0,Friendly,in Kenya,6,-6,1367,1327,0,0,119,122,1361,1333,T1
7834,May 28,2018,Italy,Saudi Arabia,2,1,Friendly,in Switzerland,3,-3,1901,1597,0,0,12,63,1898,1600,T1
7835,May 28,2018,France,Ireland,2,0,Friendly,in France,3,-3,1987,1721,1,-2,4,38,1984,1724,T1
7836,May 28,2018,Bosnia and Herzegovina,Montenegro,0,0,Friendly,in Bosnia and Herzegovina,-6,6,1725,1617,-2,3,36,53,1731,1611,draw
7837,May 29,2018,Madagascar,Seychelles,1,1,COSAFA Cup,in South Africa,-17,17,1359,968,-3,0,119,193,1376,951,draw
7838,May 29,2018,Mozambique,Comoros,3,0,COSAFA Cup,in South Africa,13,-13,1310,1028,2,-1,130,187,1297,1041,T1
7839,May 29,2018,Peru,Scotland,2,0,Friendly,in Peru,5,-5,1911,1713,1,-1,10,40,1906,1718,T1
7840,May 29,2018,Panama,Northern Ireland,0,0,Friendly,in Panama,-2,2,1667,1686,0,1,48,45,1669,1684,draw
7841,May 29,2018,Kosovo,Albania,3,0,Friendly,in Switzerland,26,-26,1431,1570,8,-3,98,68,1405,1596,T1
7842,May 29,2018,Azerbaijan,Kyrgyzstan,3,0,Friendly,in Azerbaijan,7,-7,1400,1237,2,-4,108,154,1393,1244,T1
7843,May 29,2018,Armenia,Malta,1,1,Friendly,in Austria,-6,6,1458,1208,-1,2,90,159,1464,1202,draw
7844,May 29,2018,Argentina,Haiti,4,0,Friendly,in Argentina,1,-1,1986,1494,0,0,5,84,1985,1495,T1
7845,May 30,2018,Botswana,Malawi,1,1,COSAFA Cup,in South Africa,-1,1,1296,1279,0,0,133,139,1297,1278,draw
7846,May 30,2018,Angola,Mauritius,1,0,COSAFA Cup,in South Africa,13,-13,1253,1094,3,-3,148,177,1240,1107,T1
7847,May 30,2018,Japan,Ghana,0,2,Friendly,in Japan,-22,22,1670,1639,-3,0,47,53,1692,1617,T2
7848,May 30,2018,Estonia,Lithuania,2,0,Baltic Cup,in Estonia,11,-11,1515,1401,3,-1,80,107,1504,1412,T1
7849,May 30,2018,Central African Republic,Uganda,1,0,Friendly tournament,in Niger,21,-21,1337,1436,4,-6,122,97,1316,1457,T1
7850,May 30,2018,Austria,Russia,1,0,Friendly,in Austria,6,-6,1732,1679,1,1,34,45,1726,1685,T1
7851,May 31,2018,Mozambique,Seychelles,2,1,COSAFA Cup,in South Africa,5,-5,1315,963,1,0,129,193,1310,968,T1
7852,May 31,2018,Madagascar,Comoros,1,0,COSAFA Cup,in South Africa,5,-5,1364,1023,0,-1,119,188,1359,1028,T1
7853,May 31,2018,Slovakia,Netherlands,1,1,Friendly,in Slovakia,1,-1,1763,1906,0,0,26,11,1762,1907,draw
7854,May 31,2018,Romania,Chile,3,2,Friendly,in Austria,14,-14,1720,1860,3,0,39,15,1706,1874,T1
7855,May 31,2018,Morocco,Ukraine,0,0,Friendly,in Switzerland,1,-1,1712,1740,-1,1,42,31,1711,1741,draw
7856,May 31,2018,Luxembourg,Senegal,0,0,Friendly,in Luxembourg,7,-7,1333,1740,1,-3,123,31,1326,1747,draw
7857,June 1,2018,Botswana,Mauritius,6,0,COSAFA Cup,in South Africa,20,-20,1316,1074,6,-4,127,181,1296,1094,T1
7858,June 1,2018,Angola,Malawi,0,0,COSAFA Cup,in South Africa,1,-1,1254,1278,0,0,148,139,1253,1279,draw
7859,June 1,2018,Tunisia,Turkey,2,2,Friendly,in Switzerland,2,-2,1659,1727,0,-2,49,37,1657,1729,draw
7860,June 1,2018,South Korea,Bosnia and Herzegovina,1,3,Friendly,in South Korea,-20,20,1731,1745,-9,7,36,29,1751,1725,T2
7861,June 1,2018,India,Taiwan,5,0,Friendly tournament,in India,11,-11,1160,983,1,0,170,192,1149,994,T1
7862,June 1,2018,Georgia,Malta,1,0,Friendly,in Austria,3,-3,1509,1205,1,-2,82,161,1506,1208,T1
7863,June 1,2018,France,Italy,3,1,Friendly,in France,8,-8,1995,1893,0,0,4,12,1987,1901,T1
7864,June 1,2018,Colombia,Egypt,0,0,Friendly,in Italy,-7,7,1928,1650,-1,2,9,50,1935,1643,draw
7865,June 1,2018,Australia,Czechia,4,0,Friendly,in Austria,19,-19,1733,1703,6,-5,34,42,1714,1722,T1
7866,June 1,2018,Algeria,Cape Verde,2,3,Friendly,in Algeria,-15,15,1509,1443,-6,4,82,96,1524,1428,T2
7867,June 2,2018,Namibia,Zambia,0,0,COSAFA Cup,in South Africa,6,-6,1377,1464,1,-1,115,89,1371,1470,draw
7868,June 2,2018,Lesotho,Swatini,1,0,COSAFA Cup,in South Africa,23,-23,1281,1292,6,-5,139,135,1258,1315,T1
7869,June 2,2018,Thailand,China,0,2,Friendly,in Thailand,-14,14,1383,1534,-4,4,113,72,1397,1520,T2
7870,June 2,2018,Sweden,Denmark,0,0,Friendly,in Sweden,-2,2,1794,1845,0,0,20,18,1796,1843,draw
7871,June 2,2018,Northern Cyprus,Tibet,3,1,World Football Cup,in England,1,-1,1456,630,0,0,93,227,1455,631,T1
7872,June 2,2018,Niger,Uganda,2,1,Friendly tournament,in Niger,17,-17,1308,1419,4,-5,131,103,1291,1436,T1
7873,June 2,2018,Montenegro,Slovenia,0,2,Friendly,in Montenegro,-20,20,1597,1626,-7,2,61,55,1617,1606,T2
7874,June 2,2018,Mexico,Scotland,1,0,Friendly,in Mexico,4,-4,1861,1709,1,-1,15,41,1857,1713,T1
7875,June 2,2018,Latvia,Estonia,1,0,Baltic Cup,in Latvia,18,-18,1361,1497,1,-3,120,82,1343,1515,T1
7876,June 2,2018,Kenya,New Zealand,2,1,Friendly tournament,in India,21,-21,1388,1494,6,-4,112,83,1367,1515,T1
7877,June 2,2018,Ireland,United States,2,1,Friendly,in Ireland,8,-8,1729,1756,1,-1,37,26,1721,1764,T1
7878,June 2,2018,Iceland,Norway,2,3,Friendly,in Iceland,-17,17,1770,1632,-2,1,23,54,1787,1615,T2
7879,June 2,2018,England,Nigeria,2,1,Friendly,in England,2,-2,1943,1691,0,0,7,43,1941,1693,T1
7880,June 2,2018,El Salvador,Honduras,1,0,Friendly,in the United States,14,-14,1471,1590,4,-5,87,64,1457,1604,T1
7881,June 2,2018,Belgium,Portugal,0,0,Friendly,in Belgium,-2,2,1929,1969,0,0,8,6,1931,1967,draw
7882,June 2,2018,Austria,Germany,2,1,Friendly,in Austria,16,-16,1748,2076,8,0,27,2,1732,2092,T1
7883,June 3,2018,South Africa,Madagascar,0,0,COSAFA Cup,in South Africa,-14,14,1543,1378,-1,4,70,115,1557,1364,draw
7884,June 3,2018,Botswana,Zimbabwe,1,1,COSAFA Cup,in South Africa,7,-7,1323,1444,1,0,126,95,1316,1451,draw
7885,June 3,2018,Ukraine,Albania,4,1,Friendly,in France,10,-10,1750,1560,4,0,28,68,1740,1570,T1
7886,June 3,2018,Spain,Switzerland,1,1,Friendly,in Spain,-7,7,2042,1886,0,0,3,14,2049,1879,draw
7887,June 3,2018,Peru,Saudi Arabia,3,0,Friendly,in Switzerland,5,-5,1916,1592,0,-2,10,63,1911,1597,T1
7888,June 3,2018,Costa Rica,Northern Ireland,3,0,Friendly,in Costa Rica,10,-10,1755,1676,3,-1,27,45,1745,1686,T1
7889,June 3,2018,Brazil,Croatia,2,0,Friendly,in England,5,-5,2136,1848,0,0,1,17,2131,1853,T1
7890,June 3,2018,Barbados,Belize,0,0,Friendly,in Barbados,-2,2,1135,1170,0,0,173,169,1137,1168,draw
7891,June 3,2018,Andorra,Cape Verde,0,0,Friendly,in Portugal,8,-8,1034,1435,1,-1,186,97,1026,1443,draw
7892,June 4,2018,Morocco,Slovakia,2,1,Friendly,in Switzerland,11,-11,1723,1752,1,-2,39,27,1712,1763,T1
7893,June 4,2018,Italy,Netherlands,1,1,Friendly,in Italy,-2,2,1891,1908,0,0,12,11,1893,1906,draw
7894,June 4,2018,India,Kenya,3,0,Friendly tournament,in India,36,-36,1196,1352,6,-9,164,121,1160,1388,T1
7895,June 4,2018,Chile,Serbia,1,0,Friendly,in Austria,7,-7,1867,1763,1,-1,15,24,1860,1770,T1
7896,June 4,2018,Armenia,Moldova,0,0,Friendly,in Austria,-4,4,1454,1329,-3,1,94,124,1458,1325,draw
7897,June 5,2018,South Africa,Namibia,4,1,COSAFA Cup,in South Africa,12,-12,1555,1365,1,-4,69,119,1543,1377,T1
7898,June 5,2018,Botswana,Swatini,2,0,COSAFA Cup,in South Africa,27,-27,1350,1265,4,-9,122,144,1323,1292,T1
7899,June 5,2018,Russia,Turkey,1,1,Friendly,in Russia,-1,1,1678,1728,0,0,44,38,1679,1727,draw
7900,June 5,2018,Romania,Finland,2,0,Friendly,in Romania,7,-7,1727,1597,1,-2,39,60,1720,1604,T1
7901,June 5,2018,New Zealand,Taiwan,1,0,Friendly tournament,in India,2,-2,1496,981,0,0,83,192,1494,983,T1
7902,June 5,2018,Martinique,French Guiana,3,0,Friendly tournament,in Martinique,16,-16,1439,1361,6,-5,96,120,1423,1377,T1
7903,June 5,2018,Luxembourg,Georgia,1,0,Friendly,in Luxembourg,12,-12,1345,1497,0,-1,123,81,1333,1509,T1
7904,June 5,2018,Lithuania,Latvia,1,1,Baltic Cup,in Lithuania,-6,6,1395,1367,0,1,107,118,1401,1361,draw
7905,June 5,2018,Kazakhstan,Azerbaijan,3,0,Friendly,in Kazakhstan,15,-15,1369,1385,3,-3,117,111,1354,1400,T1
7906,June 6,2018,Zambia,Madagascar,1,0,COSAFA Cup,in South Africa,15,-15,1479,1363,3,-5,86,119,1464,1378,T1
7907,June 6,2018,Lesotho,Zimbabwe,0,0,COSAFA Cup,in South Africa,9,-9,1290,1435,2,-2,136,97,1281,1444,draw
7908,June 6,2018,Norway,Panama,1,0,Friendly,in Norway,8,-8,1640,1659,1,0,53,48,1632,1667,T1
7909,June 6,2018,Czechia,Nigeria,1,0,Friendly,in Austria,10,-10,1713,1681,1,0,41,43,1703,1691,T1
7910,June 6,2018,Belgium,Egypt,3,0,Friendly,in Belgium,4,-4,1933,1646,0,0,8,50,1929,1650,T1
7911,June 6,2018,Belarus,Hungary,1,1,Friendly,in Belarus,-1,1,1530,1585,0,0,75,66,1531,1584,draw
7912,June 7,2018,Uruguay,Uzbekistan,3,0,Friendly,in Uruguay,3,-3,1894,1599,0,-1,12,59,1891,1602,T1
7913,June 7,2018,Portugal,Algeria,3,0,Friendly,in Portugal,1,-1,1970,1508,0,0,6,80,1969,1509,T1
7914,June 7,2018,India,New Zealand,1,2,Friendly tournament,in India,-7,7,1189,1503,-3,2,167,81,1196,1496,T2
7915,June 7,2018,Iceland,Ghana,2,2,Friendly,in Iceland,-6,6,1764,1645,0,2,23,52,1770,1639,draw
7916,June 7,2018,French Guiana,Guadeloupe,2,0,Friendly tournament,in Martinique,16,-16,1377,1243,6,-5,114,150,1361,1259,T1
7917,June 7,2018,England,Costa Rica,2,0,Friendly,in England,5,-5,1948,1750,0,-1,7,27,1943,1755,T1
7918,June 7,2018,Bolivia,South Korea,0,0,Friendly,in Austria,2,-2,1675,1729,0,0,46,36,1673,1731,draw
7919,June 8,2018,South Africa,Botswana,3,0,COSAFA Cup,in South Africa,10,-10,1565,1340,1,0,68,122,1555,1350,T1
7920,June 8,2018,Lesotho,Madagascar,1,0,COSAFA Cup,in South Africa,24,-24,1314,1339,5,-3,131,123,1290,1363,T1
7921,June 8,2018,Switzerland,Japan,2,0,Friendly,in Switzerland,4,-4,1890,1666,0,0,14,47,1886,1670,T1
7922,June 8,2018,Poland,Chile,2,2,Friendly,in Poland,-2,2,1829,1869,0,0,19,15,1831,1867,draw
7923,June 8,2018,Kenya,Taiwan,4,0,Friendly tournament,in India,6,-6,1358,975,1,0,120,192,1352,981,T1
7924,June 8,2018,Iran,Lithuania,1,0,Friendly,in Russia,2,-2,1789,1393,0,-1,21,108,1787,1395,T1
7925,June 8,2018,Germany,Saudi Arabia,2,1,Friendly,in Germany,1,-1,2077,1591,0,0,2,63,2076,1592,T1
7926,June 8,2018,Croatia,Senegal,2,1,Friendly,in Croatia,5,-5,1853,1735,0,-1,17,34,1848,1740,T1
7927,June 9,2018,Zimbabwe,Zambia,4,2,COSAFA Cup,in South Africa,34,-34,1469,1445,8,-9,89,95,1435,1479,T1
7928,June 9,2018,Tuvalu,Chagos Islands,6,1,Friendly,in England,22,-22,780,776,3,-2,211,212,758,798,T1
7929,June 9,2018,Sweden,Peru,0,0,Friendly,in Sweden,1,-1,1795,1915,0,0,20,10,1794,1916,draw
7930,June 9,2018,Spain,Tunisia,1,0,Friendly,in Russia,2,-2,2044,1657,0,-1,3,49,2042,1659,T1
7931,June 9,2018,Serbia,Bolivia,5,1,Friendly,in Austria,14,-14,1777,1661,2,-1,22,47,1763,1675,T1
7932,June 9,2018,Latvia,Azerbaijan,1,3,Friendly,in Latvia,-18,18,1349,1403,-2,5,120,106,1367,1385,T2
7933,June 9,2018,Hungary,Australia,1,2,Friendly,in Hungary,-9,9,1576,1742,0,2,66,33,1585,1733,T2
7934,June 9,2018,France,United States,1,1,Friendly,in France,-8,8,1987,1764,0,1,4,24,1995,1756,draw
7935,June 9,2018,Finland,Belarus,2,0,Friendly,in Finland,8,-8,1605,1522,2,-1,58,76,1597,1530,T1
7936,June 9,2018,Estonia,Morocco,1,3,Friendly,in Estonia,-10,10,1487,1733,-2,4,84,36,1497,1723,T2
7937,June 9,2018,Denmark,Mexico,2,0,Friendly,in Denmark,11,-11,1856,1850,2,-2,16,18,1845,1861,T1
7938,June 10,2018,India,Kenya,2,0,Friendly tournament,in India,27,-27,1216,1331,8,-5,159,124,1189,1358,T1
7939,June 10,2018,Austria,Brazil,0,3,Friendly,in Austria,-6,6,1742,2142,-3,0,32,1,1748,2136,T2
7940,June 11,2018,Senegal,South Korea,2,0,Friendly,in Austria,15,-15,1750,1714,8,-3,27,40,1735,1729,T1
7941,June 11,2018,Belgium,Costa Rica,4,1,Friendly,in Belgium,6,-6,1939,1744,0,-5,8,32,1933,1750,T1
7942,June 12,2018,Poland,Lithuania,4,0,Friendly,in Poland,2,-2,1831,1391,0,0,19,109,1829,1393,T1
7943,June 12,2018,Japan,Paraguay,4,2,Friendly,in Austria,18,-18,1684,1728,3,-7,43,37,1666,1746,T1
7944,June 14,2018,Russia,Saudi Arabia,5,0,World Cup,in Russia,31,-31,1709,1560,3,-5,42,68,1678,1591,T1
7945,June 15,2018,Uruguay,Egypt,1,0,World Cup,in Russia,12,-12,1906,1634,0,-4,12,54,1894,1646,T1
7946,June 15,2018,Portugal,Spain,3,3,World Cup,in Russia,6,-6,1976,2038,0,0,6,3,1970,2044,draw
7947,June 15,2018,Iran,Morocco,1,0,World Cup,in Russia,25,-25,1814,1708,1,-8,20,43,1789,1733,T1
7948,June 16,2018,France,Australia,2,1,World Cup,in Russia,12,-12,1999,1730,0,-2,4,34,1987,1742,T1
7949,June 16,2018,Denmark,Peru,1,0,World Cup,in Russia,35,-35,1891,1880,4,-5,12,15,1856,1915,T1
7950,June 16,2018,Croatia,Nigeria,2,0,World Cup,in Russia,24,-24,1877,1657,1,-3,16,48,1853,1681,T1
7951,June 16,2018,Argentina,Iceland,1,1,World Cup,in Russia,-17,17,1969,1781,-1,2,6,22,1986,1764,draw
