,Date,Year,Country_1,Country_2,Score_1,Score_2,Competition,Location,Elo_Score_Change_1,Elo_Score_Change_2,Elo_Score_New_1,Elo_Score_New_2,Rank_Change_1,Rank_Change_2,Rank_New_1,Rank_New_2,Elo_Score_Before_1,Elo_Score_Before_2,Outcome
0,January 2,2010,Iran,North Korea,1,0,Friendly tournament,in Qatar,12,-12,1646,1543,1,-6,49,79,1634,1555,T1
1,January 2,2010,Mali,Qatar,0,0,Friendly tournament,in Qatar,3,-3,1574,1527,0,-1,68,83,1571,1530,draw
2,January 2,2010,Zimbabwe,Syria,0,6,Friendly,in Malaysia,-10,10,1332,1556,-3,4,124,73,1342,1546,T1
3,January 2,2010,Tajikistan,Yemen,1,0,Friendly,in Yemen,12,-12,1277,1222,2,-2,135,151,1265,1234,T2
4,January 3,2010,Angola,Gambia,1,1,Friendly,in Portugal,-1,1,1445,1395,0,0,101,113,1446,1394,draw
5,January 3,2010,Mozambique,Gabon,0,1,Friendly,in South Africa,-7,7,1420,1540,-1,1,107,80,1427,1533,T1
6,January 4,2010,Mali,Egypt,0,1,Friendly,in the United Arab Emirates,-7,7,1567,1703,-2,0,70,41,1574,1696,T1
7,January 4,2010,Tanzania,Ivory Coast,0,1,Friendly,in Tanzania,-3,3,1342,1764,0,0,120,28,1345,1761,T2
8,January 5,2010,Ghana,Malawi,0,0,Friendly,in Swaziland,-7,7,1679,1364,-1,1,43,118,1686,1357,draw
9,January 6,2010,Bahrain,Hong Kong,4,0,Asian Cup qualifier,in Bahrain,4,-4,1620,1218,0,-2,54,153,1616,1222,T1
10,January 6,2010,Benin,Libya,1,0,Friendly,in Benin,8,-8,1466,1484,2,-2,94,89,1458,1492,T1
11,January 6,2010,China,Syria,0,0,Asian Cup qualifier,in China,-5,5,1540,1561,-3,1,80,72,1545,1556,draw
12,January 6,2010,Mozambique,Gabon,0,2,Friendly,in South Africa,-10,10,1410,1550,-2,5,109,75,1420,1540,T1
13,January 6,2010,Oman,Indonesia,2,1,Asian Cup qualifier,in Indonesia,8,-8,1605,1259,1,-1,58,138,1597,1267,T2
14,January 6,2010,Australia,Kuwait,2,2,Asian Cup qualifier,in Kuwait,-11,11,1779,1487,-4,3,23,87,1790,1476,draw
15,January 6,2010,Lebanon,Vietnam,1,1,Asian Cup qualifier,in Lebanon,2,-2,1227,1361,0,0,150,119,1225,1363,draw
16,January 6,2010,Zambia,Nigeria,0,0,Friendly,in South Africa,6,-6,1503,1742,0,-3,86,36,1497,1748,draw
17,January 6,2010,Singapore,Iran,1,3,Asian Cup qualifier,in Singapore,-18,18,1379,1664,-3,0,115,49,1397,1646,T2
18,January 6,2010,Jordan,Thailand,0,0,Asian Cup qualifier,in Thailand,6,-6,1466,1470,1,-2,94,92,1460,1476,draw
19,January 6,2010,Malaysia,United Arab Emirates,0,1,Asian Cup qualifier,in the United Arab Emirates,-5,5,1168,1403,0,0,164,111,1173,1398,T1
20,January 6,2010,Yemen,Japan,2,3,Asian Cup qualifier,in Yemen,-3,3,1219,1792,0,2,151,18,1222,1789,T2
21,January 7,2010,Ivory Coast,Rwanda,2,0,Friendly,in Tanzania,3,-3,1767,1402,1,-1,27,111,1764,1405,T1
22,January 9,2010,Kenya,Cameroon,1,3,Friendly,in Kenya,-4,4,1335,1779,0,1,122,23,1339,1775,T2
23,January 9,2010,Tunisia,Gambia,1,2,Friendly,in Tunisia,-17,17,1610,1412,-3,3,55,109,1627,1395,T2
24,January 9,2010,South Korea,Zambia,2,4,Friendly,in South Africa,-24,24,1725,1527,-4,3,36,83,1749,1503,T1
25,January 10,2010,Mali,Angola,4,4,African Nations Cup,in Angola,-2,2,1565,1447,0,1,70,100,1567,1445,draw
26,January 11,2010,Burkina Faso,Ivory Coast,0,0,African Nations Cup,in Angola,17,-17,1493,1750,4,-4,87,31,1476,1767,draw
27,January 11,2010,Malawi,Algeria,3,0,African Nations Cup,in Angola,68,-68,1432,1517,13,-21,105,85,1364,1585,T1
28,January 12,2010,Mozambique,Benin,2,2,African Nations Cup,in Angola,4,-4,1414,1462,1,-2,110,96,1410,1466,draw
29,January 12,2010,Egypt,Nigeria,3,1,African Nations Cup,in Angola,42,-42,1745,1700,6,-6,35,41,1703,1742,T1
30,January 13,2010,Cameroon,Gabon,0,1,African Nations Cup,in Angola,-39,39,1740,1589,-12,14,35,60,1779,1550,T1
31,January 13,2010,Zambia,Tunisia,1,1,African Nations Cup,in Angola,6,-6,1533,1604,1,-3,81,58,1527,1610,draw
32,January 14,2010,Algeria,Mali,1,0,African Nations Cup,in Angola,28,-28,1545,1537,9,-11,76,81,1517,1565,T1
33,January 14,2010,Malawi,Angola,0,2,African Nations Cup,in Angola,-26,26,1406,1473,-6,8,111,92,1432,1447,T1
34,January 15,2010,Ivory Coast,Ghana,3,1,African Nations Cup,in Angola,30,-30,1780,1649,7,-6,23,49,1750,1679,T1
35,January 15,2010,Kenya,Yemen,1,3,Friendly,in Yemen,-16,16,1319,1235,-4,3,126,148,1335,1219,T1
36,January 16,2010,Mozambique,Egypt,0,2,African Nations Cup,in Angola,-10,10,1404,1755,-2,3,111,31,1414,1745,T1
37,January 16,2010,Benin,Nigeria,0,1,African Nations Cup,in Angola,-10,10,1452,1710,-1,1,98,40,1462,1700,T1
38,January 16,2010,Philippines,Taiwan,0,0,Friendly,in Taiwan,5,-5,821,923,0,-1,205,195,816,928,draw
39,January 17,2010,Cameroon,Zambia,3,2,African Nations Cup,in Angola,12,-12,1752,1521,3,-2,32,84,1740,1533,T1
40,January 17,2010,Tunisia,Gabon,0,0,African Nations Cup,in Angola,-1,1,1603,1590,0,0,58,60,1604,1589,draw
41,January 17,2010,Singapore,Thailand,0,1,King's Cup,in Thailand,-7,7,1372,1477,-1,1,117,92,1379,1470,T1
42,January 17,2010,Vietnam,China,1,2,Asian Cup qualifier,in Vietnam,-16,16,1345,1556,0,6,119,73,1361,1540,T2
43,January 18,2010,Angola,Algeria,0,0,African Nations Cup,in Angola,-2,2,1471,1547,0,-1,93,78,1473,1545,draw
44,January 18,2010,Mali,Malawi,3,1,African Nations Cup,in Angola,24,-24,1561,1382,10,-4,71,114,1537,1406,T1
45,January 18,2010,Finland,South Korea,0,2,Friendly,in Spain,-13,13,1666,1738,-2,0,45,36,1679,1725,T1
46,January 19,2010,Ghana,Burkina Faso,1,0,African Nations Cup,in Angola,14,-14,1663,1479,0,-3,49,90,1649,1493,T1
47,January 20,2010,Panama,Chile,1,2,Friendly,in Chile,-2,2,1551,1883,0,0,75,11,1553,1881,T1
48,January 20,2010,Benin,Egypt,0,2,African Nations Cup,in Angola,-11,11,1441,1766,-4,3,102,28,1452,1755,T1
49,January 20,2010,Mozambique,Nigeria,0,3,African Nations Cup,in Angola,-13,13,1391,1723,-2,3,112,37,1404,1710,T1
50,January 20,2010,Sweden,Oman,1,0,Friendly,in Oman,8,-8,1781,1597,2,-1,23,58,1773,1605,T2
51,January 20,2010,Poland,Thailand,3,1,King's Cup,in Thailand,19,-19,1652,1458,1,-4,50,96,1633,1477,T2
52,January 20,2010,Bahrain,Yemen,0,3,Asian Cup qualifier,in Yemen,-59,59,1561,1294,-17,15,70,133,1620,1235,T1
53,January 21,2010,Tunisia,Cameroon,2,2,African Nations Cup,in Angola,10,-10,1613,1742,3,-3,53,35,1603,1752,draw
54,January 21,2010,Zambia,Gabon,2,1,African Nations Cup,in Angola,30,-30,1551,1560,9,-13,75,72,1521,1590,T1
55,January 22,2010,Latvia,South Korea,0,1,Friendly,in Spain,-6,6,1564,1744,-1,1,67,35,1570,1738,T1
56,January 23,2010,Singapore,Poland,1,6,King's Cup,in Thailand,-10,10,1362,1662,-1,0,118,50,1372,1652,T1
57,January 23,2010,Swaziland,South Africa,2,6,Friendly,in South Africa,-3,3,1171,1523,0,0,163,85,1174,1520,T1
58,January 23,2010,Sweden,Syria,1,1,Friendly,in Syria,-3,3,1778,1564,-2,2,25,67,1781,1561,draw
59,January 23,2010,Honduras,United States,3,1,Friendly,in the United States,21,-21,1769,1783,5,-3,27,20,1748,1804,T2
60,January 24,2010,Algeria,Ivory Coast,3,2,African Nations Cup,in Angola,40,-40,1587,1740,19,-13,60,36,1547,1780,T1
61,January 24,2010,Angola,Ghana,0,1,African Nations Cup,in Angola,-19,19,1452,1682,-5,6,97,43,1471,1663,T2
62,January 25,2010,Cameroon,Egypt,1,3,African Nations Cup,in Angola,-35,35,1707,1801,-5,11,40,17,1742,1766,T1
63,January 25,2010,Nigeria,Zambia,0,0,African Nations Cup,in Angola,-11,11,1712,1562,-2,5,39,71,1723,1551,draw
64,January 26,2010,Costa Rica,Argentina,2,3,Friendly,in Argentina,-3,3,1701,1899,0,0,41,7,1704,1896,T1
65,January 27,2010,South Africa,Zimbabwe,3,0,Friendly,in South Africa,6,-6,1529,1326,2,0,83,123,1523,1332,T1
66,January 28,2010,Egypt,Algeria,4,0,African Nations Cup,in Angola,21,-21,1822,1566,2,-7,15,67,1801,1587,T1
67,January 28,2010,Ghana,Nigeria,1,0,African Nations Cup,in Angola,27,-27,1709,1685,4,-3,39,42,1682,1712,T1
68,January 30,2010,Nigeria,Algeria,1,0,African Nations Cup,in Angola,17,-17,1702,1549,1,-10,41,77,1685,1566,T1
69,January 31,2010,Ghana,Egypt,0,1,African Nations Cup,in Angola,-17,17,1692,1839,-3,1,42,14,1709,1822,T1
70,January 31,2010,Jamaica,Canada,1,0,Friendly,in Jamaica,7,-7,1629,1600,0,-2,52,57,1622,1607,T1
71,February 2,2010,Venezuela,Japan,0,0,Friendly,in Japan,5,-5,1727,1787,0,-1,36,19,1722,1792,draw
72,February 6,2010,China,Japan,0,0,East Asian Cup,in Japan,15,-15,1571,1772,9,-7,66,26,1556,1787,draw
73,February 7,2010,Hong Kong,South Korea,0,5,East Asian Cup,in Japan,-4,4,1214,1748,0,2,153,32,1218,1744,T1
74,February 10,2010,Argentina,Jamaica,2,1,Friendly tournament,in Argentina,3,-3,1902,1626,0,0,7,52,1899,1629,T1
75,February 10,2010,China,South Korea,3,0,East Asian Cup,in Japan,51,-51,1622,1697,13,-9,53,41,1571,1748,T1
76,February 11,2010,Japan,Hong Kong,3,0,East Asian Cup,in Japan,2,-2,1774,1212,1,-2,25,155,1772,1214,T1
77,February 14,2010,Hong Kong,China,0,2,East Asian Cup,in Japan,-5,5,1207,1627,-1,1,156,52,1212,1622,T1
78,February 14,2010,Japan,South Korea,1,3,East Asian Cup,in Japan,-44,44,1730,1741,-10,8,35,33,1774,1697,T2
79,February 16,2010,Tajikistan,Bangladesh,1,2,Asian Cup qual &amp; Asian Challenge Cup,in Sri Lanka,-35,35,1242,976,-9,2,145,188,1277,941,T1
80,February 16,2010,Myanmar,Sri Lanka,4,0,Asian Cup qual &amp; Asian Challenge Cup,in Sri Lanka,22,-22,1211,912,2,-5,156,197,1189,934,T2
81,February 17,2010,Kosovo,Albania,2,3,Friendly,in Kosovo,-10,10,1379,1497,-2,0,115,87,1389,1487,T2
82,February 17,2010,Kyrgyzstan,India,2,1,Asian Cup qual &amp; Asian Challenge Cup,in Sri Lanka,25,-25,1187,1220,6,-9,159,151,1162,1245,T1
83,February 17,2010,Turkmenistan,North Korea,1,1,Asian Cup qual &amp; Asian Challenge Cup,in Sri Lanka,12,-12,1310,1531,1,-1,130,82,1298,1543,draw
84,February 18,2010,Myanmar,Bangladesh,2,1,Asian Cup qual &amp; Asian Challenge Cup,in Sri Lanka,8,-8,1219,968,4,0,152,188,1211,976,T1
85,February 18,2010,Tajikistan,Sri Lanka,3,1,Asian Cup qual &amp; Asian Challenge Cup,in Sri Lanka,13,-13,1255,899,4,0,140,197,1242,912,T2
86,February 19,2010,Kuwait,Syria,1,1,Friendly,in the United Arab Emirates,2,-2,1489,1562,0,-2,88,70,1487,1564,draw
87,February 19,2010,North Korea,Kyrgyzstan,4,0,Asian Cup qual &amp; Asian Challenge Cup,in Sri Lanka,9,-9,1540,1178,1,-2,81,161,1531,1187,T1
88,February 19,2010,Turkmenistan,India,1,0,Asian Cup qual &amp; Asian Challenge Cup,in Sri Lanka,15,-15,1325,1205,6,-6,124,157,1310,1220,T1
89,February 20,2010,Sri Lanka,Bangladesh,3,0,Asian Cup qual &amp; Asian Challenge Cup,in Sri Lanka,32,-32,931,936,5,-3,192,191,899,968,T1
90,February 20,2010,Tajikistan,Myanmar,3,0,Asian Cup qual &amp; Asian Challenge Cup,in Sri Lanka,31,-31,1286,1188,4,-7,136,158,1255,1219,T1
91,February 21,2010,India,North Korea,0,3,Asian Cup qual &amp; Asian Challenge Cup,in Sri Lanka,-9,9,1196,1549,0,4,156,77,1205,1540,T1
92,February 21,2010,Turkmenistan,Kyrgyzstan,1,0,Asian Cup qual &amp; Asian Challenge Cup,in Sri Lanka,12,-12,1337,1166,2,-4,122,165,1325,1178,T1
93,February 24,2010,Bolivia,Mexico,0,5,Friendly,in the United States,-6,6,1595,1898,-2,0,59,8,1601,1892,T1
94,February 24,2010,Myanmar,North Korea,0,5,Asian Cup qual &amp; Asian Challenge Cup,in Sri Lanka,-9,9,1179,1558,-1,2,159,75,1188,1549,T1
95,February 24,2010,Turkmenistan,Tajikistan,2,0,Asian Cup qual &amp; Asian Challenge Cup,in Sri Lanka,26,-26,1363,1260,4,-2,118,138,1337,1286,T1
96,February 24,2010,United States,El Salvador,2,1,Friendly,in the United States,2,-2,1785,1514,1,0,19,86,1783,1516,T1
97,February 25,2010,Jordan,Azerbaijan,0,2,Friendly,in Jordan,-21,21,1445,1440,-7,4,100,103,1466,1419,T2
98,February 25,2010,Bahrain,Kuwait,1,4,Friendly,in the United Arab Emirates,-21,21,1540,1510,-9,1,81,87,1561,1489,T1
99,February 27,2010,Malaysia,Yemen,1,0,Friendly,in Malaysia,11,-11,1179,1283,5,-2,159,135,1168,1294,T1
100,February 27,2010,Turkmenistan,North Korea,1,1,Asian Cup qual &amp; Asian Challenge Cup,in Sri Lanka,10,-10,1373,1548,1,-3,117,77,1363,1558,draw
101,February 27,2010,Myanmar,Tajikistan,0,1,Asian Cup qual &amp; Asian Challenge Cup,in Sri Lanka,-15,15,1164,1275,-6,2,165,136,1179,1260,T1
102,February 28,2010,Bonaire,Curaçao,0,4,Friendly,in Curaçao,-8,8,992,1138,0,0,185,171,1000,1130,T1
103,March 2,2010,Brazil,Ireland,2,0,Friendly,in England,4,-4,2108,1763,0,0,1,27,2104,1767,T1
104,March 2,2010,Guadeloupe,Saint Kitts and Nevis,2,1,Friendly,in Guadeloupe,2,-2,1471,1137,0,-1,92,171,1469,1139,T1
105,March 3,2010,Northern Ireland,Albania,0,1,Friendly,in Albania,-9,9,1568,1506,-2,1,67,87,1577,1497,T1
106,March 3,2010,Algeria,Serbia,0,3,Friendly,in Algeria,-9,9,1540,1843,-3,1,79,14,1549,1834,T2
107,March 3,2010,Angola,Latvia,1,1,Friendly,in Angola,0,0,1452,1564,-1,-3,97,71,1452,1564,draw
108,March 3,2010,Australia,Indonesia,1,0,Asian Cup qualifier,in Australia,1,-1,1780,1258,1,0,22,139,1779,1259,T1
109,March 3,2010,Denmark,Austria,1,2,Friendly,in Austria,-13,13,1799,1602,0,4,17,56,1812,1589,T1
110,March 3,2010,Belarus,Armenia,3,1,Friendly,in Turkey,7,-7,1589,1373,4,-1,60,115,1582,1380,T1
111,March 3,2010,Croatia,Belgium,1,0,Friendly,in Belgium,5,-5,1893,1582,1,-4,9,65,1888,1587,T2
112,March 3,2010,Bosnia and Herzegovina,Ghana,2,1,Friendly,in Bosnia and Herzegovina,9,-9,1650,1683,0,-1,51,43,1641,1692,T1
113,March 3,2010,Cameroon,Italy,0,0,Friendly,in Monaco,6,-6,1713,1951,1,1,38,5,1707,1957,draw
114,March 3,2010,Iceland,Cyprus,0,0,Friendly,in Cyprus,6,-6,1453,1557,3,-6,96,75,1447,1563,draw
115,March 3,2010,Egypt,England,1,3,Friendly,in England,-6,6,1833,1991,-1,0,15,4,1839,1985,T1
116,March 3,2010,France,Spain,0,2,Friendly,in France,-11,11,1879,2106,-2,0,11,2,1890,2095,T2
117,March 3,2010,Estonia,Georgia,1,2,Friendly,in Georgia,-8,8,1444,1444,-5,3,101,101,1452,1436,T1
118,March 3,2010,Argentina,Germany,1,0,Friendly,in Germany,14,-14,1916,1948,0,-1,7,6,1902,1962,T2
119,March 3,2010,Greece,Senegal,0,2,Friendly,in Greece,-26,26,1757,1571,-8,14,29,66,1783,1545,T2
120,March 3,2010,El Salvador,Guatemala,1,2,Friendly,in the United States,-12,12,1502,1438,-2,2,88,105,1514,1426,T1
121,March 3,2010,Yemen,Hong Kong,0,0,Asian Cup qualifier,in Hong Kong,1,-1,1284,1206,0,0,135,155,1283,1207,draw
122,March 3,2010,Russia,Hungary,1,1,Friendly,in Hungary,-4,4,1848,1615,0,1,13,54,1852,1611,draw
123,March 3,2010,Thailand,Iran,0,1,Asian Cup qualifier,in Iran,-6,6,1452,1670,-3,2,97,47,1458,1664,T1
124,March 3,2010,Bahrain,Japan,0,2,Asian Cup qualifier,in Japan,-10,10,1530,1740,0,2,81,33,1540,1730,T1
125,March 3,2010,Jordan,Singapore,2,1,Asian Cup qualifier,in Jordan,10,-10,1455,1352,6,0,94,119,1445,1362,T1
126,March 3,2010,Libya,Mali,2,1,Friendly,in Libya,9,-9,1493,1552,0,-5,89,77,1484,1561,T1
127,March 3,2010,Luxembourg,Azerbaijan,1,2,Friendly,in Luxembourg,-4,4,1098,1444,0,2,176,101,1102,1440,T2
128,March 3,2010,Montenegro,Macedonia,1,2,Friendly,in Macedonia,-10,10,1656,1586,-3,3,49,63,1666,1576,T1
129,March 3,2010,Finland,Malta,2,1,Friendly,in Malta,2,-2,1668,1217,-2,0,48,151,1666,1219,T2
130,March 3,2010,Mexico,New Zealand,2,0,Friendly,in the United States,3,-3,1901,1526,0,1,8,82,1898,1529,T1
131,March 3,2010,Kazakhstan,Moldova,0,1,Friendly,in Turkey,-7,7,1334,1450,-1,2,123,99,1341,1443,T1
132,March 3,2010,Botswana,Mozambique,1,0,Friendly,in Mozambique,15,-15,1307,1376,1,-1,132,113,1292,1391,T2
133,March 3,2010,Netherlands,United States,2,1,Friendly,in the Netherlands,2,-2,2033,1783,0,-1,3,20,2031,1785,T1
134,March 3,2010,Nigeria,Democratic Republic of Congo,5,2,Friendly,in Nigeria,4,-4,1706,1426,0,-2,40,108,1702,1430,T1
135,March 3,2010,Oman,Kuwait,0,0,Asian Cup qualifier,in Oman,-10,10,1587,1520,-3,3,61,84,1597,1510,draw
136,March 3,2010,Poland,Bulgaria,2,0,Friendly,in Poland,15,-15,1677,1743,4,-2,46,32,1662,1758,T1
137,March 3,2010,China,Portugal,0,2,Friendly,in Portugal,-4,4,1623,1878,-1,0,53,12,1627,1874,T1
138,March 3,2010,Israel,Romania,2,0,Friendly,in Romania,21,-21,1739,1752,4,-6,34,31,1718,1773,T2
139,March 3,2010,Scotland,Czechia,1,0,Friendly,in Scotland,9,-9,1680,1739,1,-3,44,34,1671,1748,T1
140,March 3,2010,Norway,Slovakia,1,0,Friendly,in Slovakia,10,-10,1758,1655,3,-2,28,50,1748,1665,T2
141,March 3,2010,Slovenia,Qatar,4,1,Friendly,in Slovenia,7,-7,1680,1520,0,1,44,84,1673,1527,T1
142,March 3,2010,Namibia,South Africa,1,1,Friendly,in South Africa,7,-7,1327,1522,1,0,125,83,1320,1529,draw
143,March 3,2010,Ivory Coast,South Korea,0,2,Friendly,in England,-15,15,1725,1756,-2,3,36,30,1740,1741,T1
144,March 3,2010,Switzerland,Uruguay,1,3,Friendly,in Switzerland,-18,18,1774,1831,-5,0,23,16,1792,1813,T2
145,March 3,2010,Syria,Lebanon,4,0,Asian Cup qualifier,in Syria,6,-6,1568,1221,3,0,67,150,1562,1227,T1
146,March 3,2010,Uganda,Tanzania,3,2,Friendly,in Tanzania,7,-7,1555,1335,1,0,76,121,1548,1342,T2
147,March 3,2010,Honduras,Turkey,0,2,Friendly,in Turkey,-10,10,1759,1795,-1,1,27,18,1769,1785,T1
148,March 3,2010,Uzbekistan,United Arab Emirates,0,1,Asian Cup qualifier,in Uzbekistan,-32,32,1516,1435,-9,4,86,106,1548,1403,T2
149,March 3,2010,Panama,Venezuela,2,1,Friendly,in Venezuela,17,-17,1568,1710,8,-3,67,39,1551,1727,T2
150,March 3,2010,Sweden,Wales,1,0,Friendly,in Wales,8,-8,1786,1599,5,-2,19,58,1778,1607,T2
151,March 3,2010,Malawi,Zimbabwe,1,2,Friendly,in Zimbabwe,-9,9,1373,1335,-2,3,115,121,1382,1326,T1
152,March 4,2010,North Korea,Venezuela,1,1,Friendly,in Venezuela,6,-6,1554,1704,1,-1,77,40,1548,1710,draw
153,March 6,2010,Sierra Leone,Guinea,1,0,Friendly,in Sierra Leone,14,-14,1261,1464,3,-1,139,92,1247,1478,T1
154,March 6,2010,Venezuela,North Korea,2,1,Friendly,in Venezuela,4,-4,1708,1550,1,-1,39,78,1704,1554,T1
155,March 7,2010,Benin,Niger,0,2,Friendly,in Niger,-19,19,1422,1261,-4,5,108,140,1441,1242,T1
156,March 7,2010,Guinea,Sierra Leone,0,0,Friendly,in Sierra Leone,-3,3,1461,1264,-1,1,93,138,1464,1261,draw
157,March 17,2010,North Korea,Mexico,1,2,Friendly,in Mexico,-1,1,1549,1902,0,0,78,8,1550,1901,T1
158,March 21,2010,Iceland,Faroe Islands,2,0,Friendly,in Iceland,4,-4,1457,1208,2,0,94,154,1453,1212,T1
159,March 21,2010,Namibia,Botswana,0,0,Friendly,in Namibia,-3,3,1324,1310,0,1,125,131,1327,1307,draw
160,March 24,2010,Iceland,Mexico,0,0,Friendly,in the United States,9,-9,1466,1893,2,0,92,8,1457,1902,draw
161,March 24,2010,Haiti,Martinique,0,0,Friendly,in Martinique,1,-1,1434,1374,0,0,106,114,1433,1375,draw
162,March 31,2010,Venezuela,Chile,0,0,Friendly,in Chile,7,-7,1715,1876,1,-2,38,12,1708,1883,draw
163,March 31,2010,South Africa,Paraguay,1,1,Friendly,in Paraguay,7,-7,1529,1753,1,-5,82,30,1522,1760,draw
164,April 3,2010,Guadeloupe,Saint Kitts and Nevis,0,3,Friendly,in Saint Kitts and Nevis,-28,28,1443,1165,-12,6,103,165,1471,1137,T1
165,April 7,2010,Japan,Serbia,0,3,Friendly,in Japan,-17,17,1723,1860,-3,1,36,13,1740,1843,T2
166,April 21,2010,Honduras,Venezuela,0,1,Friendly,in Honduras,-14,14,1745,1729,-5,3,31,35,1759,1715,T2
167,April 22,2010,South Africa,North Korea,0,0,Friendly,in Germany,1,-1,1530,1548,1,0,81,78,1529,1549,draw
168,April 28,2010,Jamaica,South Africa,0,2,Friendly,in Germany,-19,19,1607,1549,-3,3,55,78,1626,1530,T1
169,May 5,2010,Haiti,Argentina,0,4,Friendly,in Argentina,-1,1,1433,1917,0,0,106,7,1434,1916,T1
170,May 5,2010,Chile,Trinidad and Tobago,2,0,Friendly,in Chile,2,-2,1878,1538,1,-1,11,81,1876,1540,T1
171,May 7,2010,Ecuador,Mexico,0,0,Friendly,in the United States,5,-5,1726,1888,2,-1,36,9,1721,1893,draw
172,May 10,2010,Mexico,Senegal,1,0,Friendly,in the United States,3,-3,1891,1568,0,0,9,66,1888,1571,T1
173,May 12,2010,Malawi,Yemen,0,1,Friendly,in Yemen,-10,10,1363,1294,-3,1,118,134,1373,1284,T1
174,May 13,2010,Malta,Germany,0,3,Friendly,in Germany,0,0,1217,1948,0,0,151,6,1217,1948,T1
175,May 13,2010,Mexico,Angola,1,0,Friendly,in the United States,1,-1,1892,1451,0,-1,9,97,1891,1452,T1
176,May 15,2010,Paraguay,North Korea,1,0,Friendly,in Switzerland,5,-5,1758,1543,3,0,26,79,1753,1548,T1
177,May 16,2010,Chile,Mexico,0,1,Friendly,in Mexico,-7,7,1871,1899,-1,1,12,8,1878,1892,T1
178,May 16,2010,Thailand,South Africa,0,4,Friendly,in South Africa,-9,9,1443,1558,-6,4,102,74,1452,1549,T1
179,May 16,2010,South Korea,Ecuador,2,0,Friendly,in South Korea,10,-10,1766,1716,5,-2,24,38,1756,1726,T1
180,May 18,2010,Yemen,Oman,0,1,Friendly tournament,in Yemen,-7,7,1287,1594,0,1,134,60,1294,1587,T2
181,May 19,2010,Croatia,Austria,1,0,Friendly,in Austria,5,-5,1898,1597,0,-2,9,58,1893,1602,T2
182,May 19,2010,Bulgaria,Belgium,1,2,Friendly,in Belgium,-12,12,1731,1594,-2,5,34,60,1743,1582,T1
183,May 19,2010,Togo,Gabon,0,3,Friendly tournament,in France,-19,19,1444,1579,-6,7,98,66,1463,1560,T1
184,May 20,2010,Venezuela,Aruba,3,0,Friendly,in Aruba,1,-1,1730,939,0,0,35,191,1729,940,T2
185,May 20,2010,Burkina Faso,Yemen,2,2,Friendly tournament,in Yemen,-4,4,1475,1291,0,0,90,134,1479,1287,draw
186,May 21,2010,Estonia,Finland,2,0,Friendly,in Estonia,20,-20,1464,1648,6,-3,92,51,1444,1668,T1
187,May 21,2010,Saudi Arabia,Democratic Republic of Congo,2,0,Friendly,in Austria,6,-6,1690,1420,0,-1,42,108,1684,1426,T1
188,May 22,2010,Oman,Burkina Faso,2,0,Friendly tournament,in Yemen,15,-15,1609,1460,5,-3,55,93,1594,1475,T1
189,May 22,2010,Czechia,Turkey,1,2,Friendly,in the United States,-8,8,1731,1803,-1,1,33,17,1739,1795,T1
190,May 23,2010,Croatia,Wales,2,0,Friendly,in Croatia,3,-3,1901,1596,1,-1,8,59,1898,1599,T1
191,May 24,2010,Argentina,Canada,5,0,Friendly,in Argentina,3,-3,1920,1597,0,0,7,57,1917,1600,T1
192,May 24,2010,Australia,New Zealand,2,1,Friendly,in Australia,2,-2,1782,1524,-1,0,23,83,1780,1526,T1
193,May 24,2010,Mexico,England,1,3,Friendly,in England,-7,7,1892,1998,0,0,9,4,1899,1991,T1
194,May 24,2010,South Korea,Japan,2,0,Friendly,in Japan,17,-17,1783,1706,4,-2,20,39,1766,1723,T2
195,May 24,2010,Cape Verde,Portugal,0,0,Friendly,in Portugal,9,-9,1376,1869,4,-1,113,12,1367,1878,draw
196,May 24,2010,Bulgaria,South Africa,1,1,Friendly,in South Africa,-2,2,1729,1560,-2,0,35,74,1731,1558,draw
197,May 25,2010,Uzbekistan,Armenia,1,3,Friendly,in Armenia,-17,17,1499,1390,-2,4,88,112,1516,1373,T1
198,May 25,2010,Georgia,Cameroon,0,0,Friendly,in Austria,6,-6,1450,1707,2,0,97,38,1444,1713,draw
199,May 25,2010,Greece,North Korea,2,2,Friendly,in Austria,-5,5,1752,1548,1,0,28,79,1757,1543,draw
200,May 25,2010,Ireland,Paraguay,2,1,Friendly,in Ireland,7,-7,1770,1751,1,-4,24,31,1763,1758,T1
201,May 25,2010,Montenegro,Albania,0,1,Friendly,in Montenegro,-16,16,1640,1522,-3,3,51,84,1656,1506,T2
202,May 25,2010,Saudi Arabia,Nigeria,0,0,Friendly,in Austria,0,0,1690,1706,0,0,42,39,1690,1706,draw
203,May 25,2010,Lithuania,Ukraine,0,4,Friendly,in Ukraine,-6,6,1580,1789,-1,1,65,19,1586,1783,T1
204,May 25,2010,Czechia,United States,4,2,Friendly,in the United States,21,-21,1752,1762,5,-5,28,25,1731,1783,T2
205,May 26,2010,Azerbaijan,Moldova,1,1,Friendly,in Austria,0,0,1444,1450,0,0,100,97,1444,1450,draw
206,May 26,2010,Chile,Zambia,3,0,Friendly,in Chile,3,-3,1874,1559,0,-1,11,74,1871,1562,T1
207,May 26,2010,Croatia,Estonia,0,0,Friendly,in Estonia,-7,7,1894,1471,0,1,8,90,1901,1464,draw
208,May 26,2010,France,Costa Rica,2,1,Friendly,in France,3,-3,1882,1698,0,0,10,41,1879,1701,T1
209,May 26,2010,Netherlands,Mexico,2,1,Friendly,in Germany,6,-6,2039,1886,0,0,3,9,2033,1892,T1
210,May 26,2010,Turkey,Northern Ireland,2,0,Friendly,in the United States,6,-6,1809,1562,0,-5,17,72,1803,1568,T1
211,May 26,2010,Uruguay,Israel,4,1,Friendly tournament,in Uruguay,13,-13,1844,1726,1,-2,15,35,1831,1739,T1
212,May 27,2010,Honduras,Belarus,2,2,Friendly,in Austria,-4,4,1741,1593,0,0,32,62,1745,1589,draw
213,May 27,2010,Senegal,Denmark,0,2,Friendly,in Denmark,-4,4,1564,1803,-4,0,71,18,1568,1799,T1
214,May 27,2010,Colombia,South Africa,1,2,Friendly,in South Africa,-13,13,1747,1573,-5,6,31,67,1760,1560,T1
215,May 28,2010,Algeria,Ireland,0,3,Friendly,in Ireland,-5,5,1535,1775,-1,1,81,23,1540,1770,T1
216,May 29,2010,Cameroon,Slovakia,1,1,Friendly,in Austria,-1,1,1706,1656,0,0,38,48,1707,1655,draw
217,May 29,2010,Hungary,Germany,0,3,Friendly,in Hungary,-7,7,1608,1955,-2,1,55,5,1615,1948,T2
218,May 29,2010,Iceland,Andorra,4,0,Friendly,in Iceland,2,-2,1468,1024,0,-1,91,184,1466,1026,T1
219,May 29,2010,Azerbaijan,Macedonia,1,3,Friendly,in Austria,-9,9,1435,1595,-5,4,105,60,1444,1586,T1
220,May 29,2010,Serbia,New Zealand,0,1,Friendly,in Austria,-17,17,1843,1541,-2,3,15,80,1860,1524,T1
221,May 29,2010,Montenegro,Norway,1,2,Friendly,in Norway,-4,4,1636,1762,0,0,51,26,1640,1758,T1
222,May 29,2010,Poland,Finland,0,0,Friendly,in Poland,-4,4,1673,1652,0,1,46,49,1677,1648,draw
223,May 29,2010,Spain,Saudi Arabia,3,2,Friendly,in Austria,2,-2,2108,1688,1,0,1,42,2106,1690,T1
224,May 29,2010,Sweden,Bosnia and Herzegovina,4,2,Friendly,in Sweden,6,-6,1792,1644,0,-1,20,50,1786,1650,T1
225,May 29,2010,United Arab Emirates,Moldova,3,2,Friendly,in Austria,10,-10,1445,1440,6,-6,99,103,1435,1450,T1
226,May 29,2010,Ukraine,Romania,3,2,Friendly,in Ukraine,6,-6,1795,1746,0,-4,19,31,1789,1752,T1
227,May 29,2010,United States,Turkey,2,1,Friendly,in the United States,8,-8,1770,1801,0,-1,25,18,1762,1809,T1
228,May 29,2010,Venezuela,Canada,1,1,Friendly,in Venezuela,-6,6,1724,1603,-3,0,36,57,1730,1597,draw
229,May 30,2010,Belarus,South Korea,1,0,Friendly,in Austria,15,-15,1608,1768,8,-4,55,25,1593,1783,T1
230,May 30,2010,Northern Ireland,Chile,0,1,Friendly,in Chile,-2,2,1560,1876,0,1,73,10,1562,1874,T1
231,May 30,2010,Israel,Chile,0,3,Friendly,in Chile,-7,7,1719,1883,-2,1,36,10,1726,1876,T1
232,May 30,2010,Colombia,Nigeria,1,1,Friendly,in England,-1,1,1746,1707,0,0,30,38,1747,1706,draw
233,May 30,2010,England,Japan,2,1,Friendly,in Austria,3,-3,2001,1703,0,-2,4,40,1998,1706,T1
234,May 30,2010,Paraguay,Ivory Coast,2,2,Friendly,in France,-1,1,1750,1726,0,1,29,34,1751,1725,draw
235,May 30,2010,Mexico,Gambia,5,1,Friendly,in Germany,2,-2,1888,1410,0,0,9,110,1886,1412,T1
236,May 30,2010,Tunisia,France,1,1,Friendly,in Tunisia,5,-5,1618,1877,0,-1,53,11,1613,1882,draw
237,May 31,2010,Grenada,Martinique,2,2,Friendly,in Grenada,1,-1,1256,1373,1,0,142,116,1255,1374,draw
238,May 31,2010,South Africa,Guatemala,5,0,Friendly,in South Africa,8,-8,1581,1430,2,-2,65,106,1573,1438,T1
239,June 1,2010,Australia,Denmark,1,0,Friendly,in South Africa,11,-11,1793,1792,2,-3,19,20,1782,1803,T1
240,June 1,2010,Ghana,Netherlands,1,4,Friendly,in the Netherlands,-2,2,1681,2041,0,0,43,3,1683,2039,T1
241,June 1,2010,Cameroon,Portugal,1,3,Friendly,in Portugal,-5,5,1701,1874,-2,0,41,12,1706,1869,T1
242,June 1,2010,Switzerland,Costa Rica,0,1,Friendly,in Switzerland,-15,15,1759,1713,-3,3,26,38,1774,1698,T2
243,June 2,2010,Albania,Andorra,1,0,Friendly,in Albania,1,-1,1523,1023,0,0,84,184,1522,1024,T1
244,June 2,2010,Honduras,Azerbaijan,0,0,Friendly,in Austria,-7,7,1734,1442,1,1,31,103,1741,1435,draw
245,June 2,2010,Belarus,Sweden,0,1,Friendly,in Belarus,-8,8,1600,1800,-4,1,59,19,1608,1792,T2
246,June 2,2010,Romania,Macedonia,0,1,Friendly,in Austria,-14,14,1732,1609,-2,7,32,54,1746,1595,T1
247,June 2,2010,Ukraine,Norway,1,0,Friendly,in Norway,12,-12,1807,1750,1,-3,17,28,1795,1762,T2
248,June 2,2010,Greece,Paraguay,0,2,Friendly,in Switzerland,-15,15,1737,1765,-3,4,30,25,1752,1750,T1
249,June 2,2010,Serbia,Poland,0,0,Friendly,in Austria,-5,5,1838,1678,0,0,15,46,1843,1673,draw
250,June 2,2010,Brazil,Zimbabwe,3,0,Friendly,in Zimbabwe,1,-1,2109,1334,0,-1,1,122,2108,1335,T2
251,June 3,2010,Germany,Bosnia and Herzegovina,3,1,Friendly,in Germany,3,-3,1958,1641,0,0,5,50,1955,1644,T1
252,June 3,2010,Mexico,Italy,2,1,Friendly,in Belgium,12,-12,1900,1939,1,0,8,6,1888,1951,T1
253,June 3,2010,Spain,South Korea,1,0,Friendly,in Austria,2,-2,2110,1766,1,0,1,24,2108,1768,T1
254,June 4,2010,France,China,0,1,Friendly,in Réunion,-16,16,1861,1639,-1,1,12,51,1877,1623,T1
255,June 4,2010,Ivory Coast,Japan,2,0,Friendly,in Switzerland,14,-14,1740,1689,4,-1,30,41,1726,1703,T1
256,June 4,2010,Faroe Islands,Luxembourg,0,0,Friendly,in Luxembourg,0,0,1208,1098,0,0,154,176,1208,1098,draw
257,June 4,2010,Slovenia,New Zealand,3,1,Friendly,in Slovenia,6,-6,1686,1535,1,-1,43,81,1680,1541,T1
258,June 4,2010,Palestine,Sudan,1,1,Friendly,in Sudan,6,-6,1185,1328,1,-2,158,124,1179,1334,draw
259,June 5,2010,United Arab Emirates,Algeria,0,1,Friendly,in Germany,-7,7,1438,1542,-5,1,104,80,1445,1535,T1
260,June 5,2010,Ghana,Latvia,1,0,Friendly,in England,7,-7,1688,1557,2,-4,42,75,1681,1564,T1
261,June 5,2010,Hungary,Netherlands,1,6,Friendly,in the Netherlands,-2,2,1606,2043,-1,0,57,3,1608,2041,T1
262,June 5,2010,Romania,Honduras,3,0,Friendly,in Austria,18,-18,1750,1716,5,-4,28,36,1732,1734,T1
263,June 5,2010,Serbia,Cameroon,4,3,Friendly,in Serbia,4,-4,1842,1697,0,0,15,40,1838,1701,T1
264,June 5,2010,Slovakia,Costa Rica,3,0,Friendly,in Slovakia,15,-15,1671,1698,1,-1,47,39,1656,1713,T1
265,June 5,2010,Denmark,South Africa,0,1,Friendly,in South Africa,-13,13,1779,1594,0,2,21,63,1792,1581,T1
266,June 5,2010,Italy,Switzerland,1,1,Friendly,in Switzerland,-2,2,1937,1761,0,0,6,26,1939,1759,draw
267,June 5,2010,Australia,United States,1,3,Friendly,in South Africa,-16,16,1777,1786,-2,3,22,20,1793,1770,T1
268,June 6,2010,Nigeria,North Korea,3,1,Friendly,in South Africa,9,-9,1716,1539,2,-1,36,80,1707,1548,T1
269,June 7,2010,Brazil,Tanzania,5,1,Friendly,in Tanzania,1,-1,2110,1334,1,0,1,121,2109,1335,T2
270,June 8,2010,Mozambique,Portugal,0,3,Friendly,in South Africa,-2,2,1374,1876,-1,0,115,11,1376,1874,T1
271,June 8,2010,Spain,Poland,6,0,Friendly,in Spain,2,-2,2112,1676,0,0,1,46,2110,1678,T1
272,June 9,2010,Chile,New Zealand,2,0,Friendly,in South Africa,4,-4,1887,1531,0,0,10,82,1883,1535,T1
273,June 10,2010,Japan,Zimbabwe,0,0,Friendly,in South Africa,-8,8,1681,1342,-3,0,44,121,1689,1334,draw
274,June 11,2010,Uruguay,France,0,0,World Cup,in South Africa,1,-1,1845,1860,0,0,14,12,1844,1861,draw
275,June 11,2010,South Africa,Mexico,1,1,World Cup,in South Africa,16,-16,1610,1884,9,-2,54,10,1594,1900,draw
276,June 12,2010,Argentina,Nigeria,1,0,World Cup,in South Africa,14,-14,1934,1702,0,-1,7,37,1920,1716,T1
277,June 12,2010,United States,England,1,1,World Cup,in South Africa,17,-17,1803,1984,1,0,19,4,1786,2001,draw
278,June 12,2010,South Korea,Greece,2,0,World Cup,in South Africa,41,-41,1807,1696,7,-8,17,40,1766,1737,T1
279,June 13,2010,Australia,Germany,0,4,World Cup,in South Africa,-29,29,1748,1987,-6,1,29,4,1777,1958,T1
280,June 13,2010,Ghana,Serbia,1,0,World Cup,in South Africa,42,-42,1730,1800,9,-5,32,20,1688,1842,T1
281,June 13,2010,Algeria,Slovenia,0,1,World Cup,in South Africa,-18,18,1524,1704,-4,5,83,38,1542,1686,T1
282,June 14,2010,Paraguay,Italy,1,1,World Cup,in South Africa,14,-14,1779,1923,2,-1,22,7,1765,1937,draw
283,June 14,2010,Japan,Cameroon,1,0,World Cup,in South Africa,31,-31,1712,1666,6,-7,38,48,1681,1697,T1
284,June 14,2010,Netherlands,Denmark,2,0,World Cup,in South Africa,16,-16,2059,1763,0,-2,3,24,2043,1779,T1
285,June 15,2010,North Korea,Brazil,1,2,World Cup,in South Africa,-2,2,1537,2112,-2,1,81,1,1539,2110,T1
286,June 15,2010,Portugal,Ivory Coast,0,0,World Cup,in South Africa,-11,11,1865,1751,0,4,11,27,1876,1740,draw
287,June 15,2010,Slovakia,New Zealand,1,1,World Cup,in South Africa,-11,11,1660,1542,-2,2,48,79,1671,1531,draw
288,June 16,2010,Chile,Honduras,1,0,World Cup,in South Africa,16,-16,1903,1700,1,-4,8,40,1887,1716,T1
289,June 16,2010,Uruguay,South Africa,3,0,World Cup,in South Africa,33,-33,1878,1577,3,-13,11,67,1845,1610,T2
290,June 16,2010,Spain,Switzerland,0,1,World Cup,in South Africa,-53,53,2059,1814,-1,9,2,16,2112,1761,T1
291,June 17,2010,Argentina,South Korea,4,1,World Cup,in South Africa,34,-34,1968,1773,0,-7,6,24,1934,1807,T1
292,June 17,2010,Nigeria,Greece,1,2,World Cup,in South Africa,-31,31,1671,1727,-6,8,45,34,1702,1696,T1
293,June 17,2010,France,Mexico,0,2,World Cup,in South Africa,-42,42,1818,1926,-2,3,15,7,1860,1884,T1
294,June 18,2010,Algeria,England,0,0,World Cup,in South Africa,26,-26,1550,1958,4,0,79,5,1524,1984,draw
295,June 18,2010,Latvia,Lithuania,0,0,Baltic Cup,in Lithuania,5,-5,1562,1575,3,-2,72,67,1557,1580,draw
296,June 18,2010,Serbia,Germany,1,0,World Cup,in South Africa,45,-45,1845,1942,6,-2,14,6,1800,1987,T1
297,June 18,2010,United States,Slovenia,2,2,World Cup,in South Africa,-8,8,1795,1712,-3,1,21,38,1803,1704,draw
298,June 19,2010,Ghana,Australia,1,1,World Cup,in South Africa,2,-2,1732,1746,0,0,32,30,1730,1748,draw
299,June 19,2010,Cameroon,Denmark,1,2,World Cup,in South Africa,-22,22,1644,1785,-2,3,49,22,1666,1763,T1
300,June 19,2010,Estonia,Latvia,0,0,Baltic Cup,in Lithuania,4,-4,1475,1558,0,-2,90,74,1471,1562,draw
301,June 19,2010,Netherlands,Japan,1,0,World Cup,in South Africa,7,-7,2066,1705,0,-1,2,39,2059,1712,T1
302,June 19,2010,Chad,Niger,1,1,Friendly,in Niger,3,-3,1259,1258,2,-1,140,141,1256,1261,draw
303,June 19,2010,Guam,Northern Mariana Islands,1,1,Marianas Cup,in the Northern Mariana Islands,0,0,600,499,0,0,221,229,600,499,draw
304,June 20,2010,Ivory Coast,Brazil,1,3,World Cup,in South Africa,-10,10,1741,2122,-4,0,31,1,1751,2112,T1
305,June 20,2010,Italy,New Zealand,1,1,World Cup,in South Africa,-24,24,1899,1566,-1,9,9,71,1923,1542,draw
306,June 20,2010,Estonia,Lithuania,0,2,Baltic Cup,in Lithuania,-11,11,1464,1586,-1,2,91,65,1475,1575,T1
307,June 20,2010,Paraguay,Slovakia,2,0,World Cup,in South Africa,30,-30,1809,1630,5,-5,18,52,1779,1660,T1
308,June 20,2010,Sudan,Tunisia,2,6,Friendly,in Sudan,-9,9,1319,1627,-2,0,126,53,1328,1618,T2
309,June 21,2010,Switzerland,Chile,0,1,World Cup,in South Africa,-22,22,1792,1925,-5,0,22,8,1814,1903,T1
310,June 21,2010,North Korea,Portugal,0,7,World Cup,in South Africa,-18,18,1519,1883,-4,1,86,11,1537,1865,T1
311,June 21,2010,Honduras,Spain,0,2,World Cup,in South Africa,-10,10,1690,2069,-1,1,41,2,1700,2059,T1
312,June 22,2010,Greece,Argentina,0,2,World Cup,in South Africa,-18,18,1709,1986,-4,0,38,4,1727,1968,T1
313,June 22,2010,South Korea,Nigeria,2,2,World Cup,in South Africa,-9,9,1764,1680,0,2,25,43,1773,1671,draw
314,June 22,2010,France,South Africa,1,2,World Cup,in South Africa,-42,42,1776,1619,-7,13,23,54,1818,1577,T1
315,June 22,2010,Mexico,Uruguay,0,1,World Cup,in South Africa,-34,34,1892,1912,-4,4,11,8,1926,1878,T1
316,June 23,2010,Australia,Serbia,2,1,World Cup,in South Africa,38,-38,1784,1807,6,-2,23,16,1746,1845,T1
317,June 23,2010,Slovenia,England,0,1,World Cup,in South Africa,-12,12,1700,1970,-2,0,39,5,1712,1958,T1
318,June 23,2010,Ghana,Germany,0,1,World Cup,in South Africa,-14,14,1718,1956,-3,0,35,6,1732,1942,T1
319,June 23,2010,Algeria,United States,0,1,World Cup,in South Africa,-12,12,1538,1807,0,4,80,16,1550,1795,T1
320,June 24,2010,Denmark,Japan,1,3,World Cup,in South Africa,-55,55,1730,1760,-10,12,32,26,1785,1705,T1
321,June 24,2010,Cameroon,Netherlands,1,2,World Cup,in South Africa,-5,5,1639,2071,-2,1,50,2,1644,2066,T1
322,June 24,2010,Paraguay,New Zealand,0,0,World Cup,in South Africa,-18,18,1791,1584,-6,4,21,67,1809,1566,draw
323,June 24,2010,Slovakia,Italy,3,2,World Cup,in South Africa,49,-49,1679,1850,7,-3,45,12,1630,1899,T1
324,June 25,2010,Brazil,Portugal,0,0,World Cup,in South Africa,-18,18,2104,1901,0,2,1,9,2122,1883,draw
325,June 25,2010,Honduras,Switzerland,0,0,World Cup,in South Africa,9,-9,1699,1783,1,-2,40,22,1690,1792,draw
326,June 25,2010,North Korea,Ivory Coast,0,3,World Cup,in South Africa,-23,23,1496,1764,-2,6,88,25,1519,1741,T1
327,June 25,2010,Chile,Spain,1,2,World Cup,in South Africa,-18,18,1907,2087,-1,1,8,2,1925,2069,T1
328,June 26,2010,Tajikistan,China,0,4,Friendly,in China,-2,2,1273,1641,0,1,136,49,1275,1639,T1
329,June 26,2010,United States,Ghana,1,2,World Cup,in South Africa,-38,38,1769,1756,-9,9,24,27,1807,1718,T1
330,June 26,2010,South Korea,Uruguay,1,2,World Cup,in South Africa,-18,18,1746,1930,-6,0,31,7,1764,1912,T1
331,June 27,2010,Argentina,Mexico,3,1,World Cup,in South Africa,33,-33,2019,1859,0,0,4,11,1986,1892,T1
332,June 27,2010,England,Germany,1,4,World Cup,in South Africa,-55,55,1915,2011,-2,1,7,5,1970,1956,T1
333,June 28,2010,Chile,Brazil,0,3,World Cup,in South Africa,-26,26,1881,2130,-2,0,10,1,1907,2104,T1
334,June 28,2010,Slovakia,Netherlands,1,2,World Cup,in South Africa,-6,6,1673,2077,-1,0,46,3,1679,2071,T1
335,June 29,2010,Paraguay,Japan,0,0,World Cup,in South Africa,-3,3,1788,1763,0,0,19,26,1791,1760,draw
336,June 29,2010,Portugal,Spain,0,1,World Cup,in South Africa,-15,15,1886,2102,-1,0,9,2,1901,2087,T1
337,July 1,2010,Chad,Togo,2,2,African Nations Cup qualifier,in Chad,5,-5,1264,1439,2,-4,138,103,1259,1444,draw
338,July 1,2010,Tunisia,Botswana,0,1,African Nations Cup qualifier,in Tunisia,-37,37,1590,1347,-11,11,64,120,1627,1310,T2
339,July 2,2010,Uruguay,Ghana,1,1,World Cup,in South Africa,-14,14,1916,1770,0,3,6,24,1930,1756,draw
340,July 2,2010,Brazil,Netherlands,1,2,World Cup,in South Africa,-35,35,2095,2112,-2,2,3,1,2130,2077,T1
341,July 3,2010,Germany,Argentina,4,0,World Cup,in South Africa,58,-58,2069,1961,1,-1,4,5,2011,2019,T1
342,July 3,2010,Paraguay,Spain,0,1,World Cup,in South Africa,-8,8,1780,2110,-2,0,21,2,1788,2102,T1
343,July 3,2010,Saint Barthélemy,Saint Martin,0,3,Friendly,in Saint Martin,-5,5,695,925,0,2,217,195,700,920,T1
344,July 6,2010,Netherlands,Uruguay,3,2,World Cup,in South Africa,15,-15,2127,1901,0,-1,1,7,2112,1916,T1
345,July 7,2010,Spain,Germany,1,0,World Cup,in South Africa,26,-26,2136,2043,1,0,1,4,2110,2069,T1
346,July 9,2010,Chad,Botswana,0,1,African Nations Cup qualifier,in Botswana,-10,10,1254,1357,-5,1,143,119,1264,1347,T1
347,July 9,2010,Malawi,Togo,1,1,African Nations Cup qualifier,in Togo,9,-9,1372,1430,0,-2,118,105,1363,1439,draw
348,July 10,2010,Germany,Uruguay,3,2,World Cup,in South Africa,18,-18,2061,1883,0,-2,4,9,2043,1901,T1
349,July 11,2010,Spain,Netherlands,1,0,World Cup,in South Africa,29,-29,2165,2098,0,0,1,2,2136,2127,T1
350,July 21,2010,Antigua and Barbuda,Trinidad and Tobago,1,4,Friendly,in Trinidad and Tobago,-3,3,1242,1541,-1,0,145,80,1245,1538,T1
351,August 4,2010,Zimbabwe,Botswana,0,2,Friendly,in Botswana,-10,10,1332,1367,-2,0,124,119,1342,1357,T1
352,August 8,2010,Anguilla,Saint Martin,1,3,Friendly,in Anguilla,-5,5,549,930,0,1,228,194,554,925,T2
353,August 10,2010,Qatar,Bosnia and Herzegovina,1,1,Friendly,in Bosnia and Herzegovina,6,-6,1526,1635,1,-3,83,52,1520,1641,draw
354,August 10,2010,Ivory Coast,Italy,1,0,Friendly,in England,12,-12,1776,1838,4,-1,22,13,1764,1850,T1
355,August 10,2010,United States,Brazil,0,2,Friendly,in the United States,-6,6,1763,2101,-1,1,26,2,1769,2095,T2
356,August 11,2010,Albania,Uzbekistan,1,0,Friendly,in Albania,7,-7,1530,1492,3,-2,81,89,1523,1499,T1
357,August 11,2010,Gabon,Algeria,2,1,Friendly,in Algeria,12,-12,1591,1526,6,-1,62,82,1579,1538,T2
358,August 11,2010,Iran,Armenia,3,1,Friendly,in Armenia,8,-8,1678,1382,4,0,43,112,1670,1390,T2
359,August 11,2010,Austria,Switzerland,0,1,Friendly,in Austria,-8,8,1589,1791,-3,1,63,19,1597,1783,T2
360,August 11,2010,Kuwait,Azerbaijan,1,1,Friendly,in Azerbaijan,1,-1,1521,1441,0,0,85,101,1520,1442,draw
361,August 11,2010,Niger,Benin,0,0,Friendly,in Benin,6,-6,1264,1416,2,-1,138,108,1258,1422,draw
362,August 11,2010,Colombia,Bolivia,1,1,Friendly,in Bolivia,-1,1,1745,1596,0,1,31,61,1746,1595,draw
363,August 11,2010,Burkina Faso,Congo,3,0,Friendly,in France,15,-15,1475,1403,2,-1,91,110,1460,1418,T1
364,August 11,2010,Tunisia,Chad,3,1,African Nations Cup qualifier,in Chad,12,-12,1602,1242,6,-1,58,144,1590,1254,T2
365,August 11,2010,Bahrain,China,1,1,Friendly,in China,5,-5,1535,1636,3,-2,79,51,1530,1641,draw
366,August 11,2010,Andorra,Cyprus,0,1,Friendly,in Cyprus,-1,1,1022,1558,0,3,184,74,1023,1557,T1
367,August 11,2010,Czechia,Latvia,4,1,Friendly,in Czechia,5,-5,1757,1553,-1,-1,29,76,1752,1558,T1
368,August 11,2010,Germany,Denmark,2,2,Friendly,in Denmark,-6,6,2055,1736,0,0,4,33,2061,1730,draw
369,August 11,2010,Democratic Republic of Congo,Egypt,3,6,Friendly,in Egypt,-2,2,1418,1835,1,0,107,14,1420,1833,T1
370,August 11,2010,Hungary,England,1,2,Friendly,in England,-2,2,1604,1917,1,0,56,6,1606,1915,T1
371,August 11,2010,Faroe Islands,Estonia,1,2,European Championship qualifier,in Estonia,-5,5,1203,1469,-1,-1,155,92,1208,1464,T1
372,August 11,2010,Belgium,Finland,0,1,Friendly,in Finland,-6,6,1588,1658,-1,0,64,48,1594,1652,T1
373,August 11,2010,Guinea,Mali,2,0,Friendly,in France,19,-19,1480,1533,2,-1,90,80,1461,1552,T1
374,August 11,2010,Iceland,Liechtenstein,1,1,Friendly,in Iceland,-8,8,1460,1166,-3,4,93,164,1468,1158,draw
375,August 11,2010,Ireland,Argentina,0,1,Friendly,in Ireland,-8,8,1767,1969,0,0,24,5,1775,1961,T2
376,August 11,2010,Kazakhstan,Oman,3,1,Friendly,in Kazakhstan,22,-22,1356,1587,2,-11,120,65,1334,1609,T1
377,August 11,2010,Belarus,Lithuania,2,0,Friendly,in Lithuania,19,-19,1619,1567,4,-5,55,71,1600,1586,T2
378,August 11,2010,Botswana,Malawi,1,1,African Nations Cup qualifier,in Malawi,6,-6,1373,1366,4,-1,115,119,1367,1372,draw
379,August 11,2010,Malta,Macedonia,1,1,Friendly,in Malta,7,-7,1224,1602,1,-4,150,58,1217,1609,draw
380,August 11,2010,Mauritania,Palestine,0,0,Friendly,in Mauritania,-2,2,1143,1187,0,0,170,158,1145,1185,draw
381,August 11,2010,Spain,Mexico,1,1,Friendly,in Mexico,-5,5,2160,1864,0,0,1,11,2165,1859,draw
382,August 11,2010,Georgia,Moldova,0,0,Friendly,in Moldova,3,-3,1453,1437,1,-1,96,103,1450,1440,draw
383,August 11,2010,Montenegro,Northern Ireland,2,0,Friendly,in Montenegro,8,-8,1644,1552,1,-4,50,77,1636,1560,T1
384,August 11,2010,Morocco,Equatorial Guinea,2,1,Friendly,in Morocco,1,-1,1569,1213,0,-1,69,153,1568,1214,T1
385,August 11,2010,Swaziland,Mozambique,1,2,Friendly,in Mozambique,-3,3,1168,1377,0,1,163,114,1171,1374,T1
386,August 11,2010,Norway,France,2,1,Friendly,in Norway,8,-8,1758,1768,1,-1,28,23,1750,1776,T1
387,August 11,2010,Panama,Venezuela,3,1,Friendly,in Panama,17,-17,1585,1707,2,-4,67,39,1568,1724,T1
388,August 11,2010,Paraguay,Costa Rica,2,0,Friendly,in Paraguay,8,-8,1788,1690,1,0,20,41,1780,1698,T1
389,August 11,2010,Poland,Cameroon,0,3,Friendly,in Poland,-24,24,1652,1663,-4,3,49,47,1676,1639,T2
390,August 11,2010,Russia,Bulgaria,1,0,Friendly,in Russia,4,-4,1852,1725,0,0,12,34,1848,1729,T1
391,August 11,2010,Togo,Saudi Arabia,0,1,Friendly,in Saudi Arabia,-2,2,1428,1690,-1,1,106,41,1430,1688,T1
392,August 11,2010,Senegal,Cape Verde,1,0,Friendly,in Senegal,3,-3,1567,1373,1,-1,71,115,1564,1376,T1
393,August 11,2010,Greece,Serbia,1,0,Friendly,in Serbia,15,-15,1724,1792,3,-3,35,18,1709,1807,T2
394,August 11,2010,Slovakia,Croatia,1,1,Friendly,in Slovakia,3,-3,1676,1891,2,0,44,7,1673,1894,draw
395,August 11,2010,Australia,Slovenia,0,2,Friendly,in Slovenia,-14,14,1770,1714,-3,1,22,38,1784,1700,T1
396,August 11,2010,Ghana,South Africa,0,1,Friendly,in South Africa,-11,11,1759,1630,-2,0,27,53,1770,1619,T1
397,August 11,2010,Nigeria,South Korea,1,2,Friendly,in South Korea,-6,6,1674,1752,-2,1,45,30,1680,1746,T1
398,August 11,2010,Sweden,Scotland,3,0,Friendly,in Sweden,8,-8,1808,1672,1,-3,17,46,1800,1680,T1
399,August 11,2010,Kenya,Tanzania,1,1,Friendly,in Tanzania,3,-3,1322,1331,0,-2,127,124,1319,1334,draw
400,August 11,2010,Singapore,Thailand,0,1,Friendly,in Thailand,-5,5,1347,1448,-1,0,121,99,1352,1443,T1
401,August 11,2010,Trinidad and Tobago,Jamaica,1,3,Friendly,in Trinidad and Tobago,-16,16,1525,1623,-4,2,84,54,1541,1607,T2
402,August 11,2010,Romania,Turkey,0,2,Friendly,in Turkey,-9,9,1741,1810,-3,1,32,16,1750,1801,T1
403,August 11,2010,Uganda,Zambia,1,1,Friendly,in Uganda,-3,3,1552,1562,1,1,77,73,1555,1559,draw
404,August 11,2010,Netherlands,Ukraine,1,1,Friendly,in Ukraine,-5,5,2093,1812,0,0,3,15,2098,1807,draw
405,August 11,2010,Uruguay,Angola,2,0,Friendly,in Portugal,2,-2,1885,1449,0,-2,9,98,1883,1451,T1
406,August 11,2010,Wales,Luxembourg,5,1,Friendly,in Wales,1,-1,1597,1097,1,0,60,176,1596,1098,T1
407,August 18,2010,Kenya,Ethiopia,3,0,Friendly,in Ethiopia,21,-21,1343,1277,4,-2,123,135,1322,1298,T2
408,August 20,2010,Mayotte,Madagascar,0,0,Friendly,in Madagascar,6,-6,1133,1264,1,0,172,137,1127,1270,draw
409,August 26,2010,Saint Lucia,Martinique,1,3,Friendly,in Saint Lucia,-9,9,1119,1382,-2,3,175,112,1128,1373,T2
410,August 28,2010,Antigua and Barbuda,Saint Kitts and Nevis,1,1,Friendly,in Saint Kitts and Nevis,1,-1,1243,1164,1,0,143,166,1242,1165,draw
411,August 28,2010,Martinique,Saint Lucia,1,1,Friendly,in Saint Lucia,-4,4,1378,1123,-2,1,114,174,1382,1119,draw
412,August 29,2010,Ethiopia,Chad,1,0,Friendly,in Ethiopia,6,-6,1283,1236,0,-1,135,146,1277,1242,T1
413,August 29,2010,Comoros,Madagascar,0,1,Friendly,in Madagascar,-1,1,866,1265,0,0,204,137,867,1264,T1
414,September 2,2010,Malta,Israel,1,3,European Championship qualifier,in Israel,-2,2,1222,1721,0,0,150,36,1224,1719,T1
415,September 3,2010,Algeria,Tanzania,1,1,African Nations Cup qualifier,in Algeria,-14,14,1512,1345,-3,3,85,122,1526,1331,draw
416,September 3,2010,Russia,Andorra,2,0,European Championship qualifier,in Andorra,1,-1,1853,1021,0,0,12,184,1852,1022,T2
417,September 3,2010,Armenia,Ireland,0,1,European Championship qualifier,in Armenia,-6,6,1376,1773,-3,2,115,22,1382,1767,T2
418,September 3,2010,Belgium,Germany,0,1,European Championship qualifier,in Belgium,-4,4,1584,2059,-4,0,68,4,1588,2055,T2
419,September 3,2010,Iran,China,2,0,Friendly,in China,17,-17,1695,1619,4,-3,39,54,1678,1636,T2
420,September 3,2010,Bulgaria,England,0,4,European Championship qualifier,in England,-12,12,1713,1929,-2,0,36,6,1725,1917,T1
421,September 3,2010,Estonia,Italy,1,2,European Championship qualifier,in Estonia,-7,7,1462,1845,-2,0,94,13,1469,1838,T2
422,September 3,2010,Faroe Islands,Serbia,0,3,European Championship qualifier,in the Faroe Islands,-4,4,1199,1796,0,0,155,18,1203,1792,T2
423,September 3,2010,France,Belarus,0,1,European Championship qualifier,in France,-32,32,1736,1651,-8,5,31,50,1768,1619,T2
424,September 3,2010,Georgia,Greece,1,1,European Championship qualifier,in Greece,16,-16,1469,1708,3,-2,93,37,1453,1724,draw
425,September 3,2010,Norway,Iceland,2,1,European Championship qualifier,in Iceland,10,-10,1768,1450,4,-4,24,97,1758,1460,T2
426,September 3,2010,Turkey,Kazakhstan,3,0,European Championship qualifier,in Kazakhstan,8,-8,1818,1348,1,0,15,120,1810,1356,T2
427,September 3,2010,Kuwait,Syria,3,0,Friendly,in Kuwait,15,-15,1536,1553,4,-6,81,76,1521,1568,T1
428,September 3,2010,Croatia,Latvia,3,0,European Championship qualifier,in Latvia,14,-14,1905,1539,0,-3,7,79,1891,1553,T2
429,September 3,2010,Liechtenstein,Spain,0,4,European Championship qualifier,in Liechtenstein,0,0,1166,2160,0,0,164,1,1166,2160,T2
430,September 3,2010,Lithuania,Scotland,0,0,European Championship qualifier,in Lithuania,0,0,1567,1672,-1,0,72,46,1567,1672,draw
431,September 3,2010,Bosnia and Herzegovina,Luxembourg,3,0,European Championship qualifier,in Luxembourg,5,-5,1640,1092,1,0,51,176,1635,1097,T2
432,September 3,2010,Moldova,Finland,2,0,European Championship qualifier,in Moldova,40,-40,1477,1618,12,-7,91,55,1437,1658,T1
433,September 3,2010,Montenegro,Wales,1,0,European Championship qualifier,in Montenegro,12,-12,1656,1585,2,-5,48,65,1644,1597,T1
434,September 3,2010,Oman,Malaysia,3,0,Friendly,in Qatar,3,-3,1590,1176,3,-1,62,161,1587,1179,T1
435,September 3,2010,Costa Rica,Panama,2,2,Friendly,in Panama,0,0,1690,1585,1,2,40,65,1690,1585,draw
436,September 3,2010,Cyprus,Portugal,4,4,European Championship qualifier,in Portugal,17,-17,1575,1869,4,-2,70,10,1558,1886,draw
437,September 3,2010,Bahrain,Qatar,1,1,Friendly,in Qatar,3,-3,1538,1523,-1,-2,80,84,1535,1526,draw
438,September 3,2010,Albania,Romania,1,1,European Championship qualifier,in Romania,14,-14,1544,1727,3,-1,78,33,1530,1741,draw
439,September 3,2010,Netherlands,San Marino,5,0,European Championship qualifier,in San Marino,0,0,2093,913,0,0,3,198,2093,913,T2
440,September 3,2010,Macedonia,Slovakia,0,1,European Championship qualifier,in Slovakia,-11,11,1591,1687,-2,1,60,43,1602,1676,T1
441,September 3,2010,Northern Ireland,Slovenia,1,0,European Championship qualifier,in Slovenia,33,-33,1585,1681,12,-6,65,44,1552,1714,T2
442,September 3,2010,Sweden,Hungary,2,0,European Championship qualifier,in Sweden,9,-9,1817,1595,1,-3,16,59,1808,1604,T1
443,September 3,2010,Australia,Switzerland,0,0,Friendly,in Switzerland,3,-3,1773,1788,0,0,22,19,1770,1791,draw
444,September 3,2010,Colombia,Venezuela,2,0,Friendly,in Venezuela,18,-18,1763,1689,6,-3,25,42,1745,1707,T2
445,September 4,2010,Botswana,Togo,2,1,African Nations Cup qualifier,in Botswana,17,-17,1390,1411,4,-3,112,109,1373,1428,T1
446,September 4,2010,Canada,Peru,0,2,Friendly,in Canada,-20,20,1583,1607,-13,8,69,56,1603,1587,T2
447,September 4,2010,Cape Verde,Mali,1,0,African Nations Cup qualifier,in Cape Verde,23,-23,1396,1510,5,-3,111,85,1373,1533,T1
448,September 4,2010,El Salvador,Honduras,2,2,Friendly tournament,in the United States,8,-8,1510,1691,1,-1,85,39,1502,1699,draw
449,September 4,2010,Gambia,Namibia,3,1,African Nations Cup qualifier,in The Gambia,15,-15,1425,1309,3,-5,106,131,1410,1324,T1
450,September 4,2010,Guatemala,Nicaragua,5,0,Friendly,in the United States,5,-5,1435,1075,2,-1,103,178,1430,1080,T1
451,September 4,2010,Kenya,Guinea-Bissau,0,1,African Nations Cup qualifier,in Guinea-Bissau,-20,20,1323,1262,-2,5,126,140,1343,1242,T1
452,September 4,2010,Ivory Coast,Rwanda,3,0,African Nations Cup qualifier,in Ivory Coast,4,-4,1780,1398,1,1,20,110,1776,1402,T1
453,September 4,2010,Paraguay,Japan,0,1,Friendly,in Japan,-8,8,1780,1771,-1,1,20,24,1788,1763,T1
454,September 4,2010,Cameroon,Mauritius,3,1,African Nations Cup qualifier,in Mauritius,3,-3,1666,1031,0,0,47,182,1663,1034,T2
455,September 4,2010,Mexico,Ecuador,1,2,Friendly,in Mexico,-16,16,1848,1732,-1,2,12,33,1864,1716,T2
456,September 4,2010,Morocco,Central African Republic,0,0,African Nations Cup qualifier,in Morocco,-18,18,1551,1202,-6,4,77,155,1569,1184,draw
457,September 4,2010,Poland,Ukraine,1,1,Friendly,in Poland,2,-2,1654,1810,0,0,49,17,1652,1812,draw
458,September 4,2010,Niger,South Africa,0,2,African Nations Cup qualifier,in South Africa,-4,4,1260,1634,-3,0,141,52,1264,1630,T1
459,September 4,2010,Congo,Sudan,0,2,African Nations Cup qualifier,in Sudan,-29,29,1374,1348,-8,8,118,120,1403,1319,T1
460,September 4,2010,India,Thailand,0,1,Friendly,in Thailand,-2,2,1194,1450,-1,3,157,97,1196,1448,T1
461,September 4,2010,Malawi,Tunisia,2,2,African Nations Cup qualifier,in Tunisia,15,-15,1381,1587,6,-6,113,63,1366,1602,draw
462,September 4,2010,Uganda,Angola,3,0,African Nations Cup qualifier,in Uganda,17,-17,1569,1432,6,-6,71,105,1552,1449,T1
463,September 5,2010,Burundi,Benin,1,1,African Nations Cup qualifier,in Benin,15,-15,1205,1401,3,0,155,108,1190,1416,draw
464,September 5,2010,Democratic Republic of Congo,Senegal,2,4,African Nations Cup qualifier,in the Democratic Republic of the Congo,-26,26,1392,1593,-4,13,111,59,1418,1567,T2
465,September 5,2010,Egypt,Sierra Leone,1,1,African Nations Cup qualifier,in Egypt,-19,19,1816,1283,-2,3,16,135,1835,1264,draw
466,September 5,2010,Ethiopia,Guinea,1,4,African Nations Cup qualifier,in Ethiopia,-25,25,1258,1505,-6,3,141,87,1283,1480,T2
467,September 5,2010,Jamaica,Costa Rica,1,0,Friendly,in Jamaica,9,-9,1632,1681,0,-3,53,43,1623,1690,T1
468,September 5,2010,Zimbabwe,Liberia,1,1,African Nations Cup qualifier,in Liberia,0,0,1332,1235,0,0,125,148,1332,1235,draw
469,September 5,2010,Mozambique,Libya,0,0,African Nations Cup qualifier,in Mozambique,1,-1,1378,1492,1,-1,115,89,1377,1493,draw
470,September 5,2010,Nigeria,Madagascar,2,0,African Nations Cup qualifier,in Nigeria,3,-3,1677,1262,0,-1,45,138,1674,1265,T1
471,September 5,2010,Swaziland,Ghana,0,3,African Nations Cup qualifier,in Swaziland,-4,4,1164,1763,-2,2,165,26,1168,1759,T2
472,September 5,2010,Comoros,Zambia,0,4,African Nations Cup qualifier,in Zambia,-1,1,865,1563,0,0,204,74,866,1562,T1
473,September 6,2010,Gabon,Burkina Faso,1,1,Friendly,in France,-3,3,1588,1478,-3,1,63,91,1591,1475,draw
474,September 7,2010,Luxembourg,Albania,0,1,European Championship qualifier,in Albania,-2,2,1090,1546,0,0,176,78,1092,1544,T1
475,September 7,2010,Spain,Argentina,1,4,Friendly,in Argentina,-22,22,2138,1991,0,0,1,5,2160,1969,T1
476,September 7,2010,Kazakhstan,Austria,0,2,European Championship qualifier,in Austria,-7,7,1341,1596,-4,3,124,59,1348,1589,T1
477,September 7,2010,Romania,Belarus,0,0,European Championship qualifier,in Belarus,1,-1,1728,1650,2,1,32,49,1727,1651,draw
478,September 7,2010,Bosnia and Herzegovina,France,0,2,European Championship qualifier,in Bosnia and Herzegovina,-30,30,1610,1766,-5,6,56,25,1640,1736,T2
479,September 7,2010,Montenegro,Bulgaria,1,0,European Championship qualifier,in Bulgaria,28,-28,1684,1685,5,-6,43,42,1656,1713,T2
480,September 7,2010,Honduras,Canada,1,2,Friendly,in Canada,-10,10,1681,1593,-5,8,44,62,1691,1583,T1
481,September 7,2010,Paraguay,China,1,1,Friendly,in China,-2,2,1778,1621,-2,2,22,52,1780,1619,draw
482,September 7,2010,Greece,Croatia,0,0,European Championship qualifier,in Croatia,14,-14,1722,1891,2,0,35,7,1708,1905,draw
483,September 7,2010,Czechia,Lithuania,0,1,European Championship qualifier,in Czechia,-34,34,1723,1601,-5,15,34,58,1757,1567,T2
484,September 7,2010,Denmark,Iceland,1,0,European Championship qualifier,in Denmark,4,-4,1740,1446,1,-4,30,101,1736,1450,T1
485,September 7,2010,Estonia,Uzbekistan,3,3,Friendly,in Estonia,-2,2,1460,1494,0,1,94,88,1462,1492,draw
486,September 7,2010,Georgia,Israel,0,0,European Championship qualifier,in Georgia,8,-8,1477,1713,1,-2,92,37,1469,1721,draw
487,September 7,2010,Germany,Azerbaijan,6,1,European Championship qualifier,in Germany,1,-1,2060,1440,0,-2,4,103,2059,1441,T1
488,September 7,2010,El Salvador,Guatemala,0,2,Friendly,in the United States,-18,18,1492,1453,-4,5,89,98,1510,1435,T1
489,September 7,2010,Hungary,Moldova,2,1,European Championship qualifier,in Hungary,9,-9,1604,1468,1,-1,57,93,1595,1477,T1
490,September 7,2010,Ireland,Andorra,3,1,European Championship qualifier,in Ireland,0,0,1773,1021,-1,0,23,184,1773,1021,T1
491,September 7,2010,Italy,Faroe Islands,5,0,European Championship qualifier,in Italy,1,-1,1846,1198,1,0,12,157,1845,1199,T1
492,September 7,2010,Japan,Guatemala,2,1,Friendly,in Japan,2,-2,1773,1451,1,5,23,98,1771,1453,T1
493,September 7,2010,Macedonia,Armenia,2,2,European Championship qualifier,in Macedonia,-14,14,1577,1390,-11,5,71,112,1591,1376,draw
494,September 7,2010,Latvia,Malta,2,0,European Championship qualifier,in Malta,13,-13,1552,1209,3,-3,76,153,1539,1222,T2
495,September 7,2010,Mexico,Colombia,1,0,Friendly,in Mexico,5,-5,1853,1758,2,-3,10,29,1848,1763,T1
496,September 7,2010,Netherlands,Finland,2,1,European Championship qualifier,in the Netherlands,1,-1,2094,1617,0,0,3,55,2093,1618,T1
497,September 7,2010,Norway,Portugal,1,0,European Championship qualifier,in Norway,20,-20,1788,1849,7,-1,18,11,1768,1869,T1
498,September 7,2010,Panama,Trinidad and Tobago,3,0,Friendly,in Panama,10,-10,1595,1515,4,-1,61,83,1585,1525,T1
499,September 7,2010,Peru,Jamaica,2,1,Friendly,in the United States,11,-11,1618,1621,2,1,54,52,1607,1632,T1
500,September 7,2010,Poland,Australia,1,2,Friendly,in Poland,-9,9,1645,1782,-1,2,50,20,1654,1773,T2
501,September 7,2010,Qatar,Oman,1,1,Friendly,in Qatar,-1,1,1522,1591,2,-3,81,64,1523,1590,draw
502,September 7,2010,Russia,Slovakia,0,1,European Championship qualifier,in Russia,-33,33,1820,1720,-3,6,14,36,1853,1687,T2
503,September 7,2010,Scotland,Liechtenstein,2,1,European Championship qualifier,in Scotland,1,-1,1673,1165,-1,-1,47,164,1672,1166,T1
504,September 7,2010,Serbia,Slovenia,1,1,European Championship qualifier,in Serbia,-11,11,1785,1692,-1,3,19,40,1796,1681,draw
505,September 7,2010,South Korea,Iran,0,1,Friendly,in South Korea,-14,14,1738,1709,-1,0,31,38,1752,1695,T2
506,September 7,2010,San Marino,Sweden,0,6,European Championship qualifier,in Sweden,0,0,913,1817,0,-1,198,16,913,1817,T1
507,September 7,2010,Switzerland,England,1,3,European Championship qualifier,in Switzerland,-26,26,1762,1955,-9,0,28,6,1788,1929,T2
508,September 7,2010,Belgium,Turkey,2,3,European Championship qualifier,in Turkey,-5,5,1579,1823,-2,1,70,13,1584,1818,T1
509,September 7,2010,Kuwait,United Arab Emirates,0,3,Friendly,in the United Arab Emirates,-17,17,1519,1455,-1,7,82,95,1536,1438,T1
510,September 7,2010,Chile,Ukraine,1,2,Friendly,in Ukraine,-9,9,1872,1819,0,2,9,15,1881,1810,T1
511,September 7,2010,Ecuador,Venezuela,0,1,Friendly,in Venezuela,-8,8,1724,1697,0,2,33,39,1732,1689,T1
512,September 7,2010,Syria,Yemen,1,2,Friendly,in Yemen,-14,14,1539,1305,-3,0,79,133,1553,1291,T1
513,September 8,2010,Thailand,India,2,1,Friendly,in India,6,-6,1456,1188,4,0,95,158,1450,1194,T2
514,September 10,2010,Trinidad and Tobago,Belize,0,0,Friendly,in Belize,-7,7,1508,1086,-2,0,85,177,1515,1079,draw
515,September 10,2010,Saint Vincent and the Grenadines,Saint Lucia,5,1,Friendly,in Saint Lucia,18,-18,1254,1105,2,-1,144,175,1236,1123,T2
516,September 11,2010,French Guiana,Suriname,1,2,Friendly,in French Guiana,-12,12,1202,1255,-4,1,155,144,1214,1243,T2
517,September 15,2010,India,Namibia,2,0,Friendly,in India,16,-16,1204,1293,3,-2,155,133,1188,1309,T1
518,September 16,2010,Jordan,Iraq,4,1,Friendly,in Jordan,18,-18,1473,1540,3,-3,93,78,1455,1558,T1
519,September 17,2010,Saint Vincent and the Grenadines,Grenada,0,1,Friendly,in Saint Vincent and the Grenadines,-13,13,1241,1269,-1,6,146,137,1254,1256,T2
520,September 18,2010,Anguilla,British Virgin Islands,1,2,Friendly,in Saint Martin,-3,3,546,889,0,0,228,201,549,886,T1
521,September 18,2010,Zambia,Yemen,1,0,Friendly,in Yemen,6,-6,1569,1299,1,0,73,132,1563,1305,T2
522,September 19,2010,Antigua and Barbuda,Trinidad and Tobago,0,1,Friendly tournament,in Antigua and Barbuda,-8,8,1235,1516,-2,2,147,83,1243,1508,T2
523,September 19,2010,Bahrain,Jordan,0,2,Friendly,in Jordan,-13,13,1525,1486,0,2,80,91,1538,1473,T1
524,September 19,2010,Saint Martin,British Virgin Islands,3,1,Friendly,in Saint Martin,9,-9,939,880,3,0,191,201,930,889,T1
525,September 19,2010,Grenada,Saint Vincent and the Grenadines,0,0,Friendly,in Saint Vincent and the Grenadines,2,-2,1271,1239,0,1,137,145,1269,1241,draw
526,September 21,2010,Iraq,Oman,3,2,Friendly,in Jordan,11,-11,1551,1580,2,-5,76,69,1540,1591,T1
527,September 21,2010,Saint Lucia,Trinidad and Tobago,0,3,Friendly tournament,in Antigua and Barbuda,-5,5,1100,1521,0,1,175,82,1105,1516,T1
528,September 22,2010,French Guiana,Mayotte,2,2,French Territory Cup,in France,-3,3,1199,1136,-1,0,157,172,1202,1133,draw
529,September 22,2010,Réunion,Saint Pierre and Miquelon,11,0,French Territory Cup,in France,2,-2,1318,698,0,0,128,217,1316,700,T1
530,September 23,2010,Saint Lucia,Antigua and Barbuda,0,5,Friendly tournament,in Antigua and Barbuda,-12,12,1088,1247,-1,2,176,145,1100,1235,T1
531,September 23,2010,New Caledonia,Guadeloupe,1,1,French Territory Cup,in France,5,-5,1316,1438,1,-1,129,103,1311,1443,draw
532,September 23,2010,Tahiti,Martinique,1,4,French Territory Cup,in France,-12,12,1163,1390,-5,4,167,112,1175,1378,T1
533,September 24,2010,Iran,Bahrain,3,0,West Asian Championship,in Jordan,18,-18,1727,1507,5,-5,33,85,1709,1525,T1
534,September 24,2010,Jordan,Syria,1,1,West Asian Championship,in Jordan,-3,3,1483,1542,0,0,91,79,1486,1539,draw
535,September 24,2010,North Korea,Vietnam,0,0,Friendly tournament,in Vietnam,-2,2,1494,1347,0,1,87,121,1496,1345,draw
536,September 25,2010,Barbados,Dominica,0,2,Friendly,in Barbados,-28,28,1284,1019,-4,1,134,185,1312,991,T2
537,September 25,2010,Saint Pierre and Miquelon,French Guiana,0,7,French Territory Cup,in France,-4,4,694,1203,-1,1,218,156,698,1199,T1
538,September 25,2010,Yemen,Iraq,1,2,West Asian Championship,in Jordan,-8,8,1291,1559,0,1,132,75,1299,1551,T1
539,September 25,2010,Réunion,Mayotte,2,1,French Territory Cup,in France,8,-8,1326,1128,2,0,126,172,1318,1136,T1
540,September 26,2010,Bahrain,Oman,2,0,West Asian Championship,in Jordan,36,-36,1543,1544,6,-9,79,78,1507,1580,T1
541,September 26,2010,Barbados,Dominica,1,3,Friendly,in Barbados,-27,27,1257,1046,-9,4,143,181,1284,1019,T2
542,September 26,2010,Guadeloupe,Tahiti,1,1,French Territory Cup,in France,-10,10,1428,1173,-2,5,105,162,1438,1163,draw
543,September 26,2010,Trinidad and Tobago,Guyana,1,1,Friendly,in Guyana,-4,4,1517,1268,-2,1,83,137,1521,1264,draw
544,September 26,2010,Syria,Kuwait,1,2,West Asian Championship,in Jordan,-21,21,1521,1540,-3,2,82,80,1542,1519,T1
545,September 26,2010,Martinique,New Caledonia,4,0,French Territory Cup,in France,22,-22,1412,1294,5,-1,107,130,1390,1316,T1
546,September 27,2010,Palestine,Yemen,1,3,West Asian Championship,in Jordan,-21,21,1166,1312,-3,3,162,129,1187,1291,T1
547,September 28,2010,Iran,Oman,2,2,West Asian Championship,in Jordan,-10,10,1717,1554,-4,3,37,75,1727,1544,draw
548,September 28,2010,Jordan,Kuwait,2,2,West Asian Championship,in Jordan,-2,2,1481,1542,0,0,91,80,1483,1540,draw
549,September 28,2010,Mayotte,Saint Pierre and Miquelon,10,0,French Territory Cup,in France,6,-6,1134,688,0,-1,172,219,1128,694,T1
550,September 28,2010,French Guiana,Réunion,0,1,French Territory Cup,in France,-10,10,1193,1336,-2,1,158,125,1203,1326,T1
551,September 29,2010,Martinique,Guadeloupe,0,2,French Territory Cup,in France,-21,21,1391,1449,-5,4,112,101,1412,1428,T1
552,September 29,2010,Iraq,Palestine,3,0,West Asian Championship,in Jordan,7,-7,1566,1159,0,-6,74,168,1559,1166,T1
553,September 29,2010,Tahiti,New Caledonia,1,1,French Territory Cup,in France,5,-5,1178,1289,2,-1,159,132,1173,1294,draw
554,October 1,2010,Mayotte,Guadeloupe,0,4,French Territory Cup,in France,-8,8,1126,1457,0,5,172,96,1134,1449,T1
555,October 1,2010,Iraq,Iran,1,2,West Asian Championship,in Jordan,-12,12,1554,1729,0,5,74,32,1566,1717,T1
556,October 1,2010,Yemen,Kuwait,1,1,West Asian Championship,in Jordan,12,-12,1324,1530,2,0,127,80,1312,1542,draw
557,October 2,2010,Cayman Islands,Saint Martin,1,1,CONCACAF Champ &amp; Carib Champ qual,in Puerto Rico,-2,2,976,941,0,0,188,191,978,939,draw
558,October 2,2010,Martinique,Réunion,0,0,French Territory Cup,in France,-2,2,1389,1338,-2,0,114,125,1391,1336,draw
559,October 2,2010,Puerto Rico,Anguilla,3,1,CONCACAF Champ &amp; Carib Champ qual,in Puerto Rico,3,-3,983,543,0,0,187,229,980,546,T1
560,October 3,2010,Iran,Kuwait,1,2,West Asian Championship,in Jordan,-30,30,1699,1560,-6,6,38,74,1729,1530,T1
561,October 4,2010,Anguilla,Cayman Islands,1,4,CONCACAF Champ &amp; Carib Champ qual,in Puerto Rico,-5,5,538,981,0,0,229,188,543,976,T1
562,October 4,2010,Hong Kong,India,1,0,Friendly,in India,13,-13,1219,1191,2,-3,151,158,1206,1204,T2
563,October 4,2010,Saint Martin,Puerto Rico,0,2,CONCACAF Champ &amp; Carib Champ qual,in Puerto Rico,-18,18,923,1001,-5,1,196,186,941,983,T1
564,October 6,2010,Anguilla,Saint Martin,2,1,CONCACAF Champ &amp; Carib Champ qual,in Puerto Rico,36,-36,574,887,2,-4,227,200,538,923,T1
565,October 6,2010,Saint Kitts and Nevis,Barbados,1,1,CONCACAF Champ &amp; Carib Champ qual,in Saint Vincent and the Grenadines,5,-5,1169,1252,2,-1,162,144,1164,1257,draw
566,October 6,2010,Cayman Islands,Puerto Rico,0,2,CONCACAF Champ &amp; Carib Champ qual,in Puerto Rico,-20,20,961,1021,-1,1,189,185,981,1001,T1
567,October 6,2010,Saint Vincent and the Grenadines,Montserrat,7,0,CONCACAF Champ &amp; Carib Champ qual,in Saint Vincent and the Grenadines,1,-1,1240,521,0,0,146,230,1239,522,T1
568,October 7,2010,Venezuela,Bolivia,3,1,Friendly,in Bolivia,15,-15,1712,1581,1,-9,38,68,1697,1596,T2
569,October 7,2010,Brazil,Iran,3,0,Friendly,in the United Arab Emirates,3,-3,2104,1696,0,-1,2,39,2101,1699,T1
570,October 8,2010,Bosnia and Herzegovina,Albania,1,1,European Championship qualifier,in Albania,2,-2,1612,1544,0,0,56,79,1610,1546,draw
571,October 8,2010,Andorra,Macedonia,0,2,European Championship qualifier,in Andorra,-4,4,1017,1581,-1,3,186,67,1021,1577,T2
572,October 8,2010,Armenia,Slovakia,3,1,European Championship qualifier,in Armenia,47,-47,1437,1673,9,-9,103,45,1390,1720,T1
573,October 8,2010,Azerbaijan,Austria,0,3,European Championship qualifier,in Austria,-13,13,1427,1609,-3,2,106,57,1440,1596,T1
574,October 8,2010,Barbados,Montserrat,5,0,CONCACAF Champ &amp; Carib Champ qual,in Saint Vincent and the Grenadines,1,-1,1253,520,0,0,144,230,1252,521,T1
575,October 8,2010,China,Syria,2,1,Friendly,in China,5,-5,1626,1516,-1,-1,53,83,1621,1521,T1
576,October 8,2010,Ecuador,Colombia,0,1,Friendly,in the United States,-9,9,1715,1767,-2,6,35,23,1724,1758,T1
577,October 8,2010,Norway,Cyprus,2,1,European Championship qualifier,in Cyprus,14,-14,1802,1561,0,-4,18,75,1788,1575,T2
578,October 8,2010,Czechia,Scotland,1,0,European Championship qualifier,in Czechia,12,-12,1735,1661,4,-1,30,48,1723,1673,T1
579,October 8,2010,Malta,Georgia,0,1,European Championship qualifier,in Georgia,-4,4,1205,1481,-1,1,154,92,1209,1477,T1
580,October 8,2010,Germany,Turkey,3,0,European Championship qualifier,in Germany,9,-9,2069,1814,0,-3,4,16,2060,1823,T1
581,October 8,2010,Latvia,Greece,0,1,European Championship qualifier,in Greece,-7,7,1545,1729,-1,3,78,32,1552,1722,T1
582,October 8,2010,Hungary,San Marino,8,0,European Championship qualifier,in Hungary,1,-1,1605,912,-1,0,58,197,1604,913,T1
583,October 8,2010,India,Vietnam,3,1,Friendly,in India,17,-17,1208,1330,5,-4,153,125,1191,1347,T1
584,October 8,2010,Indonesia,Uruguay,1,7,Friendly,in Indonesia,-2,2,1256,1887,-1,0,142,8,1258,1885,T2
585,October 8,2010,Russia,Ireland,3,2,European Championship qualifier,in Ireland,23,-23,1843,1750,2,-4,12,27,1820,1773,T2
586,October 8,2010,Argentina,Japan,0,1,Friendly,in Japan,-13,13,1978,1786,0,4,5,19,1991,1773,T1
587,October 8,2010,Belgium,Kazakhstan,2,0,European Championship qualifier,in Kazakhstan,19,-19,1598,1322,7,-5,62,129,1579,1341,T2
588,October 8,2010,Bahrain,Kuwait,3,1,Friendly,in Kuwait,20,-20,1563,1540,7,-6,73,80,1543,1560,T2
589,October 8,2010,Luxembourg,Belarus,0,0,European Championship qualifier,in Luxembourg,17,-17,1107,1633,0,-2,175,51,1090,1650,draw
590,October 8,2010,Netherlands,Moldova,1,0,European Championship qualifier,in Moldova,2,-2,2096,1466,0,-1,3,95,2094,1468,T2
591,October 8,2010,Switzerland,Montenegro,0,1,European Championship qualifier,in Montenegro,-19,19,1743,1703,0,4,28,39,1762,1684,T1
592,October 8,2010,Italy,Northern Ireland,0,0,European Championship qualifier,in Northern Ireland,-9,9,1837,1594,-1,2,13,63,1846,1585,draw
593,October 8,2010,Gabon,Oman,0,1,Friendly,in Oman,-8,8,1580,1562,-6,1,69,74,1588,1554,T1
594,October 8,2010,Panama,El Salvador,1,0,Friendly,in Panama,5,-5,1600,1487,1,-2,59,91,1595,1492,T1
595,October 8,2010,Costa Rica,Peru,0,2,Friendly,in Peru,-13,13,1668,1631,-2,2,46,52,1681,1618,T1
596,October 8,2010,Portugal,Denmark,3,1,European Championship qualifier,in Portugal,14,-14,1863,1726,1,-4,10,34,1849,1740,T1
597,October 8,2010,Serbia,Estonia,1,3,European Championship qualifier,in Serbia,-55,55,1730,1515,-12,11,31,84,1785,1460,T2
598,October 8,2010,Faroe Islands,Slovenia,1,5,European Championship qualifier,in Slovenia,-2,2,1196,1694,-1,-1,157,41,1198,1692,T1
599,October 8,2010,Lithuania,Spain,1,3,European Championship qualifier,in Spain,-1,1,1600,2139,-1,0,59,1,1601,2138,T1
600,October 8,2010,Saint Vincent and the Grenadines,Saint Kitts and Nevis,1,1,CONCACAF Champ &amp; Carib Champ qual,in Saint Vincent and the Grenadines,-9,9,1231,1178,-2,3,148,159,1240,1169,draw
601,October 8,2010,Canada,Ukraine,2,2,Friendly,in Ukraine,7,-7,1600,1812,2,-2,59,17,1593,1819,draw
602,October 8,2010,Bulgaria,Wales,1,0,European Championship qualifier,in Wales,20,-20,1705,1565,4,-7,38,72,1685,1585,T2
603,October 9,2010,Guinea-Bissau,Angola,0,1,African Nations Cup qualifier,in Angola,-7,7,1255,1439,-4,1,142,104,1262,1432,T1
604,October 9,2010,Australia,Paraguay,1,0,Friendly,in Australia,7,-7,1789,1771,1,-1,19,23,1782,1778,T1
605,October 9,2010,Gambia,Burkina Faso,1,3,African Nations Cup qualifier,in Burkina Faso,-18,18,1407,1496,-3,6,110,88,1425,1478,T1
606,October 9,2010,Ivory Coast,Burundi,1,0,African Nations Cup qualifier,in Burundi,2,-2,1782,1203,-1,-1,22,155,1780,1205,T2
607,October 9,2010,Cameroon,Democratic Republic of Congo,1,1,African Nations Cup qualifier,in Cameroon,-16,16,1650,1408,-2,3,49,109,1666,1392,draw
608,October 9,2010,Mozambique,Comoros,1,0,African Nations Cup qualifier,in the Comoros,3,-3,1381,862,2,0,115,204,1378,865,T2
609,October 9,2010,Romania,France,0,2,European Championship qualifier,in France,-19,19,1709,1785,-3,3,36,21,1728,1766,T1
610,October 9,2010,Guatemala,Belize,4,2,Friendly,in Guatemala,2,-2,1453,1084,1,0,99,177,1451,1086,T1
611,October 9,2010,Israel,Croatia,1,2,European Championship qualifier,in Israel,-16,16,1697,1907,-3,0,39,7,1713,1891,T2
612,October 9,2010,Uganda,Kenya,0,0,African Nations Cup qualifier,in Kenya,-8,8,1561,1331,-5,3,75,124,1569,1323,draw
613,October 9,2010,Malawi,Chad,6,2,African Nations Cup qualifier,in Malawi,15,-15,1396,1221,4,-3,111,149,1381,1236,T1
614,October 9,2010,Liberia,Mali,1,2,African Nations Cup qualifier,in Mali,-4,4,1231,1514,1,1,146,85,1235,1510,T1
615,October 9,2010,Honduras,New Zealand,1,1,Friendly,in New Zealand,0,0,1681,1584,0,0,43,66,1681,1584,draw
616,October 9,2010,Rwanda,Benin,0,3,African Nations Cup qualifier,in Rwanda,-45,45,1353,1446,-9,7,119,102,1398,1401,T2
617,October 9,2010,Saudi Arabia,Uzbekistan,4,0,Friendly,in Saudi Arabia,6,-6,1696,1488,2,-3,40,91,1690,1494,T1
618,October 9,2010,Mauritius,Senegal,0,7,African Nations Cup qualifier,in Senegal,-2,2,1029,1595,0,1,183,63,1031,1593,T1
619,October 9,2010,Taiwan,Macao,7,1,Friendly tournament,in Taiwan,9,-9,932,690,3,-1,193,217,923,699,T1
620,October 9,2010,Tanzania,Morocco,0,1,African Nations Cup qualifier,in Tanzania,-14,14,1331,1565,-2,6,124,71,1345,1551,T2
621,October 9,2010,United Arab Emirates,Chile,0,2,Friendly,in the United Arab Emirates,-4,4,1451,1876,-2,0,100,9,1455,1872,T2
622,October 9,2010,United States,Poland,2,2,Friendly,in the United States,-6,6,1757,1651,-1,1,26,48,1763,1645,draw
623,October 10,2010,Central African Republic,Algeria,2,0,African Nations Cup qualifier,in Central African Republic,46,-46,1248,1466,12,-8,144,94,1202,1512,T1
624,October 10,2010,Swaziland,Congo,1,3,African Nations Cup qualifier,in Congo,-9,9,1155,1383,-3,2,168,115,1164,1374,T1
625,October 10,2010,Ghana,Sudan,0,0,African Nations Cup qualifier,in Ghana,-18,18,1745,1366,-2,1,27,119,1763,1348,draw
626,October 10,2010,Guinea,Nigeria,1,0,African Nations Cup qualifier,in Guinea,24,-24,1529,1653,6,-3,81,47,1505,1677,T1
627,October 10,2010,Jamaica,Trinidad and Tobago,1,0,Friendly,in Jamaica,5,-5,1626,1512,2,-4,52,86,1621,1517,T1
628,October 10,2010,Libya,Zambia,1,0,African Nations Cup qualifier,in Libya,19,-19,1511,1550,3,-7,87,77,1492,1569,T1
629,October 10,2010,Ethiopia,Madagascar,1,0,African Nations Cup qualifier,in Madagascar,26,-26,1284,1236,4,-8,136,146,1258,1262,T2
630,October 10,2010,Egypt,Niger,0,1,African Nations Cup qualifier,in Niger,-37,37,1779,1297,-7,8,22,131,1816,1260,T1
631,October 10,2010,South Africa,Sierra Leone,0,0,African Nations Cup qualifier,in Sierra Leone,-12,12,1622,1295,-4,2,54,132,1634,1283,draw
632,October 10,2010,Montserrat,Saint Kitts and Nevis,0,4,CONCACAF Champ &amp; Carib Champ qual,in Saint Vincent and the Grenadines,-2,2,518,1180,0,0,230,159,520,1178,T1
633,October 10,2010,Saint Vincent and the Grenadines,Barbados,0,0,CONCACAF Champ &amp; Carib Champ qual,in Saint Vincent and the Grenadines,-4,4,1227,1257,-3,4,149,140,1231,1253,draw
634,October 10,2010,Philippines,Taiwan,1,1,Friendly tournament,in Taiwan,8,-8,829,924,1,-2,205,195,821,932,draw
635,October 10,2010,Tunisia,Togo,2,1,African Nations Cup qualifier,in Togo,16,-16,1603,1395,6,-4,59,112,1587,1411,T2
636,October 10,2010,Zimbabwe,Cape Verde,0,0,African Nations Cup qualifier,in Zimbabwe,-2,2,1330,1398,-2,1,125,110,1332,1396,draw
637,October 11,2010,Ukraine,Brazil,0,2,Friendly,in England,-5,5,1807,2109,0,0,16,2,1812,2104,T1
638,October 12,2010,Andorra,Armenia,0,4,European Championship qualifier,in Armenia,-4,4,1013,1441,0,1,186,104,1017,1437,T1
639,October 12,2010,Turkey,Azerbaijan,0,1,European Championship qualifier,in Azerbaijan,-34,34,1780,1461,-7,11,22,96,1814,1427,T1
640,October 12,2010,Uzbekistan,Bahrain,4,2,Friendly,in Bahrain,22,-22,1510,1541,4,-6,86,78,1488,1563,T2
641,October 12,2010,Albania,Belarus,0,2,European Championship qualifier,in Belarus,-15,15,1529,1648,-1,0,80,50,1544,1633,T1
642,October 12,2010,Austria,Belgium,4,4,European Championship qualifier,in Belgium,5,-5,1614,1593,2,0,55,63,1609,1598,draw
643,October 12,2010,Bulgaria,Saudi Arabia,2,0,Friendly,in Turkey,15,-15,1720,1681,3,-1,34,41,1705,1696,T1
644,October 12,2010,China,Uruguay,0,4,Friendly tournament,in China,-16,16,1610,1903,-5,0,57,8,1626,1887,T2
645,October 12,2010,El Salvador,Costa Rica,1,2,Friendly,in Costa Rica,-3,3,1484,1671,-1,0,92,45,1487,1668,T1
646,October 12,2010,Croatia,Norway,2,1,Friendly,in Croatia,5,-5,1912,1797,0,1,7,16,1907,1802,T1
647,October 12,2010,Cyprus,Denmark,0,2,European Championship qualifier,in Denmark,-11,11,1550,1737,-1,2,75,31,1561,1726,T1
648,October 12,2010,Ecuador,Poland,2,2,Friendly,in Canada,-2,2,1713,1653,-3,1,37,47,1715,1651,draw
649,October 12,2010,Montenegro,England,0,0,European Championship qualifier,in England,15,-15,1718,1940,3,0,35,6,1703,1955,draw
650,October 12,2010,Equatorial Guinea,Botswana,0,2,Friendly,in Equatorial Guinea,-12,12,1201,1402,-4,3,157,110,1213,1390,T2
651,October 12,2010,Slovenia,Estonia,1,0,European Championship qualifier,in Estonia,16,-16,1710,1499,4,-4,38,88,1694,1515,T2
652,October 12,2010,Northern Ireland,Faroe Islands,1,1,European Championship qualifier,in the Faroe Islands,-14,14,1580,1210,-1,4,66,153,1594,1196,draw
653,October 12,2010,Hungary,Finland,2,1,European Championship qualifier,in Finland,26,-26,1631,1591,7,-9,51,64,1605,1617,T2
654,October 12,2010,France,Luxembourg,2,0,European Championship qualifier,in France,1,-1,1786,1106,1,0,19,175,1785,1107,T1
655,October 12,2010,Greece,Israel,2,1,European Championship qualifier,in Greece,13,-13,1742,1684,3,-4,29,43,1729,1697,T1
656,October 12,2010,Honduras,Guatemala,2,0,Friendly,in the United States,6,-6,1687,1447,1,-3,42,102,1681,1453,T1
657,October 12,2010,Portugal,Iceland,3,1,European Championship qualifier,in Iceland,8,-8,1871,1438,0,-3,10,105,1863,1446,T2
658,October 12,2010,Indonesia,Maldives,3,0,Friendly,in Indonesia,7,-7,1263,1116,1,0,140,174,1256,1123,T1
659,October 12,2010,Kazakhstan,Germany,0,3,European Championship qualifier,in Kazakhstan,-2,2,1320,2071,0,0,129,4,1322,2069,T2
660,October 12,2010,Vietnam,Kuwait,1,3,Friendly,in Kuwait,-4,4,1326,1544,-1,3,126,77,1330,1540,T1
661,October 12,2010,Latvia,Georgia,1,1,European Championship qualifier,in Latvia,-9,9,1536,1490,-1,1,79,91,1545,1481,draw
662,October 12,2010,Czechia,Liechtenstein,2,0,European Championship qualifier,in Liechtenstein,4,-4,1739,1161,0,-2,30,166,1735,1165,T2
663,October 12,2010,Russia,Macedonia,1,0,European Championship qualifier,in Macedonia,11,-11,1854,1570,1,-2,11,69,1843,1581,T2
664,October 12,2010,Mexico,Venezuela,2,2,Friendly,in Mexico,-6,6,1847,1718,-1,0,12,35,1853,1712,draw
665,October 12,2010,Netherlands,Sweden,4,1,European Championship qualifier,in the Netherlands,7,-7,2103,1810,0,0,3,14,2096,1817,T1
666,October 12,2010,New Zealand,Paraguay,0,2,Friendly,in New Zealand,-11,11,1573,1782,-1,3,67,20,1584,1771,T2
667,October 12,2010,Chile,Oman,1,0,Friendly,in Oman,5,-5,1881,1557,0,0,9,73,1876,1562,T2
668,October 12,2010,Peru,Panama,0,1,Friendly,in Panama,-8,8,1623,1608,-2,2,53,58,1631,1600,T1
669,October 12,2010,Philippines,Macao,5,0,Friendly tournament,in Taiwan,19,-19,848,671,0,-3,205,220,829,690,T1
670,October 12,2010,Iraq,Qatar,2,1,Friendly,in Qatar,12,-12,1566,1510,6,-4,70,86,1554,1522,T2
671,October 12,2010,Moldova,San Marino,2,0,European Championship qualifier,in San Marino,4,-4,1470,908,0,0,94,197,1466,912,T2
672,October 12,2010,Saudi Arabia,Gabon,1,0,Friendly,in Turkey,7,-7,1688,1573,-1,2,41,67,1681,1580,T1
673,October 12,2010,Spain,Scotland,3,2,European Championship qualifier,in Scotland,4,-4,2143,1657,0,0,1,46,2139,1661,T2
674,October 12,2010,Slovakia,Ireland,1,1,European Championship qualifier,in Slovakia,-1,1,1672,1751,0,-1,44,27,1673,1750,draw
675,October 12,2010,Japan,South Korea,0,0,Friendly,in South Korea,1,-1,1787,1737,1,-2,18,31,1786,1738,draw
676,October 12,2010,Wales,Switzerland,1,4,European Championship qualifier,in Switzerland,-12,12,1553,1755,-4,3,74,25,1565,1743,T1
677,October 12,2010,Angola,United Arab Emirates,2,0,Friendly,in the United Arab Emirates,20,-20,1459,1431,7,-7,97,107,1439,1451,T2
678,October 12,2010,United States,Colombia,0,0,Friendly,in the United States,-3,3,1754,1770,-1,0,26,24,1757,1767,draw
679,October 13,2010,Saint Lucia,Guyana,0,1,CONCACAF Champ &amp; Carib Champ qual,in Suriname,-10,10,1078,1278,-1,2,177,137,1088,1268,T1
680,October 13,2010,India,Yemen,3,6,Friendly,in India,-17,17,1191,1341,-4,5,158,122,1208,1324,T2
681,October 13,2010,Netherlands Antilles,Suriname,1,2,CONCACAF Champ &amp; Carib Champ qual,in Suriname,-9,9,1129,1264,0,2,171,140,1138,1255,T1
682,October 14,2010,Dominican Republic,British Virgin Islands,17,0,CONCACAF Champ &amp; Carib Champ qual,in the Dominican Republic,25,-25,1074,855,1,-3,179,204,1049,880,T1
683,October 15,2010,British Virgin Islands,Dominica,0,10,CONCACAF Champ &amp; Carib Champ qual,in the Dominican Republic,-26,26,829,1072,-1,2,205,179,855,1046,T1
684,October 15,2010,Guyana,Netherlands Antilles,3,2,CONCACAF Champ &amp; Carib Champ qual,in Suriname,12,-12,1290,1117,3,-2,134,173,1278,1129,T1
685,October 15,2010,Suriname,Saint Lucia,2,1,CONCACAF Champ &amp; Carib Champ qual,in Suriname,6,-6,1270,1072,0,-2,140,179,1264,1078,T1
686,October 17,2010,Dominican Republic,Dominica,0,1,CONCACAF Champ &amp; Carib Champ qual,in the Dominican Republic,-26,26,1048,1098,-3,3,181,176,1074,1072,T2
687,October 17,2010,Netherlands Antilles,Saint Lucia,2,2,CONCACAF Champ &amp; Carib Champ qual,in Suriname,-3,3,1114,1075,-1,1,174,178,1117,1072,draw
688,October 17,2010,Guyana,Suriname,2,0,CONCACAF Champ &amp; Carib Champ qual,in Suriname,37,-37,1327,1233,7,-6,127,146,1290,1270,T2
689,October 22,2010,Grenada,Puerto Rico,3,1,CONCACAF Champ &amp; Carib Champ qual,in Grenada,7,-7,1278,1014,1,0,138,185,1271,1021,T1
690,October 22,2010,Guadeloupe,Saint Kitts and Nevis,2,1,CONCACAF Champ &amp; Carib Champ qual,in Grenada,7,-7,1464,1173,2,-3,96,162,1457,1180,T1
691,October 22,2010,Cambodia,Laos,0,0,Southeast Asian Championship qualifier,in Laos,10,-10,785,861,1,-2,209,203,775,871,draw
692,October 22,2010,East Timor,Philippines,0,5,Southeast Asian Championship qualifier,in Laos,-13,13,550,861,0,1,229,203,563,848,T1
693,October 24,2010,East Timor,Cambodia,2,4,Southeast Asian Championship qualifier,in Laos,-12,12,538,797,0,2,229,207,550,785,T1
694,October 24,2010,Grenada,Saint Kitts and Nevis,2,0,CONCACAF Champ &amp; Carib Champ qual,in Grenada,14,-14,1292,1159,3,-4,135,166,1278,1173,T1
695,October 24,2010,Guadeloupe,Puerto Rico,3,2,CONCACAF Champ &amp; Carib Champ qual,in Grenada,3,-3,1467,1011,1,-1,95,186,1464,1014,T1
696,October 24,2010,Laos,Philippines,2,2,Southeast Asian Championship qualifier,in Laos,-6,6,855,867,-1,1,204,202,861,861,draw
697,October 26,2010,Cambodia,Philippines,0,0,Southeast Asian Championship qualifier,in Laos,4,-4,801,863,0,0,207,202,797,867,draw
698,October 26,2010,Guadeloupe,Grenada,3,0,CONCACAF Champ &amp; Carib Champ qual,in Grenada,28,-28,1495,1264,5,-4,90,139,1467,1292,T2
699,October 26,2010,East Timor,Laos,1,6,Southeast Asian Championship qualifier,in Laos,-7,7,531,862,0,1,229,203,538,855,T1
700,October 26,2010,Panama,Cuba,0,3,Friendly,in Panama,-29,29,1579,1479,-8,6,66,95,1608,1450,T2
701,October 26,2010,Saint Kitts and Nevis,Puerto Rico,1,0,CONCACAF Champ &amp; Carib Champ qual,in Grenada,12,-12,1171,999,4,0,162,186,1159,1011,T1
702,October 27,2010,Swaziland,Botswana,0,2,Friendly,in Botswana,-4,4,1151,1406,-1,0,169,110,1155,1402,T1
703,October 28,2010,Yemen,Senegal,4,1,Friendly,in Yemen,25,-25,1366,1570,3,-7,119,68,1341,1595,T1
704,October 29,2010,Curaçao,Aruba,3,0,Friendly tournament,in Curaçao,9,-9,1123,930,1,-2,173,193,1114,939,T1
705,October 29,2010,Bonaire,Suriname,2,4,Friendly tournament,in Curaçao,-9,9,983,1242,0,1,187,145,992,1233,T1
706,October 31,2010,Aruba,Bonaire,3,3,Friendly tournament,in Curaçao,2,-2,932,981,1,0,192,187,930,983,draw
707,October 31,2010,Curaçao,Suriname,2,2,Friendly tournament,in Curaçao,1,-1,1124,1241,0,0,173,145,1123,1242,draw
708,November 2,2010,Guyana,Haiti,0,0,CONCACAF Champ &amp; Carib Champ qual,in Trinidad and Tobago,6,-6,1333,1427,3,-1,124,107,1327,1433,draw
709,November 2,2010,Singapore,North Korea,1,2,Friendly tournament,in Vietnam,-9,9,1338,1503,0,3,122,88,1347,1494,T1
710,November 2,2010,Saint Vincent and the Grenadines,Trinidad and Tobago,2,6,CONCACAF Champ &amp; Carib Champ qual,in Trinidad and Tobago,-7,7,1220,1519,-2,2,151,82,1227,1512,T1
711,November 4,2010,Haiti,Saint Vincent and the Grenadines,3,1,CONCACAF Champ &amp; Carib Champ qual,in Trinidad and Tobago,14,-14,1441,1206,3,-2,104,153,1427,1220,T1
712,November 4,2010,Trinidad and Tobago,Guyana,2,1,CONCACAF Champ &amp; Carib Champ qual,in Trinidad and Tobago,6,-6,1525,1327,0,-3,82,127,1519,1333,T1
713,November 4,2010,Singapore,Vietnam,1,1,Friendly tournament,in Vietnam,4,-4,1342,1322,0,-1,122,129,1338,1326,draw
714,November 6,2010,Guyana,Saint Vincent and the Grenadines,2,0,CONCACAF Champ &amp; Carib Champ qual,in Trinidad and Tobago,20,-20,1347,1186,5,-5,122,158,1327,1206,T1
715,November 6,2010,Haiti,Trinidad and Tobago,0,4,CONCACAF Champ &amp; Carib Champ qual,in Trinidad and Tobago,-19,19,1422,1544,-3,5,107,77,1441,1525,T1
716,November 6,2010,Vietnam,North Korea,0,2,Friendly tournament,in Vietnam,-17,17,1305,1520,-2,5,131,83,1322,1503,T2
717,November 7,2010,Uganda,Yemen,2,2,Friendly,in Yemen,-3,3,1558,1369,0,0,72,119,1561,1366,draw
718,November 10,2010,Suriname,Antigua and Barbuda,1,2,CONCACAF Champ &amp; Carib Champ qual,in Antigua and Barbuda,-14,14,1227,1261,-3,3,148,141,1241,1247,T1
719,November 10,2010,Bahrain,Uganda,0,0,Friendly,in Bahrain,-2,2,1539,1560,0,0,79,72,1541,1558,draw
720,November 10,2010,Dominica,Cuba,2,4,CONCACAF Champ &amp; Carib Champ qual,in Antigua and Barbuda,-6,6,1092,1485,0,2,176,93,1098,1479,T1
721,November 10,2010,North Korea,Yemen,1,1,Friendly,in Yemen,-1,1,1519,1370,0,0,83,119,1520,1369,draw
722,November 11,2010,Iraq,India,2,0,Friendly,in the United Arab Emirates,3,-3,1569,1188,0,0,70,157,1566,1191,T1
723,November 12,2010,Dominica,Antigua and Barbuda,0,0,CONCACAF Champ &amp; Carib Champ qual,in Antigua and Barbuda,13,-13,1105,1248,0,-2,176,143,1092,1261,draw
724,November 12,2010,Cuba,Suriname,3,3,CONCACAF Champ &amp; Carib Champ qual,in Antigua and Barbuda,-13,13,1472,1240,-2,3,95,145,1485,1227,draw
725,November 14,2010,Antigua and Barbuda,Cuba,0,0,CONCACAF Champ &amp; Carib Champ qual,in Antigua and Barbuda,7,-7,1255,1465,0,-2,143,97,1248,1472,draw
726,November 14,2010,Bahrain,Syria,0,2,Friendly,in Bahrain,-20,20,1519,1536,-4,5,83,79,1539,1516,T2
727,November 14,2010,Kuwait,India,9,1,Friendly,in the United Arab Emirates,5,-5,1549,1183,0,-1,77,158,1544,1188,T1
728,November 14,2010,Suriname,Dominica,5,0,CONCACAF Champ &amp; Carib Champ qual,in Antigua and Barbuda,25,-25,1265,1080,6,-1,139,177,1240,1105,T1
729,November 16,2010,Guinea-Bissau,Cape Verde,1,2,Friendly,in Portugal,-6,6,1249,1404,-1,0,144,111,1255,1398,T1
730,November 16,2010,Cyprus,Jordan,0,0,Friendly,in Jordan,1,-1,1551,1480,0,0,75,94,1550,1481,draw
731,November 16,2010,Uganda,Saudi Arabia,0,0,Friendly,in the United Arab Emirates,4,-4,1564,1684,0,-1,72,42,1560,1688,draw
732,November 16,2010,Faroe Islands,Scotland,0,3,Friendly,in Scotland,-1,1,1209,1658,0,0,152,46,1210,1657,T1
733,November 17,2010,Albania,Macedonia,0,0,Friendly,in Albania,-2,2,1527,1572,0,0,81,68,1529,1570,draw
734,November 17,2010,Argentina,Brazil,1,0,Friendly,in Qatar,14,-14,1992,2095,0,-1,5,3,1978,2109,T1
735,November 17,2010,Austria,Greece,1,2,Friendly,in Austria,-9,9,1605,1751,-3,2,58,27,1614,1742,T2
736,November 17,2010,Botswana,Tunisia,1,0,African Nations Cup qualifier,in Botswana,25,-25,1431,1578,4,-7,106,65,1406,1603,T1
737,November 17,2010,Bulgaria,Serbia,0,1,Friendly,in Bulgaria,-13,13,1707,1743,-3,5,37,28,1720,1730,T2
738,November 17,2010,Burkina Faso,Guinea,2,1,Friendly,in France,11,-11,1507,1518,2,-4,88,85,1496,1529,T1
739,November 17,2010,Chile,Uruguay,2,0,Friendly,in Chile,12,-12,1893,1891,0,-2,9,10,1881,1903,T1
740,November 17,2010,Latvia,China,0,1,Friendly,in China,-5,5,1531,1615,-1,1,80,56,1536,1610,T1
741,November 17,2010,Peru,Colombia,1,1,Friendly,in Colombia,6,-6,1629,1764,1,-1,52,25,1623,1770,draw
742,November 17,2010,Jamaica,Costa Rica,0,0,Friendly,in the United States,1,-1,1627,1670,-1,1,53,44,1626,1671,draw
743,November 17,2010,Croatia,Malta,3,0,European Championship qualifier,in Croatia,1,-1,1913,1204,0,0,7,153,1912,1205,T1
744,November 17,2010,Czechia,Denmark,0,0,Friendly,in Denmark,3,-3,1742,1734,0,-2,30,33,1739,1737,draw
745,November 17,2010,Ecuador,Venezuela,4,1,Friendly,in Ecuador,13,-13,1726,1705,3,-3,34,38,1713,1718,T1
746,November 17,2010,Egypt,Australia,3,0,Friendly,in Egypt,13,-13,1792,1776,5,-5,18,22,1779,1789,T1
747,November 17,2010,England,France,1,2,Friendly,in England,-16,16,1924,1802,0,2,6,17,1940,1786,T2
748,November 17,2010,Estonia,Liechtenstein,1,1,Friendly,in Estonia,-9,9,1490,1170,-3,3,92,163,1499,1161,draw
749,November 17,2010,San Marino,Finland,0,8,European Championship qualifier,in Finland,-1,1,907,1592,0,1,197,61,908,1591,T1
750,November 17,2010,Ghana,Saudi Arabia,0,0,Friendly,in the United Arab Emirates,-2,2,1743,1686,0,1,28,41,1745,1684,draw
751,November 17,2010,Guatemala,Guyana,3,0,Friendly,in the United States,13,-13,1460,1334,5,-2,97,124,1447,1347,T1
752,November 17,2010,Paraguay,Hong Kong,7,0,Friendly,in Hong Kong,3,-3,1785,1216,0,0,20,151,1782,1219,T2
753,November 17,2010,Lithuania,Hungary,0,2,Friendly,in Hungary,-10,10,1590,1641,-3,0,62,51,1600,1631,T1
754,November 17,2010,Kuwait,Iraq,1,1,Friendly,in the United Arab Emirates,1,-1,1550,1568,2,1,75,69,1549,1569,draw
755,November 17,2010,Norway,Ireland,2,1,Friendly,in Ireland,12,-12,1809,1739,1,-4,15,31,1797,1751,T2
756,November 17,2010,Israel,Iceland,3,2,Friendly,in Israel,2,-2,1686,1436,1,0,41,105,1684,1438,T1
757,November 17,2010,Italy,Romania,1,1,Friendly,in Austria,-4,4,1833,1713,1,3,12,36,1837,1709,draw
758,November 17,2010,Niger,Libya,1,1,Friendly tournament,in Libya,11,-11,1308,1500,1,-4,131,90,1297,1511,draw
759,November 17,2010,Luxembourg,Algeria,0,0,Friendly,in Luxembourg,6,-6,1112,1460,0,-1,175,97,1106,1466,draw
760,November 17,2010,Malawi,Rwanda,2,1,Friendly,in Malawi,6,-6,1402,1347,1,0,111,121,1396,1353,T1
761,November 17,2010,Mali,Democratic Republic of Congo,3,1,Friendly,in France,11,-11,1525,1397,3,-4,82,112,1514,1408,T1
762,November 17,2010,Montenegro,Azerbaijan,2,0,Friendly,in Montenegro,3,-3,1721,1458,0,-2,35,100,1718,1461,T1
763,November 17,2010,Netherlands,Turkey,1,0,Friendly,in the Netherlands,2,-2,2105,1778,1,1,2,21,2103,1780,T1
764,November 17,2010,Morocco,Northern Ireland,1,1,Friendly,in Northern Ireland,3,-3,1568,1577,2,-2,69,66,1565,1580,draw
765,November 17,2010,Oman,Belarus,0,4,Friendly,in Oman,-19,19,1538,1667,-5,4,78,46,1557,1648,T2
766,November 17,2010,Panama,Honduras,2,0,Friendly,in Panama,15,-15,1594,1672,5,-2,60,43,1579,1687,T1
767,November 17,2010,Ivory Coast,Poland,1,3,Friendly,in Poland,-16,16,1766,1669,-4,2,24,45,1782,1653,T1
768,November 17,2010,Portugal,Spain,4,0,Friendly,in Portugal,27,-27,1898,2116,2,0,8,1,1871,2143,T1
769,November 17,2010,Russia,Belgium,0,2,Friendly,in Russia,-27,27,1827,1620,-2,6,13,55,1854,1593,T2
770,November 17,2010,Senegal,Gabon,2,1,Friendly,in France,10,-10,1580,1563,4,-6,64,72,1570,1573,T1
771,November 17,2010,Slovakia,Bosnia and Herzegovina,2,3,Friendly,in Slovakia,-14,14,1658,1626,-3,2,47,54,1672,1612,T2
772,November 17,2010,Slovenia,Georgia,1,2,Friendly,in Slovenia,-17,17,1693,1507,-2,4,40,88,1710,1490,T2
773,November 17,2010,United States,South Africa,1,0,Friendly tournament,in South Africa,14,-14,1768,1608,3,-3,23,57,1754,1622,T2
774,November 17,2010,Sweden,Germany,0,0,Friendly,in Sweden,4,-4,1814,2067,0,0,14,4,1810,2071,draw
775,November 17,2010,Ukraine,Switzerland,2,2,Friendly,in Switzerland,1,-1,1808,1754,-1,-1,16,26,1807,1755,draw
776,November 17,2010,Tajikistan,Afghanistan,1,0,Friendly,in Tajikistan,1,-1,1274,779,0,0,138,210,1273,780,T1
777,November 17,2010,Chad,Togo,0,0,African Nations Cup qualifier,in Togo,13,-13,1234,1382,2,-2,147,115,1221,1395,draw
778,November 18,2010,Haiti,Qatar,1,0,Friendly,in Qatar,15,-15,1437,1495,3,-4,105,90,1422,1510,T2
779,November 18,2010,United Arab Emirates,India,5,0,Friendly,in the United Arab Emirates,5,-5,1436,1178,0,0,106,158,1431,1183,T1
780,November 21,2010,Indonesia,East Timor,6,0,Friendly,in Indonesia,0,0,1263,531,0,0,141,229,1263,531,T1
781,November 22,2010,Qatar,Kuwait,0,1,Gulf Cup,in Yemen,-17,17,1478,1567,-4,4,94,71,1495,1550,T1
782,November 22,2010,Yemen,Saudi Arabia,0,4,Gulf Cup,in Yemen,-17,17,1353,1703,-1,2,120,39,1370,1686,T2
783,November 23,2010,Oman,Bahrain,1,1,Gulf Cup,in Yemen,-1,1,1537,1520,0,0,78,83,1538,1519,draw
784,November 23,2010,Iraq,United Arab Emirates,0,0,Gulf Cup,in Yemen,-7,7,1561,1443,-4,2,73,104,1568,1436,draw
785,November 23,2010,Kenya,Tanzania,0,1,Friendly,in Tanzania,-7,7,1324,1338,-2,2,127,123,1331,1331,T1
786,November 24,2010,Taiwan,Indonesia,0,2,Friendly,in Indonesia,-2,2,922,1265,-1,2,196,139,924,1263,T1
787,November 25,2010,Kuwait,Saudi Arabia,0,0,Gulf Cup,in Yemen,7,-7,1574,1696,3,0,67,39,1567,1703,draw
788,November 25,2010,Yemen,Qatar,1,2,Gulf Cup,in Yemen,-19,19,1334,1497,-4,4,124,90,1353,1478,T2
789,November 26,2010,Trinidad and Tobago,Cuba,0,2,CONCACAF Champ qual &amp; Carib Champ,in Martinique,-37,37,1507,1502,-8,8,85,88,1544,1465,T1
790,November 26,2010,Iraq,Bahrain,3,2,Gulf Cup,in Yemen,18,-18,1579,1502,8,-5,65,88,1561,1520,T1
791,November 26,2010,Grenada,Martinique,1,1,CONCACAF Champ qual &amp; Carib Champ,in Martinique,11,-11,1275,1378,3,-4,138,117,1264,1389,draw
792,November 26,2010,United Arab Emirates,Oman,0,0,Gulf Cup,in Yemen,5,-5,1448,1532,1,0,103,78,1443,1537,draw
793,November 26,2010,Singapore,Laos,4,0,Friendly,in Singapore,1,-1,1343,861,0,-1,121,204,1342,862,T1
794,November 27,2010,Guyana,Guadeloupe,1,1,CONCACAF Champ qual &amp; Carib Champ,in Martinique,9,-9,1343,1486,3,-1,121,93,1334,1495,draw
795,November 27,2010,Antigua and Barbuda,Jamaica,1,3,CONCACAF Champ qual &amp; Carib Champ,in Martinique,-6,6,1249,1633,0,1,143,52,1255,1627,T1
796,November 27,2010,Zambia,Tanzania,1,0,CECAFA Cup,in Tanzania,14,-14,1564,1324,4,-4,72,126,1550,1338,T2
797,November 28,2010,Somalia,Burundi,0,2,CECAFA Cup,in Tanzania,-10,10,914,1213,-1,2,196,152,924,1203,T1
798,November 28,2010,Trinidad and Tobago,Grenada,0,1,CONCACAF Champ qual &amp; Carib Champ,in Martinique,-32,32,1475,1307,-10,6,95,132,1507,1275,T1
799,November 28,2010,Cuba,Martinique,1,0,CONCACAF Champ qual &amp; Carib Champ,in Martinique,19,-19,1521,1359,6,-2,82,119,1502,1378,T2
800,November 28,2010,Saudi Arabia,Qatar,1,1,Gulf Cup,in Yemen,-10,10,1686,1507,-2,5,41,86,1696,1497,draw
801,November 28,2010,Rwanda,Ivory Coast,2,1,CECAFA Cup,in Tanzania,37,-37,1384,1729,7,-9,113,33,1347,1766,T1
802,November 28,2010,Yemen,Kuwait,0,3,Gulf Cup,in Yemen,-22,22,1312,1596,-6,8,130,60,1334,1574,T2
803,November 28,2010,Zanzibar,Sudan,2,0,CECAFA Cup,in Tanzania,35,-35,1344,1331,10,-5,120,124,1309,1366,T1
804,November 29,2010,Antigua and Barbuda,Guyana,1,0,CONCACAF Champ qual &amp; Carib Champ,in Martinique,25,-25,1274,1318,4,-7,139,128,1249,1343,T1
805,November 29,2010,Iraq,Oman,0,0,Gulf Cup,in Yemen,-3,3,1576,1535,-2,0,68,78,1579,1532,draw
806,November 29,2010,Guadeloupe,Jamaica,0,2,CONCACAF Champ qual &amp; Carib Champ,in Martinique,-18,18,1468,1651,-4,2,96,50,1486,1633,T1
807,November 29,2010,Malawi,Kenya,3,2,CECAFA Cup,in Tanzania,16,-16,1418,1308,2,-4,109,130,1402,1324,T1
808,November 29,2010,Bahrain,United Arab Emirates,1,3,Gulf Cup,in Yemen,-35,35,1467,1483,-8,11,97,92,1502,1448,T1
809,November 29,2010,Uganda,Ethiopia,2,1,CECAFA Cup,in Tanzania,7,-7,1571,1277,1,0,71,138,1564,1284,T1
810,November 30,2010,Burundi,Zambia,0,0,CECAFA Cup,in Tanzania,15,-15,1228,1549,2,-3,150,76,1213,1564,draw
811,November 30,2010,Cuba,Grenada,0,0,CONCACAF Champ qual &amp; Carib Champ,in Martinique,-11,11,1510,1318,-2,4,84,128,1521,1307,draw
812,November 30,2010,Martinique,Trinidad and Tobago,0,1,CONCACAF Champ qual &amp; Carib Champ,in Martinique,-19,19,1340,1494,-2,4,121,90,1359,1475,T2
813,November 30,2010,Somalia,Tanzania,0,3,CECAFA Cup,in Tanzania,-4,4,910,1328,0,0,196,125,914,1324,T1
814,December 1,2010,Antigua and Barbuda,Guadeloupe,0,1,CONCACAF Champ qual &amp; Carib Champ,in Martinique,-10,10,1264,1478,-3,1,142,95,1274,1468,T1
815,December 1,2010,Indonesia,Malaysia,5,1,Southeast Asian Championship,in Indonesia,19,-19,1284,1157,3,-6,138,167,1265,1176,T1
816,December 1,2010,Zanzibar,Ivory Coast,0,1,CECAFA Cup,in Tanzania,-4,4,1340,1733,-1,0,120,33,1344,1729,T1
817,December 1,2010,Guyana,Jamaica,0,4,CONCACAF Champ qual &amp; Carib Champ,in Martinique,-10,10,1308,1661,-2,3,130,47,1318,1651,T1
818,December 1,2010,Laos,Thailand,2,2,Southeast Asian Championship,in Indonesia,19,-19,880,1437,3,-3,201,105,861,1456,draw
819,December 1,2010,Rwanda,Sudan,0,0,CECAFA Cup,in Tanzania,-3,3,1381,1334,-2,0,115,123,1384,1331,draw
820,December 2,2010,Ethiopia,Kenya,2,1,CECAFA Cup,in Tanzania,22,-22,1299,1286,6,-8,133,138,1277,1308,T1
821,December 2,2010,Iraq,Kuwait,2,2,Gulf Cup,in Yemen,1,-1,1577,1595,1,0,67,60,1576,1596,draw
822,December 2,2010,Uganda,Malawi,1,1,CECAFA Cup,in Tanzania,-8,8,1563,1426,-1,0,72,109,1571,1418,draw
823,December 2,2010,Singapore,Philippines,1,1,Southeast Asian Championship,in Vietnam,-18,18,1325,881,-6,2,125,201,1343,863,draw
824,December 2,2010,United Arab Emirates,Saudi Arabia,0,1,Gulf Cup,in Yemen,-9,9,1474,1695,-2,1,95,40,1483,1686,T1
825,December 2,2010,Myanmar,Vietnam,1,7,Southeast Asian Championship,in Vietnam,-17,17,1147,1322,-5,6,169,127,1164,1305,T1
826,December 3,2010,Guadeloupe,Cuba,2,1,Caribbean Championship,in Martinique,22,-22,1500,1488,6,-8,88,92,1478,1510,T1
827,December 3,2010,Jamaica,Grenada,2,1,Caribbean Championship,in Martinique,5,-5,1666,1313,0,0,47,129,1661,1318,T1
828,December 3,2010,Zanzibar,Rwanda,0,0,CECAFA Cup,in Tanzania,2,-2,1342,1379,0,-1,119,116,1340,1381,draw
829,December 3,2010,Zambia,Somalia,6,0,CECAFA Cup,in Tanzania,2,-2,1551,908,1,0,75,196,1549,910,T1
830,December 4,2010,Malawi,Ethiopia,1,1,CECAFA Cup,in Tanzania,-7,7,1419,1306,0,0,109,133,1426,1299,draw
831,December 4,2010,Indonesia,Laos,6,0,Southeast Asian Championship,in Indonesia,4,-4,1288,876,2,0,137,202,1284,880,T1
832,December 4,2010,Thailand,Malaysia,0,0,Southeast Asian Championship,in Indonesia,-13,13,1424,1170,-3,4,108,162,1437,1157,draw
833,December 4,2010,Burundi,Tanzania,0,2,CECAFA Cup,in Tanzania,-14,14,1214,1342,-2,5,152,119,1228,1328,T1
834,December 5,2010,Grenada,Cuba,0,1,Caribbean Championship,in Martinique,-11,11,1302,1499,-3,2,132,90,1313,1488,T1
835,December 5,2010,Jamaica,Guadeloupe,1,1,Caribbean Championship,in Martinique,-9,9,1657,1509,-2,3,49,85,1666,1500,draw
836,December 5,2010,Ivory Coast,Sudan,3,0,CECAFA Cup,in Tanzania,6,-6,1739,1328,3,-2,30,125,1733,1334,T1
837,December 5,2010,Kuwait,Saudi Arabia,1,0,Gulf Cup,in Yemen,26,-26,1621,1669,5,-4,55,44,1595,1695,T1
838,December 5,2010,Singapore,Myanmar,2,1,Southeast Asian Championship,in Vietnam,11,-11,1336,1136,2,-1,123,170,1325,1147,T1
839,December 5,2010,Kenya,Uganda,0,2,CECAFA Cup,in Tanzania,-10,10,1276,1573,1,3,138,69,1286,1563,T1
840,December 5,2010,Philippines,Vietnam,2,0,Southeast Asian Championship,in Vietnam,57,-57,938,1265,10,-13,191,140,881,1322,T2
841,December 7,2010,Zambia,Ethiopia,1,2,CECAFA Cup,in Tanzania,-32,32,1519,1338,-6,9,81,122,1551,1306,T1
842,December 7,2010,Thailand,Indonesia,1,2,Southeast Asian Championship,in Indonesia,-22,22,1402,1310,-3,6,111,130,1424,1288,T1
843,December 7,2010,Malawi,Ivory Coast,0,1,CECAFA Cup,in Tanzania,-5,5,1414,1744,1,3,108,27,1419,1739,T1
844,December 7,2010,Laos,Malaysia,1,5,Southeast Asian Championship,in Indonesia,-12,12,864,1182,-1,4,203,158,876,1170,T1
845,December 8,2010,Myanmar,Philippines,0,0,Southeast Asian Championship,in Vietnam,-10,10,1126,948,0,0,170,191,1136,938,draw
846,December 8,2010,Tanzania,Rwanda,1,0,CECAFA Cup,in Tanzania,16,-16,1358,1363,0,-2,119,118,1342,1379,T1
847,December 8,2010,Uganda,Zanzibar,2,2,CECAFA Cup,in Tanzania,-12,12,1561,1354,-4,-1,73,120,1573,1342,draw
848,December 8,2010,Vietnam,Singapore,1,0,Southeast Asian Championship,in Vietnam,18,-18,1283,1318,2,-4,138,128,1265,1336,T1
849,December 10,2010,Bosnia and Herzegovina,Poland,2,2,Friendly,in Turkey,1,-1,1627,1668,0,-1,54,45,1626,1669,draw
850,December 10,2010,Ivory Coast,Ethiopia,1,0,CECAFA Cup,in Tanzania,4,-4,1748,1334,0,-1,27,123,1744,1338,T1
851,December 10,2010,Uganda,Tanzania,0,0,CECAFA Cup,in Tanzania,-6,6,1555,1364,0,1,73,118,1561,1358,draw
852,December 12,2010,Tanzania,Ivory Coast,1,0,CECAFA Cup,in Tanzania,33,-33,1397,1715,6,-8,112,35,1364,1748,T1
853,December 12,2010,Uganda,Ethiopia,4,3,CECAFA Cup,in Tanzania,9,-9,1564,1325,1,-2,72,125,1555,1334,T1
854,December 15,2010,Vietnam,Malaysia,0,2,Southeast Asian Championship,in Malaysia,-30,30,1253,1212,-5,5,143,153,1283,1182,T1
855,December 16,2010,Philippines,Indonesia,0,1,Southeast Asian Championship,in Indonesia,-3,3,945,1313,0,1,191,129,948,1310,T1
856,December 16,2010,Egypt,Qatar,1,2,Friendly,in Qatar,-15,15,1777,1522,-3,5,21,81,1792,1507,T1
857,December 18,2010,China,Estonia,3,0,Friendly,in China,8,-8,1623,1482,2,-1,55,93,1615,1490,T1
858,December 18,2010,Panama,Honduras,1,2,Friendly,in Honduras,-5,5,1589,1677,-2,0,63,42,1594,1672,T1
859,December 18,2010,Syria,Iraq,1,0,Friendly,in Iraq,14,-14,1550,1563,0,-5,76,72,1536,1577,T2
860,December 18,2010,Vietnam,Malaysia,0,0,Southeast Asian Championship,in Vietnam,-8,8,1245,1220,-2,2,145,151,1253,1212,draw
861,December 19,2010,Indonesia,Philippines,1,0,Southeast Asian Championship,in Indonesia,3,-3,1316,942,0,0,129,191,1313,945,T1
862,December 22,2010,China,Macedonia,1,0,Friendly,in China,6,-6,1629,1566,2,-2,53,71,1623,1572,T1
863,December 22,2010,Qatar,Estonia,2,0,Friendly,in Qatar,9,-9,1531,1473,3,-2,78,95,1522,1482,T1
864,December 22,2010,Iraq,Syria,1,0,Friendly,in Syria,12,-12,1575,1538,4,0,68,76,1563,1550,T2
865,December 24,2010,Kuwait,North Korea,2,1,Friendly,in Egypt,7,-7,1628,1512,1,-2,55,84,1621,1519,T1
866,December 25,2010,Bahrain,Uzbekistan,1,1,Friendly,in the United Arab Emirates,1,-1,1468,1509,0,0,97,85,1467,1510,draw
867,December 26,2010,Indonesia,Malaysia,0,3,Southeast Asian Championship,in Malaysia,-35,35,1281,1255,-8,8,137,143,1316,1220,T1
868,December 27,2010,North Korea,Kuwait,2,2,Friendly,in Egypt,3,-3,1515,1625,0,-1,84,56,1512,1628,draw
869,December 28,2010,Algeria,Chad,3,1,Friendly,in Algeria,4,-4,1464,1230,0,-1,98,149,1460,1234,T1
870,December 28,2010,Jordan,Bahrain,1,2,Friendly,in the United Arab Emirates,-10,10,1470,1478,-3,4,96,93,1480,1468,T1
871,December 28,2010,Iran,Qatar,0,0,Friendly,in Qatar,-2,2,1694,1533,0,0,39,78,1696,1531,draw
872,December 28,2010,Saudi Arabia,Iraq,0,1,Friendly,in Saudi Arabia,-15,15,1654,1590,-5,6,49,62,1669,1575,T2
873,December 29,2010,Malaysia,Indonesia,1,2,Southeast Asian Championship,in Indonesia,-13,13,1242,1294,-3,3,146,134,1255,1281,T1
874,December 30,2010,Syria,South Korea,0,1,Friendly,in the United Arab Emirates,-5,5,1533,1742,-1,2,77,29,1538,1737,T1
875,December 31,2010,Saudi Arabia,Bahrain,1,0,Friendly,in Bahrain,8,-8,1662,1470,3,-2,46,95,1654,1478,T2
876,December 31,2010,Zambia,Kuwait,0,4,Friendly,in Egypt,-13,13,1506,1638,-6,3,88,53,1519,1625,T1
877,January 2,2011,China,Iraq,3,2,Friendly,in Qatar,9,-9,1638,1581,1,-2,53,64,1629,1590,T1
878,January 2,2011,Angola,Iran,0,1,Friendly,in Qatar,-4,4,1455,1698,-1,0,101,39,1459,1694,T1
879,January 2,2011,Jordan,Uzbekistan,2,2,Friendly,in the United Arab Emirates,1,-1,1471,1508,0,-1,95,85,1470,1509,draw
880,January 2,2011,United Arab Emirates,Syria,2,0,Friendly,in the United Arab Emirates,13,-13,1487,1520,1,-4,92,81,1474,1533,T1
881,January 4,2011,North Korea,Bahrain,1,0,Friendly,in Bahrain,11,-11,1539,1459,2,-4,76,100,1528,1470,T2
882,January 4,2011,Angola,Saudi Arabia,0,0,Friendly,in Saudi Arabia,7,-7,1462,1655,3,-3,98,49,1455,1662,draw
883,January 5,2011,Egypt,Tanzania,5,1,Friendly tournament,in Egypt,3,-3,1780,1394,1,-1,20,113,1777,1397,T1
884,January 5,2011,Sudan,Kenya,0,1,Friendly tournament,in Egypt,-17,17,1311,1293,-5,3,129,135,1328,1276,T1
885,January 5,2011,Australia,United Arab Emirates,0,0,Friendly,in the United Arab Emirates,-5,5,1771,1492,0,0,22,92,1776,1487,draw
886,January 5,2011,Burundi,Uganda,1,3,Friendly tournament,in Egypt,-5,5,1209,1569,0,2,153,70,1214,1564,T1
887,January 7,2011,Qatar,Uzbekistan,0,2,Asian Cup,in Qatar,-49,49,1471,1557,-13,11,94,74,1520,1508,T2
888,January 8,2011,Burundi,Tanzania,1,1,Friendly tournament,in Egypt,7,-7,1216,1387,1,0,152,113,1209,1394,draw
889,January 8,2011,China,Kuwait,2,0,Asian Cup,in Qatar,38,-38,1676,1600,10,-6,43,59,1638,1638,T1
890,January 8,2011,Kenya,Democratic Republic of Congo,0,1,Friendly tournament,in Egypt,-11,11,1282,1408,-3,3,138,109,1293,1397,T1
891,January 8,2011,Egypt,Uganda,1,0,Friendly tournament,in Egypt,4,-4,1784,1565,0,-2,20,72,1780,1569,T1
892,January 9,2011,Japan,Jordan,1,1,Asian Cup,in Qatar,-18,18,1769,1489,-4,2,22,92,1787,1471,draw
893,January 9,2011,Saudi Arabia,Syria,1,2,Asian Cup,in Qatar,-34,34,1621,1554,-5,7,55,75,1655,1520,T1
894,January 10,2011,India,Australia,0,4,Asian Cup,in Qatar,-3,3,1175,1774,-2,0,161,21,1178,1771,T1
895,January 10,2011,South Korea,Bahrain,2,1,Asian Cup,in Qatar,8,-8,1750,1451,2,-2,27,102,1742,1459,T1
896,January 11,2011,Democratic Republic of Congo,Sudan,2,1,Friendly tournament,in Egypt,11,-11,1419,1300,1,-3,108,132,1408,1311,T1
897,January 11,2011,Egypt,Burundi,3,0,Friendly tournament,in Egypt,1,-1,1785,1215,1,-1,18,153,1784,1216,T1
898,January 11,2011,Iran,Iraq,2,1,Asian Cup,in Qatar,17,-17,1715,1564,4,-7,35,71,1698,1581,T1
899,January 11,2011,North Korea,United Arab Emirates,0,0,Asian Cup,in Qatar,-3,3,1536,1495,0,1,78,90,1539,1492,draw
900,January 11,2011,Tanzania,Uganda,1,1,Friendly tournament,in Egypt,7,-7,1394,1558,0,-1,113,73,1387,1565,draw
901,January 12,2011,China,Qatar,0,2,Asian Cup,in Qatar,-49,49,1627,1520,-10,12,53,83,1676,1471,T1
902,January 12,2011,Uzbekistan,Kuwait,2,1,Asian Cup,in Qatar,28,-28,1585,1572,11,-10,63,69,1557,1600,T1
903,January 13,2011,Japan,Syria,2,1,Asian Cup,in Qatar,11,-11,1780,1543,2,-2,20,77,1769,1554,T1
904,January 13,2011,Saudi Arabia,Jordan,0,1,Asian Cup,in Qatar,-34,34,1587,1523,-7,10,62,83,1621,1489,T1
905,January 14,2011,Australia,South Korea,1,1,Asian Cup,in Qatar,-2,2,1772,1752,0,1,22,26,1774,1750,draw
906,January 14,2011,Bahrain,India,5,2,Asian Cup,in Qatar,15,-15,1466,1160,5,-4,97,165,1451,1175,T1
907,January 14,2011,Honduras,Costa Rica,1,1,CONCACAF Champ q &amp; Central Am Cup,in Panama,0,0,1677,1670,0,0,42,43,1677,1670,draw
908,January 14,2011,Kenya,Egypt,1,5,Friendly tournament,in Egypt,-2,2,1280,1787,0,0,138,18,1282,1785,T1
909,January 14,2011,El Salvador,Nicaragua,2,0,CONCACAF Champ q &amp; Central Am Cup,in Panama,5,-5,1489,1070,0,-1,94,179,1484,1075,T1
910,January 14,2011,Panama,Belize,2,0,CONCACAF Champ q &amp; Central Am Cup,in Panama,2,-2,1591,1082,1,0,60,176,1589,1084,T1
911,January 14,2011,Uganda,Democratic Republic of Congo,1,0,Friendly tournament,in Egypt,9,-9,1567,1410,3,-1,71,109,1558,1419,T1
912,January 15,2011,North Korea,Iran,0,1,Asian Cup,in Qatar,-13,13,1523,1728,-4,2,82,33,1536,1715,T1
913,January 15,2011,Iraq,United Arab Emirates,1,0,Asian Cup,in Qatar,20,-20,1584,1475,9,-2,64,94,1564,1495,T1
914,January 16,2011,China,Uzbekistan,2,2,Asian Cup,in Qatar,-3,3,1624,1588,-1,1,54,62,1627,1585,draw
915,January 16,2011,Guatemala,Costa Rica,0,2,CONCACAF Champ q &amp; Central Am Cup,in Panama,-14,14,1446,1684,-2,1,102,42,1460,1670,T1
916,January 16,2011,El Salvador,Belize,5,2,CONCACAF Champ q &amp; Central Am Cup,in Panama,6,-6,1495,1076,1,-1,92,177,1489,1082,T1
917,January 16,2011,Panama,Nicaragua,2,0,CONCACAF Champ q &amp; Central Am Cup,in Panama,2,-2,1593,1068,1,0,59,179,1591,1070,T1
918,January 16,2011,Kuwait,Qatar,0,3,Asian Cup,in Qatar,-38,38,1534,1558,-9,10,79,74,1572,1520,T1
919,January 16,2011,Sudan,Tanzania,2,0,Friendly tournament,in Egypt,28,-28,1328,1366,8,-5,124,118,1300,1394,T1
920,January 17,2011,Democratic Republic of Congo,Kenya,1,0,Friendly tournament,in Egypt,10,-10,1420,1270,1,-1,108,139,1410,1280,T1
921,January 17,2011,Egypt,Uganda,3,1,Friendly tournament,in Egypt,6,-6,1793,1561,-1,-2,19,73,1787,1567,T1
922,January 17,2011,Saudi Arabia,Japan,0,5,Asian Cup,in Qatar,-25,25,1562,1805,-9,3,72,17,1587,1780,T1
923,January 17,2011,Jordan,Syria,2,1,Asian Cup,in Qatar,26,-26,1549,1517,6,-8,77,85,1523,1543,T1
924,January 18,2011,Bahrain,Australia,0,1,Asian Cup,in Qatar,-7,7,1459,1779,-2,1,99,21,1466,1772,T1
925,January 18,2011,Belize,Nicaragua,1,1,CONCACAF Champ q &amp; Central Am Cup,in Panama,0,0,1076,1068,0,0,177,179,1076,1068,draw
926,January 18,2011,Guatemala,Honduras,1,3,CONCACAF Champ q &amp; Central Am Cup,in Panama,-13,13,1433,1690,-4,2,106,41,1446,1677,T1
927,January 18,2011,El Salvador,Panama,0,2,CONCACAF Champ q &amp; Central Am Cup,in Panama,-15,15,1480,1608,-1,3,93,56,1495,1593,T1
928,January 18,2011,South Korea,India,4,1,Asian Cup,in Qatar,3,-3,1755,1157,1,-1,25,166,1752,1160,T1
929,January 19,2011,Iran,United Arab Emirates,3,0,Asian Cup,in Qatar,17,-17,1745,1458,5,-5,28,99,1728,1475,T1
930,January 19,2011,North Korea,Iraq,0,1,Asian Cup,in Qatar,-21,21,1502,1605,-6,5,89,58,1523,1584,T1
931,January 19,2011,Sweden,Botswana,2,1,Friendly,in South Africa,2,-2,1816,1429,0,0,14,107,1814,1431,T1
932,January 21,2011,Guatemala,Nicaragua,2,1,CONCACAF Champ q &amp; Central Am Cup,in Panama,4,-4,1437,1064,2,0,104,179,1433,1068,T1
933,January 21,2011,El Salvador,Honduras,0,2,Central American Cup,in Panama,-14,14,1466,1704,-2,1,95,40,1480,1690,T1
934,January 21,2011,Costa Rica,Panama,1,1,Central American Cup,in Panama,1,-1,1685,1607,0,-2,43,58,1684,1608,draw
935,January 21,2011,Qatar,Japan,2,3,Asian Cup,in Qatar,-15,15,1543,1820,-2,3,76,14,1558,1805,T2
936,January 21,2011,Jordan,Uzbekistan,1,2,Asian Cup,in Qatar,-22,22,1527,1610,-3,7,80,56,1549,1588,T1
937,January 22,2011,Iraq,Australia,0,1,Asian Cup,in Qatar,-13,13,1592,1792,-2,1,61,20,1605,1779,T1
938,January 22,2011,Iran,South Korea,0,1,Asian Cup,in Qatar,-24,24,1721,1779,-6,3,34,22,1745,1755,T1
939,January 22,2011,United States,Chile,1,1,Friendly,in the United States,1,-1,1769,1892,-1,0,24,9,1768,1893,draw
940,January 23,2011,Costa Rica,Honduras,1,2,Central American Cup,in Panama,-19,19,1666,1723,-2,6,45,34,1685,1704,T1
941,January 23,2011,El Salvador,Panama,0,0,Central American Cup,in Panama,12,-12,1478,1595,2,-2,93,60,1466,1607,draw
942,January 24,2011,Vanuatu,New Caledonia,0,0,Friendly,in Vanuatu,-1,1,1229,1290,-1,0,150,136,1230,1289,draw
943,January 25,2011,Uzbekistan,Australia,0,6,Asian Cup,in Qatar,-28,28,1582,1820,-7,6,63,14,1610,1792,T1
944,January 25,2011,South Korea,Japan,2,2,Asian Cup,in Qatar,3,-3,1782,1817,0,-1,22,15,1779,1820,draw
945,January 28,2011,Uzbekistan,South Korea,2,3,Asian Cup,in Qatar,-12,12,1570,1794,-5,2,68,20,1582,1782,T1
946,January 29,2011,Australia,Japan,0,1,Asian Cup,in Qatar,-25,25,1795,1842,-5,3,19,12,1820,1817,T1
947,February 6,2011,Moldova,Poland,0,1,Friendly,in Portugal,-5,5,1465,1673,0,0,95,43,1470,1668,T1
948,February 8,2011,Sweden,Cyprus,2,0,Friendly tournament,in Cyprus,13,-13,1829,1538,1,-1,14,76,1816,1551,T2
949,February 8,2011,Equatorial Guinea,Chad,2,0,Friendly,in Equatorial Guinea,12,-12,1213,1218,2,-2,154,151,1201,1230,T1
950,February 8,2011,Togo,Ghana,1,4,Friendly,in Belgium,-4,4,1378,1747,-2,0,116,28,1382,1743,T1
951,February 8,2011,Ireland,Wales,3,0,Friendly tournament,in Ireland,8,-8,1747,1545,3,0,28,74,1739,1553,T1
952,February 8,2011,Ivory Coast,Mali,1,0,Friendly,in France,5,-5,1720,1520,0,0,37,82,1715,1525,T1
953,February 8,2011,Peru,Panama,1,0,Friendly,in Peru,6,-6,1635,1589,0,-3,52,62,1629,1595,T1
954,February 8,2011,Romania,Ukraine,2,2,Friendly tournament,in Cyprus,4,-4,1717,1804,0,0,38,17,1713,1808,draw
955,February 9,2011,Albania,Slovenia,1,2,Friendly,in Albania,-8,8,1519,1701,-2,1,82,40,1527,1693,T2
956,February 9,2011,Argentina,Portugal,2,1,Friendly,in Switzerland,7,-7,1999,1891,0,-1,5,9,1992,1898,T1
957,February 9,2011,Kazakhstan,Belarus,1,1,Friendly,in Turkey,8,-8,1328,1659,3,-3,124,47,1320,1667,draw
958,February 9,2011,Belgium,Finland,1,1,Friendly,in Belgium,-4,4,1616,1596,0,1,55,58,1620,1592,draw
959,February 9,2011,Macao,Cambodia,1,3,Asian Cup &amp; Asian Challenge Cup qual,in Cambodia,-13,13,658,814,0,0,220,207,671,801,T1
960,February 9,2011,Burkina Faso,Cape Verde,0,1,Friendly,in Portugal,-13,13,1494,1417,-5,2,91,109,1507,1404,T1
961,February 9,2011,Czechia,Croatia,2,4,Friendly,in Croatia,-5,5,1737,1918,0,0,31,7,1742,1913,T1
962,February 9,2011,Romania,Cyprus,1,1,Friendly tournament,in Cyprus,-3,3,1714,1541,0,0,38,76,1717,1538,draw
963,February 9,2011,Denmark,England,1,2,Friendly,in Denmark,-7,7,1727,1931,-2,0,34,6,1734,1924,T2
964,February 9,2011,El Salvador,Haiti,1,0,Friendly,in El Salvador,6,-6,1484,1431,0,-2,93,106,1478,1437,T1
965,February 9,2011,France,Brazil,1,0,Friendly,in France,15,-15,1817,2080,3,0,15,3,1802,2095,T1
966,February 9,2011,Gabon,Democratic Republic of Congo,2,0,Friendly,in France,9,-9,1572,1411,4,-2,67,110,1563,1420,T1
967,February 9,2011,Georgia,Armenia,2,1,Friendly,in Cyprus,8,-8,1515,1433,2,-2,84,105,1507,1441,T1
968,February 9,2011,Italy,Germany,1,1,Friendly,in Germany,7,-7,1840,2060,0,0,13,4,1833,2067,draw
969,February 9,2011,Canada,Greece,0,1,Friendly,in Greece,-4,4,1596,1755,0,0,58,27,1600,1751,T1
970,February 9,2011,Gambia,Guinea-Bissau,1,3,Friendly,in Portugal,-21,21,1386,1270,-2,4,112,139,1407,1249,T1
971,February 9,2011,Ecuador,Honduras,1,1,Friendly,in Honduras,3,-3,1729,1720,0,-2,33,36,1726,1723,draw
972,February 9,2011,Azerbaijan,Hungary,0,2,Friendly,in the United Arab Emirates,-8,8,1450,1649,-2,1,101,50,1458,1641,T1
973,February 9,2011,Iran,Russia,1,0,Friendly,in the United Arab Emirates,13,-13,1734,1814,3,-1,32,16,1721,1827,T1
974,February 9,2011,Israel,Serbia,0,2,Friendly,in Israel,-17,17,1669,1760,-3,4,45,26,1686,1743,T2
975,February 9,2011,Libya,Benin,3,2,Friendly,in Libya,6,-6,1506,1440,2,0,88,102,1500,1446,T1
976,February 9,2011,Luxembourg,Slovakia,2,1,Friendly,in Luxembourg,19,-19,1131,1639,5,-5,170,51,1112,1658,T1
977,February 9,2011,Macedonia,Cameroon,0,1,Friendly,in Macedonia,-10,10,1556,1660,-3,4,73,46,1566,1650,T2
978,February 9,2011,Hong Kong,Malaysia,0,2,Friendly,in Malaysia,-10,10,1206,1252,-4,2,156,144,1216,1242,T1
979,February 9,2011,Malta,Switzerland,0,0,Friendly,in Malta,9,-9,1213,1745,3,-4,153,30,1204,1754,draw
980,February 9,2011,Bosnia and Herzegovina,Mexico,0,2,Friendly,in the United States,-7,7,1620,1854,-1,0,54,11,1627,1847,T1
981,February 9,2011,Moldova,Andorra,2,1,Friendly,in Portugal,1,-1,1466,1012,0,0,95,185,1465,1013,T1
982,February 9,2011,Niger,Morocco,0,3,Friendly,in Morocco,-4,4,1304,1572,-1,2,131,67,1308,1568,T1
983,February 9,2011,Botswana,Mozambique,1,1,Friendly,in Mozambique,1,-1,1430,1380,0,0,107,114,1429,1381,draw
984,February 9,2011,Namibia,Malawi,1,2,Friendly,in Namibia,-9,9,1284,1423,-2,1,137,108,1293,1414,T2
985,February 9,2011,Netherlands,Austria,3,1,Friendly,in the Netherlands,1,-1,2106,1604,0,0,2,57,2105,1605,T1
986,February 9,2011,Sierra Leone,Nigeria,1,2,Friendly,in Nigeria,-1,1,1294,1654,0,0,133,49,1295,1653,T1
987,February 9,2011,Philippines,Mongolia,2,0,Asian Cup &amp; Asian Challenge Cup qual,in the Philippines,12,-12,954,782,0,-1,191,209,942,794,T1
988,February 9,2011,Poland,Norway,1,0,Friendly,in Portugal,14,-14,1687,1795,1,-3,42,19,1673,1809,T1
989,February 9,2011,San Marino,Liechtenstein,0,1,Friendly,in San Marino,-6,6,901,1176,0,1,198,161,907,1170,T2
990,February 9,2011,Northern Ireland,Scotland,0,3,Friendly tournament,in Ireland,-20,20,1557,1678,-6,3,72,43,1577,1658,T1
991,February 9,2011,Guinea,Senegal,0,3,Friendly,in Senegal,-10,10,1508,1590,-4,3,87,61,1518,1580,T1
992,February 9,2011,South Africa,Kenya,2,0,Friendly,in South Africa,2,-2,1610,1268,0,-1,56,140,1608,1270,T1
993,February 9,2011,Spain,Colombia,1,0,Friendly,in Spain,1,-1,2117,1763,0,0,1,25,2116,1764,T1
994,February 9,2011,Swaziland,Zambia,0,4,Friendly,in Swaziland,-7,7,1144,1513,0,3,168,85,1151,1506,T2
995,February 9,2011,Ukraine,Sweden,1,1,Friendly tournament,in Cyprus,1,-1,1805,1828,0,0,17,14,1804,1829,draw
996,February 9,2011,Tanzania,Palestine,1,0,Friendly,in Tanzania,3,-3,1369,1156,0,-1,118,166,1366,1159,T1
997,February 9,2011,Turkey,South Korea,0,0,Friendly,in Turkey,-2,2,1776,1796,0,2,23,18,1778,1794,draw
998,February 9,2011,Costa Rica,Venezuela,2,2,Friendly,in Venezuela,4,-4,1670,1701,1,0,44,40,1666,1705,draw
999,February 10,2011,Laos,Taiwan,2,5,Asian Cup &amp; Asian Challenge Cup qual,in Taiwan,-20,20,844,942,-1,4,204,192,864,922,T1
1000,February 14,2011,Bahrain,Kuwait,0,0,Friendly,in Bahrain,-1,1,1458,1535,0,1,98,77,1459,1534,draw
1001,February 16,2011,Taiwan,Laos,1,1,Asian Cup &amp; Asian Challenge Cup qual,in Laos,0,0,942,844,0,0,192,204,942,844,draw
1002,February 16,2011,Macao,Cambodia,3,2,Asian Cup &amp; Asian Challenge Cup qual,in Macao,23,-23,681,791,1,-1,219,208,658,814,T1
1003,March 11,2011,Gibraltar,Faroe Islands,3,0,Friendly,in Gibraltar,17,-17,1143,1192,2,-2,169,157,1126,1209,T1
1004,March 15,2011,Mongolia,Philippines,2,1,Asian Cup &amp; Asian Challenge Cup qual,in Mongolia,24,-24,806,930,2,-4,207,195,782,954,T1
1005,March 16,2011,Venezuela,Argentina,1,4,Friendly,in Argentina,-3,3,1698,2002,-1,0,41,5,1701,1999,T1
1006,March 16,2011,Namibia,Botswana,1,1,Friendly,in Botswana,6,-6,1290,1424,2,0,135,107,1284,1430,draw
1007,March 17,2011,Nepal,Bhutan,1,0,Friendly,in Nepal,1,-1,963,597,0,0,188,224,962,598,T1
1008,March 19,2011,Bhutan,Nepal,1,2,Friendly,in Nepal,-1,1,596,964,0,0,224,188,597,963,T1
1009,March 21,2011,Taiwan,India,0,3,Asian Cup &amp; Asian Challenge Cup qual,in Malaysia,-16,16,926,1173,-4,3,195,162,942,1157,T1
1010,March 21,2011,Maldives,Cambodia,4,0,Asian Cup &amp; Asian Challenge Cup qual,in the Maldives,6,-6,1122,785,1,0,174,209,1116,791,T1
1011,March 21,2011,Myanmar,Philippines,1,1,Asian Cup &amp; Asian Challenge Cup qual,in Myanmar,-14,14,1112,944,-3,4,175,191,1126,930,draw
1012,March 21,2011,Bangladesh,Palestine,0,2,Asian Cup &amp; Asian Challenge Cup qual,in Myanmar,-13,13,923,1169,-4,2,196,164,936,1156,T1
1013,March 21,2011,Tajikistan,Kyrgyzstan,1,0,Asian Cup &amp; Asian Challenge Cup qual,in the Maldives,14,-14,1288,1152,1,-4,137,167,1274,1166,T1
1014,March 21,2011,Turkmenistan,Pakistan,3,0,Asian Cup &amp; Asian Challenge Cup qual,in Malaysia,4,-4,1377,887,0,-1,117,200,1373,891,T1
1015,March 23,2011,Afghanistan,Bhutan,3,0,Asian Cup &amp; Asian Challenge Cup qual,in India,18,-18,797,578,2,-2,208,226,779,596,T1
1016,March 23,2011,Pakistan,India,1,3,Asian Cup &amp; Asian Challenge Cup qual,in Malaysia,-10,10,877,1183,-1,3,201,159,887,1173,T1
1017,March 23,2011,Kyrgyzstan,Maldives,1,2,Asian Cup &amp; Asian Challenge Cup qual,in the Maldives,-16,16,1136,1138,-4,4,171,170,1152,1122,T1
1018,March 23,2011,Myanmar,Bangladesh,0,2,Asian Cup &amp; Asian Challenge Cup qual,in Myanmar,-50,50,1062,973,-4,8,179,188,1112,923,T2
1019,March 23,2011,Palestine,Philippines,0,0,Asian Cup &amp; Asian Challenge Cup qual,in Myanmar,-11,11,1158,955,-1,-1,165,192,1169,944,draw
1020,March 23,2011,Cambodia,Tajikistan,0,3,Asian Cup &amp; Asian Challenge Cup qual,in the Maldives,-4,4,781,1292,-1,2,210,135,785,1288,T1
1021,March 23,2011,Turkmenistan,Taiwan,2,0,Asian Cup &amp; Asian Challenge Cup qual,in Malaysia,4,-4,1381,922,3,-1,114,196,1377,926,T1
1022,March 24,2011,Cuba,El Salvador,0,1,Friendly,in Cuba,-13,13,1486,1497,-3,3,93,90,1499,1484,T2
1023,March 25,2011,Afghanistan,Bhutan,2,0,Asian Cup &amp; Asian Challenge Cup qual,in India,13,-13,810,565,1,-1,207,227,797,578,T1
1024,March 25,2011,Austria,Belgium,0,2,European Championship qualifier,in Austria,-37,37,1567,1653,-11,6,68,49,1604,1616,T2
1025,March 25,2011,China,New Zealand,1,1,Friendly,in China,-4,4,1620,1577,-1,2,54,64,1624,1573,draw
1026,March 25,2011,Estonia,Uruguay,2,0,Friendly,in Estonia,26,-26,1499,1865,4,-1,90,10,1473,1891,T1
1027,March 25,2011,Netherlands,Hungary,4,0,European Championship qualifier,in Hungary,9,-9,2115,1640,0,0,2,50,2106,1649,T2
1028,March 25,2011,Turkmenistan,India,1,1,Asian Cup &amp; Asian Challenge Cup qual,in Malaysia,-10,10,1371,1193,-3,3,117,156,1381,1183,draw
1029,March 25,2011,Jamaica,Venezuela,0,2,Friendly,in Jamaica,-18,18,1639,1716,-3,4,51,37,1657,1698,T2
1030,March 25,2011,Kyrgyzstan,Cambodia,4,3,Asian Cup &amp; Asian Challenge Cup qual,in the Maldives,5,-5,1141,776,1,0,170,210,1136,781,T1
1031,March 25,2011,Lithuania,Poland,2,0,Friendly,in Lithuania,15,-15,1605,1672,4,-1,57,43,1590,1687,T1
1032,March 25,2011,France,Luxembourg,2,0,European Championship qualifier,in Luxembourg,2,-2,1819,1129,0,0,15,172,1817,1131,T2
1033,March 25,2011,Maldives,Tajikistan,0,0,Asian Cup &amp; Asian Challenge Cup qual,in the Maldives,3,-3,1141,1289,0,-2,170,137,1138,1292,draw
1034,March 25,2011,Uzbekistan,Montenegro,0,1,Friendly,in Montenegro,-4,4,1566,1725,0,0,69,35,1570,1721,T1
1035,March 25,2011,Palestine,Myanmar,3,1,Asian Cup &amp; Asian Challenge Cup qual,in Myanmar,30,-30,1188,1032,6,-3,159,182,1158,1062,T2
1036,March 25,2011,Pakistan,Taiwan,2,0,Asian Cup &amp; Asian Challenge Cup qual,in Malaysia,34,-34,911,888,5,-4,196,200,877,922,T1
1037,March 25,2011,Panama,Bolivia,2,0,Friendly,in Panama,10,-10,1599,1571,5,-3,58,67,1589,1581,T1
1038,March 25,2011,Bangladesh,Philippines,0,3,Asian Cup &amp; Asian Challenge Cup qual,in Myanmar,-37,37,936,992,-4,5,192,187,973,955,T1
1039,March 25,2011,Serbia,Northern Ireland,2,1,European Championship qualifier,in Serbia,6,-6,1766,1551,1,-1,25,73,1760,1557,T1
1040,March 25,2011,Italy,Slovenia,1,0,European Championship qualifier,in Slovenia,18,-18,1858,1683,2,-1,11,41,1840,1701,T2
1041,March 25,2011,Honduras,South Korea,0,4,Friendly,in South Korea,-10,10,1710,1806,-3,1,39,17,1720,1796,T1
1042,March 25,2011,Spain,Czechia,2,1,European Championship qualifier,in Spain,2,-2,2119,1735,0,0,1,31,2117,1737,T1
1043,March 26,2011,Belarus,Albania,0,1,European Championship qualifier,in Albania,-22,22,1637,1541,-6,6,53,76,1659,1519,T1
1044,March 26,2011,Slovakia,Andorra,1,0,European Championship qualifier,in Andorra,2,-2,1641,1010,2,0,49,185,1639,1012,T2
1045,March 26,2011,Armenia,Russia,0,0,European Championship qualifier,in Armenia,13,-13,1446,1801,3,-2,102,18,1433,1814,draw
1046,March 26,2011,Bosnia and Herzegovina,Romania,2,1,European Championship qualifier,in Bosnia and Herzegovina,20,-20,1640,1694,4,-2,50,40,1620,1714,T1
1047,March 26,2011,Bulgaria,Switzerland,0,0,European Championship qualifier,in Bulgaria,-4,4,1703,1749,1,1,39,29,1707,1745,draw
1048,March 26,2011,Burkina Faso,Namibia,4,0,African Nations Cup qualifier,in Burkina Faso,11,-11,1505,1279,3,-4,89,139,1494,1290,T1
1049,March 26,2011,Liberia,Cape Verde,2,4,African Nations Cup qualifier,in Cape Verde,-10,10,1221,1427,-1,0,149,109,1231,1417,T1
1050,March 26,2011,Chad,Botswana,0,1,African Nations Cup qualifier,in Chad,-14,14,1204,1438,-3,3,154,104,1218,1424,T2
1051,March 26,2011,Colombia,Ecuador,2,0,Friendly,in Spain,14,-14,1777,1715,5,-4,21,37,1763,1729,T1
1052,March 26,2011,Costa Rica,China,2,2,Friendly,in Costa Rica,-4,4,1666,1624,-1,-2,45,56,1670,1620,draw
1053,March 26,2011,Cyprus,Iceland,0,0,European Championship qualifier,in Cyprus,-11,11,1530,1447,-4,3,80,101,1541,1436,draw
1054,March 26,2011,Croatia,Georgia,0,1,European Championship qualifier,in Georgia,-34,34,1884,1549,-2,10,9,74,1918,1515,T1
1055,March 26,2011,Germany,Kazakhstan,4,0,European Championship qualifier,in Germany,1,-1,2061,1327,0,0,4,124,2060,1328,T1
1056,March 26,2011,Uganda,Guinea-Bissau,1,0,African Nations Cup qualifier,in Guinea-Bissau,10,-10,1571,1260,4,-3,67,142,1561,1270,T2
1057,March 26,2011,North Korea,Iraq,0,2,Friendly,in the United Arab Emirates,-11,11,1491,1603,-4,2,93,59,1502,1592,T1
1058,March 26,2011,Macedonia,Ireland,1,2,European Championship qualifier,in Ireland,-6,6,1550,1753,-1,0,73,28,1556,1747,T1
1059,March 26,2011,Israel,Latvia,2,1,European Championship qualifier,in Israel,8,-8,1677,1523,2,-4,43,83,1669,1531,T1
1060,March 26,2011,Kuwait,Jordan,1,1,Friendly,in the United Arab Emirates,0,0,1535,1527,0,-1,77,81,1535,1527,draw
1061,March 26,2011,Kenya,Angola,2,1,African Nations Cup qualifier,in Kenya,25,-25,1293,1437,5,-8,135,105,1268,1462,T1
1062,March 26,2011,Togo,Malawi,0,1,African Nations Cup qualifier,in Malawi,-12,12,1366,1435,-3,1,119,107,1378,1423,T1
1063,March 26,2011,Mali,Zimbabwe,1,0,African Nations Cup qualifier,in Mali,6,-6,1526,1324,-1,-3,82,126,1520,1330,T1
1064,March 26,2011,Greece,Malta,1,0,European Championship qualifier,in Malta,3,-3,1758,1210,0,1,27,152,1755,1213,T2
1065,March 26,2011,Paraguay,Mexico,1,3,Friendly,in the United States,-12,12,1773,1866,-1,2,23,10,1785,1854,T1
1066,March 26,2011,Denmark,Norway,1,1,European Championship qualifier,in Norway,9,-9,1736,1786,3,-1,31,20,1727,1795,draw
1067,March 26,2011,Portugal,Chile,1,1,Friendly,in Portugal,-3,3,1888,1895,1,1,8,7,1891,1892,draw
1068,March 26,2011,Rwanda,Burundi,3,1,African Nations Cup qualifier,in Rwanda,12,-12,1375,1203,2,-3,117,155,1363,1215,T1
1069,March 26,2011,Cameroon,Senegal,0,1,African Nations Cup qualifier,in Senegal,-18,18,1642,1608,-2,5,48,57,1660,1590,T1
1070,March 26,2011,Egypt,South Africa,0,1,African Nations Cup qualifier,in South Africa,-25,25,1768,1635,-4,2,25,54,1793,1610,T1
1071,March 26,2011,Central African Republic,Tanzania,1,2,African Nations Cup qualifier,in Tanzania,-9,9,1239,1378,-1,2,146,116,1248,1369,T1
1072,March 26,2011,Argentina,United States,1,1,Friendly,in the United States,-4,4,1998,1773,0,1,5,23,2002,1769,draw
1073,March 26,2011,Wales,England,0,2,European Championship qualifier,in Wales,-10,10,1535,1941,-3,0,77,6,1545,1931,T2
1074,March 27,2011,Morocco,Algeria,0,1,African Nations Cup qualifier,in Algeria,-20,20,1552,1484,-6,1,71,95,1572,1464,T1
1075,March 27,2011,Brazil,Scotland,2,0,Friendly,in England,3,-3,2083,1675,0,-1,3,43,2080,1678,T1
1076,March 27,2011,Ghana,Congo,3,0,African Nations Cup qualifier,in Congo,13,-13,1760,1370,3,-4,27,117,1747,1383,T2
1077,March 27,2011,Mauritius,Democratic Republic of Congo,0,3,African Nations Cup qualifier,in the Democratic Republic of the Congo,-4,4,1025,1415,0,0,183,110,1029,1411,T1
1078,March 27,2011,Ivory Coast,Benin,2,1,African Nations Cup qualifier,in Ghana,7,-7,1727,1433,1,-4,34,107,1720,1440,T1
1079,March 27,2011,Madagascar,Guinea,1,1,African Nations Cup qualifier,in Madagascar,9,-9,1245,1499,2,-2,145,89,1236,1508,draw
1080,March 27,2011,Mozambique,Zambia,0,2,African Nations Cup qualifier,in Mozambique,-27,27,1353,1540,-6,8,120,77,1380,1513,T2
1081,March 27,2011,Sierra Leone,Niger,1,3,African Nations Cup qualifier,in Niger,-21,21,1273,1325,-6,6,139,125,1294,1304,T1
1082,March 27,2011,Ethiopia,Nigeria,0,4,African Nations Cup qualifier,in Nigeria,-6,6,1319,1660,-3,0,128,46,1325,1654,T1
1083,March 27,2011,Sri Lanka,Tajikistan,2,2,Friendly,in Sri Lanka,6,-6,937,1283,2,0,192,137,931,1289,draw
1084,March 27,2011,Saint Kitts and Nevis,Grenada,0,0,Friendly,in Saint Kitts and Nevis,1,-1,1172,1301,0,0,164,132,1171,1302,draw
1085,March 27,2011,Sudan,Swaziland,3,0,African Nations Cup qualifier,in Sudan,11,-11,1339,1133,1,-4,122,171,1328,1144,T1
1086,March 28,2011,Bolivia,Guatemala,1,1,Friendly,in Guatemala,-1,1,1570,1438,-1,1,67,103,1571,1437,draw
1087,March 28,2011,Comoros,Libya,0,3,African Nations Cup qualifier,in Mali,-2,2,860,1508,0,0,203,87,862,1506,T1
1088,March 29,2011,Belgium,Azerbaijan,4,1,European Championship qualifier,in Belgium,10,-10,1663,1440,1,-2,46,102,1653,1450,T1
1089,March 29,2011,Belarus,Canada,0,1,Friendly,in Turkey,-11,11,1626,1607,-3,2,56,59,1637,1596,T1
1090,March 29,2011,Chile,Colombia,2,0,Friendly,in the Netherlands,10,-10,1905,1767,0,-3,7,24,1895,1777,T1
1091,March 29,2011,Honduras,China,0,3,Friendly,in China,-17,17,1693,1641,-2,6,40,50,1710,1624,T1
1092,March 29,2011,Argentina,Costa Rica,0,0,Friendly,in Costa Rica,-6,6,1992,1672,0,0,5,45,1998,1666,draw
1093,March 29,2011,Cuba,Panama,0,2,Friendly,in Cuba,-14,14,1472,1613,-1,3,95,57,1486,1599,T2
1094,March 29,2011,Cyprus,Bulgaria,0,1,Friendly,in Cyprus,-8,8,1522,1711,-3,1,84,38,1530,1703,T2
1095,March 29,2011,Liechtenstein,Czechia,0,2,European Championship qualifier,in Czechia,-1,1,1175,1736,0,0,163,32,1176,1735,T1
1096,March 29,2011,Ecuador,Peru,0,0,Friendly,in the Netherlands,-2,2,1713,1637,0,1,37,53,1715,1635,draw
1097,March 29,2011,El Salvador,Jamaica,2,3,Friendly,in El Salvador,-9,9,1488,1648,-2,4,93,48,1497,1639,T2
1098,March 29,2011,Ghana,England,1,1,Friendly,in England,7,-7,1767,1934,3,0,24,6,1760,1941,draw
1099,March 29,2011,Gambia,Equatorial Guinea,0,1,Friendly,in Equatorial Guinea,-12,12,1374,1225,-3,2,115,149,1386,1213,T1
1100,March 29,2011,Estonia,Serbia,1,1,European Championship qualifier,in Estonia,9,-9,1508,1757,2,-1,87,27,1499,1766,draw
1101,March 29,2011,Croatia,France,0,0,Friendly,in France,1,-1,1885,1818,0,0,9,15,1884,1819,draw
1102,March 29,2011,Germany,Australia,1,2,Friendly,in Germany,-18,18,2043,1813,0,3,4,16,2061,1795,T2
1103,March 29,2011,Poland,Greece,0,0,Friendly,in Greece,5,-5,1677,1753,1,0,43,28,1672,1758,draw
1104,March 29,2011,Uruguay,Ireland,3,2,Friendly,in Ireland,10,-10,1875,1743,1,-2,10,31,1865,1753,T2
1105,March 29,2011,Israel,Georgia,1,0,European Championship qualifier,in Israel,8,-8,1685,1541,1,-3,41,77,1677,1549,T1
1106,March 29,2011,Jordan,North Korea,1,1,Friendly,in the United Arab Emirates,-1,1,1526,1492,1,1,81,92,1527,1491,draw
1107,March 29,2011,Iraq,Kuwait,0,1,Friendly,in the United Arab Emirates,-12,12,1591,1547,-3,4,62,74,1603,1535,T1
1108,March 29,2011,Lithuania,Spain,1,3,European Championship qualifier,in Lithuania,-5,5,1600,2124,-2,0,60,1,1605,2119,T2
1109,March 29,2011,Mexico,Venezuela,1,1,Friendly,in the United States,-4,4,1862,1720,-2,0,12,36,1866,1716,draw
1110,March 29,2011,Hungary,Netherlands,3,5,European Championship qualifier,in the Netherlands,-2,2,1638,2117,-2,0,52,2,1640,2115,T1
1111,March 29,2011,Kenya,Nigeria,0,3,Friendly,in Nigeria,-2,2,1291,1662,0,-1,134,47,1293,1660,T1
1112,March 29,2011,Slovenia,Northern Ireland,0,0,European Championship qualifier,in Northern Ireland,-2,2,1681,1553,-1,1,42,71,1683,1551,draw
1113,March 29,2011,Tunisia,Oman,1,2,Friendly,in Oman,-8,8,1570,1543,-3,2,66,76,1578,1535,T1
1114,March 29,2011,Portugal,Finland,2,0,Friendly,in Portugal,3,-3,1891,1593,0,0,8,61,1888,1596,T1
1115,March 29,2011,Qatar,Russia,1,1,Friendly,in Qatar,4,-4,1547,1797,1,0,74,18,1543,1801,draw
1116,March 29,2011,Romania,Luxembourg,3,1,European Championship qualifier,in Romania,1,-1,1695,1128,1,0,39,172,1694,1129,T1
1117,March 29,2011,Denmark,Slovakia,2,1,Friendly,in Slovakia,10,-10,1746,1631,1,-6,30,55,1736,1641,T2
1118,March 29,2011,Sri Lanka,Tajikistan,0,2,Friendly,in Sri Lanka,-6,6,931,1289,-2,1,194,136,937,1283,T2
1119,March 29,2011,Moldova,Sweden,1,2,European Championship qualifier,in Sweden,-3,3,1463,1831,0,0,96,14,1466,1828,T1
1120,March 29,2011,Turkey,Austria,2,0,European Championship qualifier,in Turkey,9,-9,1785,1558,0,-2,22,70,1776,1567,T1
1121,March 29,2011,Italy,Ukraine,2,0,Friendly,in Ukraine,17,-17,1875,1788,2,-2,10,19,1858,1805,T2
1122,March 29,2011,United States,Paraguay,0,1,Friendly,in the United States,-13,13,1760,1786,-3,3,26,20,1773,1773,T2
1123,April 2,2011,Grenada,Saint Kitts and Nevis,0,1,Friendly,in Grenada,-16,16,1285,1188,-5,5,137,159,1301,1172,T2
1124,April 3,2011,New Caledonia,Tahiti,3,1,Friendly,in Tahiti,14,-14,1304,1164,2,-2,132,164,1290,1178,T2
1125,April 6,2011,Tahiti,New Caledonia,1,0,Friendly,in Tahiti,11,-11,1175,1293,1,-1,163,133,1164,1304,T1
1126,April 7,2011,Nepal,Afghanistan,1,0,Asian Cup &amp; Asian Challenge Cup qual,in Nepal,8,-8,972,802,0,-1,189,208,964,810,T1
1127,April 7,2011,Sri Lanka,North Korea,0,4,Asian Cup &amp; Asian Challenge Cup qual,in Nepal,-3,3,928,1495,-1,1,195,91,931,1492,T1
1128,April 9,2011,Afghanistan,Sri Lanka,1,0,Asian Cup &amp; Asian Challenge Cup qual,in Nepal,27,-27,829,901,3,-2,205,197,802,928,T1
1129,April 9,2011,North Korea,Nepal,1,0,Asian Cup &amp; Asian Challenge Cup qual,in Nepal,3,-3,1498,969,0,0,91,189,1495,972,T2
1130,April 11,2011,Nepal,Sri Lanka,0,0,Asian Cup &amp; Asian Challenge Cup qual,in Nepal,-9,9,960,910,-1,1,190,196,969,901,draw
1131,April 11,2011,Afghanistan,North Korea,0,2,Asian Cup &amp; Asian Challenge Cup qual,in Nepal,-1,1,828,1499,-1,1,206,90,829,1498,T1
1132,April 20,2011,Argentina,Ecuador,2,2,Friendly,in Argentina,-8,8,1984,1721,0,1,5,36,1992,1713,draw
1133,April 23,2011,Tanzania,Mozambique,0,2,Friendly,in Mozambique,-12,12,1366,1365,-4,1,117,119,1378,1353,T1
1134,May 4,2011,New Caledonia,Réunion,2,4,Friendly,in New Caledonia,-17,17,1276,1355,-5,3,138,120,1293,1338,T2
1135,May 7,2011,Vatican,Monaco,1,2,Friendly,in Italy,-5,5,700,895,-2,0,215,199,705,890,T1
1136,May 7,2011,New Caledonia,Réunion,1,3,Friendly,in New Caledonia,-16,16,1260,1371,-3,5,141,115,1276,1355,T2
1137,May 14,2011,Tanzania,South Africa,0,1,Friendly,in Tanzania,-5,5,1361,1640,-2,3,120,51,1366,1635,T2
1138,May 20,2011,Guyana,Barbados,1,0,Friendly,in Guyana,6,-6,1314,1251,1,-1,130,144,1308,1257,T1
1139,May 22,2011,Guyana,Barbados,3,2,Friendly,in Guyana,6,-6,1320,1245,2,0,128,144,1314,1251,T1
1140,May 24,2011,Ireland,Northern Ireland,5,0,Friendly tournament,in Ireland,10,-10,1753,1543,3,-4,28,75,1743,1553,T1
1141,May 25,2011,Paraguay,Argentina,2,4,Friendly tournament,in Argentina,-7,7,1779,1991,-2,0,22,5,1786,1984,T1
1142,May 25,2011,Scotland,Wales,3,1,Friendly tournament,in Ireland,14,-14,1689,1521,3,-4,41,84,1675,1535,T1
1143,May 25,2011,Botswana,Swaziland,0,0,Friendly,in Swaziland,-5,5,1433,1138,-3,0,106,171,1438,1133,draw
1144,May 26,2011,Cuba,Nicaragua,1,1,Friendly,in Cuba,-9,9,1463,1073,0,0,95,178,1472,1064,draw
1145,May 27,2011,Saint Vincent and the Grenadines,Barbados,0,0,Friendly,in Barbados,4,-4,1190,1241,2,-2,159,146,1186,1245,draw
1146,May 27,2011,Antigua and Barbuda,Grenada,2,2,Friendly,in Grenada,3,-3,1267,1282,1,0,139,136,1264,1285,draw
1147,May 27,2011,Wales,Northern Ireland,2,0,Friendly tournament,in Ireland,24,-24,1545,1519,9,-9,75,84,1521,1543,T1
1148,May 28,2011,Cuba,Nicaragua,2,1,Friendly,in Cuba,1,-1,1464,1072,0,0,95,178,1463,1073,T1
1149,May 28,2011,Ecuador,Mexico,1,1,Friendly,in the United States,4,-4,1725,1858,1,0,35,12,1721,1862,draw
1150,May 28,2011,Ethiopia,Sudan,1,2,Friendly,in Ethiopia,-12,12,1307,1351,-2,1,131,122,1319,1339,T2
1151,May 29,2011,Guyana,Barbados,1,1,Friendly,in Barbados,1,-1,1321,1240,0,0,128,146,1320,1241,draw
1152,May 29,2011,El Salvador,Honduras,2,2,Friendly,in the United States,5,-5,1493,1688,0,0,93,40,1488,1693,draw
1153,May 29,2011,Germany,Uruguay,2,1,Friendly,in Germany,4,-4,2047,1871,0,-1,4,11,2043,1875,T1
1154,May 29,2011,Scotland,Ireland,0,1,Friendly tournament,in Ireland,-8,8,1681,1761,-1,2,42,26,1689,1753,T1
1155,May 29,2011,Panama,Grenada,2,0,Friendly,in Panama,2,-2,1615,1280,0,0,57,136,1613,1282,T1
1156,May 29,2011,Malawi,Swaziland,1,1,Friendly,in Swaziland,-5,5,1430,1143,-3,4,108,167,1435,1138,draw
1157,May 29,2011,Central African Republic,Tunisia,0,3,Friendly,in Tunisia,-3,3,1236,1573,0,2,147,64,1239,1570,T1
1158,June 1,2011,Ecuador,Canada,2,2,Friendly,in Canada,-1,1,1724,1608,-2,1,37,58,1725,1607,draw
1159,June 1,2011,Ethiopia,Sudan,1,1,Friendly,in Ethiopia,-2,2,1305,1353,0,0,131,122,1307,1351,draw
1160,June 1,2011,Venezuela,Guatemala,2,0,Friendly,in Guatemala,8,-8,1728,1430,3,-4,34,107,1720,1438,T2
1161,June 1,2011,Japan,Peru,0,0,Friendly tournament,in Japan,-11,11,1831,1648,0,6,13,48,1842,1637,draw
1162,June 1,2011,New Zealand,Mexico,0,3,Friendly,in the United States,-6,6,1571,1864,-2,0,65,12,1577,1858,T1
1163,June 1,2011,Argentina,Nigeria,1,4,Friendly,in Nigeria,-28,28,1963,1690,0,7,5,40,1991,1662,T1
1164,June 1,2011,Ukraine,Uzbekistan,2,0,Friendly,in Ukraine,4,-4,1792,1562,0,0,19,68,1788,1566,T1
1165,June 3,2011,Austria,Germany,1,2,European Championship qualifier,in Austria,-4,4,1554,2051,1,0,69,4,1558,2047,T2
1166,June 3,2011,France,Belarus,1,1,European Championship qualifier,in Belarus,-5,5,1813,1631,0,2,15,54,1818,1626,draw
1167,June 3,2011,Turkey,Belgium,1,1,European Championship qualifier,in Belgium,-1,1,1784,1664,0,0,21,47,1785,1663,draw
1168,June 3,2011,Croatia,Georgia,2,1,European Championship qualifier,in Croatia,3,-3,1888,1538,0,-2,9,79,1885,1541,T1
1169,June 3,2011,Slovenia,Faroe Islands,2,0,European Championship qualifier,in the Faroe Islands,6,-6,1687,1186,1,-4,42,162,1681,1192,T2
1170,June 3,2011,Congo,Ghana,1,3,African Nations Cup qualifier,in Ghana,-3,3,1367,1770,0,1,117,23,1370,1767,T1
1171,June 3,2011,Malaysia,Hong Kong,1,1,Friendly,in Hong Kong,2,-2,1254,1204,0,-1,143,154,1252,1206,draw
1172,June 3,2011,Estonia,Italy,0,3,European Championship qualifier,in Italy,-4,4,1504,1879,-2,0,89,10,1508,1875,T1
1173,June 3,2011,Azerbaijan,Kazakhstan,1,2,European Championship qualifier,in Kazakhstan,-21,21,1419,1348,-7,1,109,123,1440,1327,T1
1174,June 3,2011,Liechtenstein,Lithuania,2,0,European Championship qualifier,in Liechtenstein,52,-52,1227,1548,14,-12,149,72,1175,1600,T1
1175,June 3,2011,Luxembourg,Hungary,0,1,Friendly,in Luxembourg,-2,2,1126,1640,0,2,172,52,1128,1638,T2
1176,June 3,2011,Sweden,Moldova,4,1,European Championship qualifier,in Moldova,12,-12,1843,1451,0,-3,13,99,1831,1463,T2
1177,June 3,2011,Bosnia and Herzegovina,Romania,0,3,European Championship qualifier,in Romania,-20,20,1620,1715,-4,1,56,38,1640,1695,T1
1178,June 3,2011,San Marino,Finland,0,1,European Championship qualifier,in San Marino,-1,1,900,1594,0,1,198,60,901,1593,T2
1179,June 3,2011,Serbia,South Korea,1,2,Friendly,in South Korea,-6,6,1751,1812,-1,0,29,17,1757,1806,T1
1180,June 4,2011,Bolivia,Paraguay,0,2,Friendly,in Bolivia,-10,10,1560,1789,-3,2,69,20,1570,1779,T2
1181,June 4,2011,Netherlands,Brazil,0,0,Friendly,in Brazil,2,-2,2119,2081,0,0,2,3,2117,2083,draw
1182,June 4,2011,Senegal,Cameroon,0,0,African Nations Cup qualifier,in Cameroon,7,-7,1615,1635,1,-3,57,53,1608,1642,draw
1183,June 4,2011,Peru,Czechia,0,0,Friendly tournament,in Japan,4,-4,1652,1732,0,-1,48,33,1648,1736,draw
1184,June 4,2011,England,Switzerland,2,2,European Championship qualifier,in England,-14,14,1920,1763,0,3,6,27,1934,1749,draw
1185,June 4,2011,Greece,Malta,3,1,European Championship qualifier,in Greece,1,-1,1754,1209,-1,0,29,153,1753,1210,T1
1186,June 4,2011,Denmark,Iceland,2,0,European Championship qualifier,in Iceland,14,-14,1760,1433,3,-2,28,102,1746,1447,T2
1187,June 4,2011,Israel,Latvia,2,1,European Championship qualifier,in Latvia,16,-16,1701,1507,3,-6,40,88,1685,1523,T2
1188,June 4,2011,Macedonia,Ireland,0,2,European Championship qualifier,in Macedonia,-21,21,1529,1782,-8,4,79,22,1550,1761,T2
1189,June 4,2011,Montenegro,Bulgaria,1,1,European Championship qualifier,in Montenegro,-6,6,1719,1717,-1,1,37,38,1725,1711,draw
1190,June 4,2011,Morocco,Algeria,4,0,African Nations Cup qualifier,in Morocco,21,-21,1573,1463,7,-1,63,95,1552,1484,T1
1191,June 4,2011,Namibia,Burkina Faso,1,4,African Nations Cup qualifier,in Namibia,-23,23,1256,1528,-4,8,141,80,1279,1505,T2
1192,June 4,2011,Portugal,Norway,1,0,European Championship qualifier,in Portugal,9,-9,1900,1777,0,-3,8,23,1891,1786,T1
1193,June 4,2011,Armenia,Russia,1,3,European Championship qualifier,in Russia,-4,4,1442,1801,1,0,100,18,1446,1797,T1
1194,June 4,2011,Sierra Leone,Niger,1,0,African Nations Cup qualifier,in Sierra Leone,17,-17,1290,1308,4,-5,134,130,1273,1325,T1
1195,June 4,2011,Andorra,Slovakia,0,1,European Championship qualifier,in Slovakia,-1,1,1009,1632,0,0,185,54,1010,1631,T1
1196,June 4,2011,Guinea-Bissau,Uganda,0,2,African Nations Cup qualifier,in Uganda,-5,5,1255,1576,-1,2,142,62,1260,1571,T1
1197,June 4,2011,United States,Spain,0,4,Friendly,in the United States,-7,7,1753,2131,-3,0,30,1,1760,2124,T2
1198,June 4,2011,Mozambique,Zambia,0,3,African Nations Cup qualifier,in Zambia,-12,12,1353,1552,-2,7,121,71,1365,1540,T1
1199,June 5,2011,Kenya,Angola,0,1,African Nations Cup qualifier,in Angola,-8,8,1283,1445,-3,2,136,99,1291,1437,T1
1200,June 5,2011,New Zealand,Australia,0,3,Friendly,in Australia,-4,4,1567,1817,0,0,66,15,1571,1813,T1
1201,June 5,2011,Benin,Ivory Coast,2,6,African Nations Cup qualifier,in Benin,-18,18,1415,1745,-7,3,109,32,1433,1727,T2
1202,June 5,2011,Malawi,Botswana,0,0,African Nations Cup qualifier,in Botswana,6,-6,1436,1427,4,-4,102,106,1430,1433,draw
1203,June 5,2011,Rwanda,Burundi,1,3,African Nations Cup qualifier,in Burundi,-36,36,1339,1239,-12,8,125,148,1375,1203,T1
1204,June 5,2011,China,Uzbekistan,1,0,Friendly,in China,5,-5,1646,1557,-1,-2,51,69,1641,1562,T1
1205,June 5,2011,Tanzania,Central African Republic,1,2,African Nations Cup qualifier,in Central African Republic,-21,21,1340,1257,-4,6,123,141,1361,1236,T1
1206,June 5,2011,Libya,Comoros,1,1,African Nations Cup qualifier,in the Comoros,-18,18,1490,878,-5,1,92,202,1508,860,draw
1207,June 5,2011,Costa Rica,Cuba,5,0,CONCACAF Championship,in the United States,23,-23,1695,1441,5,-7,41,101,1672,1464,T1
1208,June 5,2011,Egypt,South Africa,0,0,African Nations Cup qualifier,in Egypt,-12,12,1756,1652,-3,3,28,48,1768,1640,draw
1209,June 5,2011,Ethiopia,Nigeria,2,2,African Nations Cup qualifier,in Ethiopia,14,-14,1319,1676,3,-5,128,46,1305,1690,draw
1210,June 5,2011,Guinea,Madagascar,4,1,African Nations Cup qualifier,in Guinea,8,-8,1507,1237,4,-5,86,149,1499,1245,T1
1211,June 5,2011,Cape Verde,Liberia,0,1,African Nations Cup qualifier,in Liberia,-26,26,1401,1247,-3,6,111,145,1427,1221,T1
1212,June 5,2011,Mauritius,Democratic Republic of Congo,1,2,African Nations Cup qualifier,in Mauritius,-6,6,1019,1421,-1,3,184,107,1025,1415,T2
1213,June 5,2011,Mexico,El Salvador,5,0,CONCACAF Championship,in the United States,11,-11,1875,1482,1,0,11,93,1864,1493,T1
1214,June 5,2011,Argentina,Poland,1,2,Friendly,in Poland,-15,15,1948,1692,0,3,5,42,1963,1677,T1
1215,June 5,2011,Swaziland,Sudan,1,2,African Nations Cup qualifier,in Swaziland,-14,14,1129,1367,-4,5,171,116,1143,1353,T2
1216,June 5,2011,Chad,Tunisia,0,5,African Nations Cup qualifier,in Tunisia,-5,5,1199,1578,-2,1,156,62,1204,1573,T1
1217,June 5,2011,Mali,Zimbabwe,1,2,African Nations Cup qualifier,in Zimbabwe,-26,26,1500,1350,-8,4,89,121,1526,1324,T1
1218,June 6,2011,Honduras,Guatemala,0,0,CONCACAF Championship,in the United States,-16,16,1672,1446,-3,6,46,99,1688,1430,draw
1219,June 6,2011,Jamaica,Grenada,4,0,CONCACAF Championship,in the United States,10,-10,1658,1270,2,0,48,137,1648,1280,T1
1220,June 6,2011,France,Ukraine,4,1,Friendly,in Ukraine,21,-21,1834,1771,2,-4,14,23,1813,1792,T2
1221,June 7,2011,Australia,Serbia,0,0,Friendly,in Australia,-4,4,1813,1755,-1,1,17,30,1817,1751,draw
1222,June 7,2011,Latvia,Austria,1,3,Friendly,in Austria,-9,9,1498,1563,-2,3,88,67,1507,1554,T1
1223,June 7,2011,Germany,Azerbaijan,3,1,European Championship qualifier,in Azerbaijan,3,-3,2054,1416,0,0,4,108,2051,1419,T2
1224,June 7,2011,Belarus,Luxembourg,2,0,European Championship qualifier,in Belarus,2,-2,1633,1124,0,-1,55,173,1631,1126,T1
1225,June 7,2011,Bosnia and Herzegovina,Albania,2,0,European Championship qualifier,in Bosnia and Herzegovina,16,-16,1636,1525,2,-4,54,81,1620,1541,T1
1226,June 7,2011,Romania,Brazil,0,1,Friendly,in Brazil,-1,1,1714,2082,0,0,39,3,1715,2081,T1
1227,June 7,2011,Cameroon,Russia,0,0,Friendly,in Austria,4,-4,1639,1797,0,-1,53,19,1635,1801,draw
1228,June 7,2011,Greece,Ecuador,1,1,Friendly,in the United States,-1,1,1753,1725,-2,1,31,35,1754,1724,draw
1229,June 7,2011,Estonia,Faroe Islands,0,2,European Championship qualifier,in the Faroe Islands,-47,47,1457,1233,-8,12,96,150,1504,1186,T1
1230,June 7,2011,Gambia,Gabon,1,0,Friendly,in Gabon,17,-17,1391,1555,1,-5,112,70,1374,1572,T2
1231,June 7,2011,Italy,Ireland,0,2,Friendly,in Belgium,-19,19,1860,1801,-2,3,12,18,1879,1782,T1
1232,June 7,2011,Japan,Czechia,0,0,Friendly tournament,in Japan,-8,8,1823,1740,0,1,15,33,1831,1732,draw
1233,June 7,2011,Lithuania,Norway,0,1,Friendly,in Norway,-3,3,1545,1780,-2,0,74,22,1548,1777,T1
1234,June 7,2011,Panama,Guadeloupe,3,2,CONCACAF Championship,in the United States,18,-18,1633,1491,2,-5,55,90,1615,1509,T1
1235,June 7,2011,Bolivia,Paraguay,0,0,Friendly,in Paraguay,7,-7,1567,1782,3,-2,65,21,1560,1789,draw
1236,June 7,2011,San Marino,Hungary,0,3,European Championship qualifier,in San Marino,-2,2,898,1642,0,0,198,52,900,1640,T2
1237,June 7,2011,Maldives,Singapore,0,4,Friendly,in Singapore,-6,6,1135,1324,-1,3,170,126,1141,1318,T1
1238,June 7,2011,Ghana,South Korea,1,2,Friendly,in South Korea,-6,6,1764,1818,-2,1,26,16,1770,1812,T1
1239,June 7,2011,Sweden,Finland,5,0,European Championship qualifier,in Sweden,9,-9,1852,1585,0,-1,13,61,1843,1594,T1
1240,June 7,2011,Canada,United States,0,2,CONCACAF Championship,in the United States,-15,15,1593,1768,0,6,59,24,1608,1753,T1
1241,June 7,2011,Spain,Venezuela,3,0,Friendly,in Venezuela,5,-5,2136,1723,0,-1,1,36,2131,1728,T2
1242,June 8,2011,China,North Korea,2,0,Friendly,in China,6,-6,1652,1493,2,-2,49,89,1646,1499,T1
1243,June 8,2011,Uruguay,Netherlands,1,1,Friendly tournament,in Uruguay,6,-6,1877,2113,1,0,10,2,1871,2119,draw
1244,June 9,2011,Costa Rica,El Salvador,1,1,CONCACAF Championship,in the United States,-14,14,1681,1496,-2,4,43,88,1695,1482,draw
1245,June 9,2011,Mexico,Cuba,5,0,CONCACAF Championship,in the United States,8,-8,1883,1433,1,-1,10,103,1875,1441,T1
1246,June 9,2011,France,Poland,1,0,Friendly,in Poland,9,-9,1843,1683,0,0,14,42,1834,1692,T2
1247,June 10,2011,Honduras,Grenada,7,1,CONCACAF Championship,in the United States,10,-10,1682,1260,3,-2,43,139,1672,1270,T1
1248,June 10,2011,Guatemala,Jamaica,0,2,CONCACAF Championship,in the United States,-17,17,1429,1675,-6,1,105,47,1446,1658,T1
1249,June 11,2011,Canada,Guadeloupe,1,0,CONCACAF Championship,in the United States,18,-18,1611,1473,0,-1,59,92,1593,1491,T1
1250,June 11,2011,Paraguay,Romania,2,0,Friendly,in Paraguay,8,-8,1790,1706,1,0,20,39,1782,1714,T1
1251,June 11,2011,United States,Panama,1,2,CONCACAF Championship,in the United States,-40,40,1728,1673,-10,7,34,48,1768,1633,T2
1252,June 12,2011,El Salvador,Cuba,6,1,CONCACAF Championship,in the United States,41,-41,1537,1392,10,-9,78,111,1496,1433,T1
1253,June 12,2011,Mexico,Costa Rica,4,1,CONCACAF Championship,in the United States,21,-21,1904,1660,2,-5,8,49,1883,1681,T1
1254,June 13,2011,Guatemala,Grenada,4,0,CONCACAF Championship,in the United States,26,-26,1455,1234,7,-10,97,149,1429,1260,T1
1255,June 13,2011,Jamaica,Honduras,1,0,CONCACAF Championship,in the United States,26,-26,1701,1656,6,-6,40,49,1675,1682,T1
1256,June 14,2011,Panama,Canada,1,1,CONCACAF Championship,in the United States,-4,4,1669,1615,0,1,46,58,1673,1611,draw
1257,June 14,2011,United States,Guadeloupe,1,0,CONCACAF Championship,in the United States,6,-6,1734,1467,1,0,33,92,1728,1473,T1
1258,June 15,2011,Belize,Montserrat,5,2,World Cup qualifier,in Trinidad and Tobago,3,-3,1079,515,0,0,176,230,1076,518,T1
1259,June 18,2011,Honduras,Costa Rica,1,1,CONCACAF Championship,in the United States,0,0,1656,1660,0,0,49,48,1656,1660,draw
1260,June 18,2011,Malaysia,Myanmar,2,0,Friendly,in Malaysia,4,-4,1258,1028,3,0,140,182,1254,1032,T1
1261,June 18,2011,Mexico,Guatemala,2,1,CONCACAF Championship,in the United States,4,-4,1908,1451,1,-1,7,98,1904,1455,T1
1262,June 19,2011,US Virgin Islands,Anguilla,0,0,Friendly,in Anguilla,0,0,672,574,0,0,220,226,672,574,draw
1263,June 19,2011,Estonia,Chile,0,4,Friendly,in Chile,-2,2,1455,1907,0,0,96,8,1457,1905,T1
1264,June 19,2011,El Salvador,Panama,1,1,CONCACAF Championship,in the United States,9,-9,1546,1660,4,-1,74,47,1537,1669,draw
1265,June 19,2011,Jamaica,United States,0,2,CONCACAF Championship,in the United States,-24,24,1677,1758,-4,5,44,28,1701,1734,T1
1266,June 20,2011,Albania,Argentina,0,4,Friendly,in Argentina,-2,2,1523,1950,0,0,82,5,1525,1948,T1
1267,June 22,2011,Mexico,Honduras,2,0,CONCACAF Championship,in the United States,14,-14,1922,1642,1,-3,6,52,1908,1656,T1
1268,June 22,2011,United States,Panama,1,0,CONCACAF Championship,in the United States,12,-12,1770,1648,4,-4,24,51,1758,1660,T1
1269,June 23,2011,Paraguay,Chile,0,0,Friendly,in Paraguay,0,0,1790,1907,0,0,20,8,1790,1907,draw
1270,June 23,2011,Estonia,Uruguay,0,3,Friendly tournament,in Uruguay,-2,2,1453,1879,-1,0,97,11,1455,1877,T1
1271,June 25,2011,Kenya,Sudan,1,2,Friendly,in Kenya,-10,10,1273,1377,0,2,136,114,1283,1367,T2
1272,June 25,2011,Mexico,United States,4,2,CONCACAF Championship,in the United States,32,-32,1954,1738,1,-9,5,33,1922,1770,T2
1273,June 29,2011,Bangladesh,Pakistan,3,0,World Cup qualifier,in Bangladesh,23,-23,959,888,0,-4,192,199,936,911,T1
1274,June 29,2011,Cambodia,Laos,4,2,World Cup qualifier,in Cambodia,27,-27,803,817,1,-4,209,208,776,844,T1
1275,June 29,2011,Syria,Iraq,2,1,Friendly,in Iraq,15,-15,1532,1576,6,-2,79,62,1517,1591,T2
1276,June 29,2011,Taiwan,Malaysia,1,2,World Cup qualifier,in Malaysia,-3,3,885,1261,-1,1,201,139,888,1258,T1
1277,June 29,2011,Myanmar,Mongolia,0,1,World Cup qualifier,in Mongolia,-27,27,1001,833,-3,4,185,204,1028,806,T1
1278,June 29,2011,Nepal,East Timor,2,1,World Cup qualifier,in Nepal,2,-2,962,529,1,0,189,229,960,531,T1
1279,June 29,2011,Afghanistan,Palestine,0,2,World Cup qualifier,in Tajikistan,-7,7,821,1195,-1,3,207,158,828,1188,T1
1280,June 29,2011,Philippines,Sri Lanka,1,1,World Cup qualifier,in Sri Lanka,1,-1,993,909,0,1,187,195,992,910,draw
1281,June 29,2011,Macao,Vietnam,0,6,World Cup qualifier,in Vietnam,-2,2,679,1247,0,1,219,144,681,1245,T1
1282,July 1,2011,Bolivia,Argentina,1,1,Copa América,in Argentina,22,-22,1589,1928,5,0,60,6,1567,1950,draw
1283,July 2,2011,Costa Rica,Colombia,0,1,Copa América,in Argentina,-18,18,1642,1785,-4,3,51,21,1660,1767,T1
1284,July 2,2011,Lebanon,Kuwait,0,6,Friendly,in Lebanon,-9,9,1212,1556,0,2,154,70,1221,1547,T2
1285,July 2,2011,East Timor,Nepal,0,5,World Cup qualifier,in Nepal,-4,4,525,966,0,0,229,189,529,962,T1
1286,July 2,2011,Turks and Caicos,Bahamas,0,4,World Cup qualifier,in Turks and Caicos,-43,43,784,914,-4,8,210,195,827,871,T2
1287,July 3,2011,Venezuela,Brazil,0,0,Copa América,in Argentina,19,-19,1742,2063,4,0,32,3,1723,2082,draw
1288,July 3,2011,Paraguay,Ecuador,0,0,Copa América,in Argentina,-5,5,1785,1730,0,-1,20,36,1790,1725,draw
1289,July 3,2011,Cambodia,Laos,2,6,World Cup qualifier,in Laos,-26,26,777,843,-2,3,210,204,803,817,T1
1290,July 3,2011,Macao,Vietnam,1,7,World Cup qualifier,in Macao,-5,5,674,1252,-1,1,220,143,679,1247,T2
1291,July 3,2011,Myanmar,Mongolia,2,0,World Cup qualifier,in Myanmar,11,-11,1012,822,1,-2,184,206,1001,833,T1
1292,July 3,2011,Pakistan,Bangladesh,0,0,World Cup qualifier,in Pakistan,-2,2,886,961,-2,2,202,190,888,959,draw
1293,July 3,2011,Palestine,Afghanistan,1,1,World Cup qualifier,in Palestine,-18,18,1177,839,-5,1,163,205,1195,821,draw
1294,July 3,2011,Sri Lanka,Philippines,0,4,World Cup qualifier,in the Philippines,-19,19,890,1012,-4,3,200,184,909,993,T1
1295,July 3,2011,Malaysia,Taiwan,2,3,World Cup qualifier,in Taiwan,-33,33,1228,918,-12,7,151,195,1261,885,T1
1296,July 3,2011,US Virgin Islands,British Virgin Islands,2,0,World Cup qualifier,in the US Virgin Islands,35,-35,707,794,7,-2,213,207,672,829,T1
1297,July 4,2011,Mexico,Chile,1,2,Copa América,in Argentina,-28,28,1926,1935,-2,3,7,5,1954,1907,T1
1298,July 4,2011,Uruguay,Peru,1,1,Copa América,in Argentina,-14,14,1865,1666,0,1,11,46,1879,1652,draw
1299,July 5,2011,Syria,Jordan,3,1,Friendly,in Turkey,15,-15,1547,1511,6,-3,73,85,1532,1526,T1
1300,July 6,2011,Colombia,Argentina,0,0,Copa América,in Argentina,15,-15,1800,1913,1,-2,19,8,1785,1928,draw
1301,July 6,2011,Kuwait,Oman,1,1,Friendly,in Lebanon,0,0,1556,1543,0,0,70,78,1556,1543,draw
1302,July 6,2011,Namibia,Malawi,1,0,Friendly,in Malawi,17,-17,1273,1419,5,-4,136,106,1256,1436,T2
1303,July 7,2011,Costa Rica,Bolivia,2,0,Copa América,in Argentina,32,-32,1674,1557,5,-8,46,68,1642,1589,T1
1304,July 7,2011,Vanuatu,Solomon Islands,1,2,Friendly,in the Solomon Islands,-6,6,1223,1293,-3,2,153,133,1229,1287,T1
1305,July 8,2011,Aruba,Saint Lucia,4,2,World Cup qualifier,in Aruba,34,-34,966,1041,4,-4,189,181,932,1075,T1
1306,July 8,2011,Uruguay,Chile,1,1,Copa América,in Argentina,5,-5,1870,1930,0,0,11,5,1865,1935,draw
1307,July 8,2011,Dominican Republic,Anguilla,2,0,World Cup qualifier,in the Dominican Republic,2,-2,1050,572,1,0,179,226,1048,574,T1
1308,July 8,2011,Yemen,Jordan,0,4,Friendly,in Turkey,-9,9,1303,1520,-1,1,131,84,1312,1511,T1
1309,July 8,2011,Peru,Mexico,1,0,Copa América,in Argentina,41,-41,1707,1885,8,-4,39,10,1666,1926,T1
1310,July 9,2011,Turks and Caicos,Bahamas,0,6,World Cup qualifier,in the Bahamas,-18,18,766,932,-1,2,210,194,784,914,T1
1311,July 9,2011,Brazil,Paraguay,2,2,Copa América,in Argentina,-17,17,2046,1802,-1,3,4,18,2063,1785,draw
1312,July 9,2011,Oman,Lebanon,1,0,Friendly,in Lebanon,4,-4,1547,1208,5,-1,73,155,1543,1212,T2
1313,July 9,2011,Solomon Islands,Vanuatu,0,0,Friendly,in the Solomon Islands,-5,5,1288,1228,-2,3,135,150,1293,1223,draw
1314,July 9,2011,Ecuador,Venezuela,0,1,Copa América,in Argentina,-24,24,1706,1766,-3,7,39,25,1730,1742,T1
1315,July 10,2011,British Virgin Islands,US Virgin Islands,1,2,World Cup qualifier,in the British Virgin Islands,-30,30,764,737,-3,2,210,211,794,707,T2
1316,July 10,2011,Bolivia,Colombia,0,2,Copa América,in Argentina,-15,15,1542,1815,-10,3,78,17,1557,1800,T1
1317,July 10,2011,Dominican Republic,Anguilla,4,0,World Cup qualifier,in the Dominican Republic,3,-3,1053,569,0,0,179,226,1050,572,T1
1318,July 10,2011,India,Maldives,1,1,Friendly,in the Maldives,1,-1,1194,1134,0,0,158,170,1193,1135,draw
1319,July 11,2011,Argentina,Costa Rica,3,0,Copa América,in Argentina,11,-11,1924,1663,1,-1,6,48,1913,1674,T1
1320,July 12,2011,Chile,Peru,1,0,Copa América,in Argentina,11,-11,1941,1696,0,-3,5,41,1930,1707,T1
1321,July 12,2011,Aruba,Saint Lucia,2,4,World Cup qualifier,in Saint Lucia,-16,16,950,1057,-4,3,193,178,966,1041,T1
1322,July 12,2011,Mexico,Uruguay,0,1,Copa América,in Argentina,-26,26,1859,1896,-2,2,12,9,1885,1870,T1
1323,July 13,2011,Brazil,Ecuador,4,2,Copa América,in Argentina,9,-9,2055,1697,1,-2,3,40,2046,1706,T1
1324,July 13,2011,Fiji,Vanuatu,2,0,Friendly,in Fiji,7,-7,1330,1221,1,-3,126,153,1323,1228,T1
1325,July 13,2011,Saudi Arabia,Jordan,1,1,Friendly tournament,in Jordan,2,-2,1564,1518,1,-1,66,85,1562,1520,draw
1326,July 13,2011,Kuwait,Iraq,2,0,Friendly tournament,in Jordan,24,-24,1580,1552,8,-8,61,70,1556,1576,T1
1327,July 13,2011,Venezuela,Paraguay,3,3,Copa América,in Argentina,3,-3,1769,1799,0,-1,25,20,1766,1802,draw
1328,July 14,2011,Myanmar,Thailand,0,1,Friendly,in Thailand,-1,1,1011,1403,-1,0,185,109,1012,1402,T1
1329,July 15,2011,Fiji,Vanuatu,1,2,Friendly,in Fiji,-15,15,1315,1236,-3,5,129,148,1330,1221,T2
1330,July 15,2011,Oman,Syria,1,1,Friendly,in Lebanon,0,0,1547,1547,0,0,72,72,1547,1547,draw
1331,July 15,2011,Thailand,Myanmar,1,1,Friendly,in Thailand,-9,9,1394,1020,-1,2,110,183,1403,1011,draw
1332,July 16,2011,Argentina,Uruguay,1,1,Copa América,in Argentina,-9,9,1915,1905,-1,1,7,8,1924,1896,draw
1333,July 16,2011,Iraq,Jordan,1,1,Friendly tournament,in Jordan,3,-3,1555,1515,2,0,68,85,1552,1518,draw
1334,July 16,2011,Kuwait,Saudi Arabia,1,0,Friendly tournament,in Jordan,14,-14,1594,1550,1,-5,60,71,1580,1564,T1
1335,July 16,2011,Colombia,Peru,0,2,Copa América,in Argentina,-50,50,1765,1746,-8,9,25,32,1815,1696,T1
1336,July 17,2011,Montserrat,Belize,1,3,World Cup qualifier,in Honduras,-2,2,513,1081,0,1,230,175,515,1079,T1
1337,July 17,2011,Paraguay,Brazil,0,0,Copa América,in Argentina,16,-16,1815,2039,2,-1,17,4,1799,2055,draw
1338,July 17,2011,Madagascar,Iran,0,1,Friendly,in Iran,-1,1,1236,1735,0,0,147,36,1237,1734,T1
1339,July 17,2011,Qatar,India,1,2,Friendly,in Qatar,-19,19,1528,1213,-8,4,80,154,1547,1194,T2
1340,July 17,2011,United Arab Emirates,Lebanon,6,2,Friendly,in the United Arab Emirates,4,-4,1462,1204,0,-1,94,156,1458,1208,T1
1341,July 17,2011,Chile,Venezuela,1,2,Copa América,in Argentina,-36,36,1905,1805,-2,5,7,19,1941,1769,T1
1342,July 18,2011,Singapore,Taiwan,3,2,Friendly,in Singapore,1,-1,1325,917,0,0,126,196,1324,918,T1
1343,July 19,2011,Peru,Uruguay,0,2,Copa América,in Argentina,-21,21,1725,1926,-4,2,36,5,1746,1905,T1
1344,July 20,2011,Venezuela,Paraguay,0,0,Copa América,in Argentina,1,-1,1806,1814,0,0,19,17,1805,1815,draw
1345,July 23,2011,China,Laos,7,2,World Cup qualifier,in China,0,0,1652,843,0,0,49,204,1652,843,T1
1346,July 23,2011,Maldives,Iran,0,4,World Cup qualifier,in Iran,-1,1,1133,1736,0,-1,170,36,1134,1735,T1
1347,July 23,2011,Yemen,Iraq,0,2,World Cup qualifier,in Iraq,-7,7,1296,1562,-1,1,132,67,1303,1555,T1
1348,July 23,2011,Jordan,Nepal,9,0,World Cup qualifier,in Jordan,2,-2,1517,964,0,0,85,189,1515,966,T1
1349,July 23,2011,Kuwait,Philippines,3,0,World Cup qualifier,in Kuwait,1,-1,1595,1011,0,0,60,185,1594,1012,T1
1350,July 23,2011,Lebanon,Bangladesh,4,0,World Cup qualifier,in Lebanon,9,-9,1213,952,3,-2,153,192,1204,961,T1
1351,July 23,2011,Myanmar,Oman,0,2,World Cup qualifier,in Oman,-2,2,1018,1549,-1,-1,184,73,1020,1547,T1
1352,July 23,2011,Peru,Venezuela,4,1,Copa América,in Argentina,54,-54,1779,1752,13,-13,23,32,1725,1806,T1
1353,July 23,2011,Vietnam,Qatar,0,3,World Cup qualifier,in Qatar,-7,7,1245,1535,-1,1,144,79,1252,1528,T1
1354,July 23,2011,Hong Kong,Saudi Arabia,0,3,World Cup qualifier,in Saudi Arabia,-5,5,1199,1555,-1,2,157,69,1204,1550,T1
1355,July 23,2011,Singapore,Malaysia,5,3,World Cup qualifier,in Singapore,15,-15,1340,1213,3,-2,123,153,1325,1228,T1
1356,July 23,2011,Tajikistan,Syria,1,2,World Cup qualifier,in Jordan,-7,7,1282,1554,-1,1,135,71,1289,1547,T1
1357,July 23,2011,Palestine,Thailand,0,1,World Cup qualifier,in Thailand,-6,6,1171,1400,-1,0,164,110,1177,1394,T1
1358,July 23,2011,Indonesia,Turkmenistan,1,1,World Cup qualifier,in Turkmenistan,9,-9,1303,1362,1,-3,131,118,1294,1371,draw
1359,July 23,2011,United Arab Emirates,India,3,0,World Cup qualifier,in the United Arab Emirates,8,-8,1470,1205,2,-2,92,156,1462,1213,T1
1360,July 23,2011,Kyrgyzstan,Uzbekistan,0,4,World Cup qualifier,in Uzbekistan,-4,4,1137,1561,0,-1,169,68,1141,1557,T1
1361,July 24,2011,Liberia,Gambia,3,2,Friendly,in Liberia,11,-11,1258,1380,2,0,141,112,1247,1391,T1
1362,July 24,2011,Paraguay,Uruguay,0,3,Copa América,in Argentina,-30,30,1784,1956,-3,0,20,5,1814,1926,T1
1363,July 27,2011,Vanuatu,Solomon Islands,0,0,Friendly,in Vanuatu,-1,1,1235,1289,-1,0,148,134,1236,1288,draw
1364,July 28,2011,Bangladesh,Lebanon,2,0,World Cup qualifier,in Bangladesh,43,-43,995,1170,4,-11,188,164,952,1213,T1
1365,July 28,2011,Saudi Arabia,Hong Kong,5,0,World Cup qualifier,in Hong Kong,15,-15,1570,1184,3,-3,66,160,1555,1199,T2
1366,July 28,2011,India,United Arab Emirates,2,2,World Cup qualifier,in India,9,-9,1214,1461,2,-2,154,94,1205,1470,draw
1367,July 28,2011,Indonesia,Turkmenistan,4,3,World Cup qualifier,in Indonesia,18,-18,1321,1344,4,-4,127,122,1303,1362,T1
1368,July 28,2011,Iraq,Yemen,0,0,World Cup qualifier,in the United Arab Emirates,-13,13,1549,1309,-6,1,73,131,1562,1296,draw
1369,July 28,2011,Kyrgyzstan,Uzbekistan,0,3,World Cup qualifier,in Kyrgyzstan,-9,9,1128,1570,-2,2,171,66,1137,1561,T2
1370,July 28,2011,Laos,China,1,6,World Cup qualifier,in Laos,-1,1,842,1653,0,0,204,49,843,1652,T2
1371,July 28,2011,Malaysia,Singapore,1,1,World Cup qualifier,in Malaysia,2,-2,1215,1338,0,-3,153,126,1213,1340,draw
1372,July 28,2011,Iran,Maldives,1,0,World Cup qualifier,in the Maldives,2,-2,1738,1131,1,1,35,169,1736,1133,T2
1373,July 28,2011,Oman,Myanmar,2,0,World Cup qualifier,in Myanmar,5,-5,1554,1013,2,0,71,184,1549,1018,T2
1374,July 28,2011,Jordan,Nepal,1,1,World Cup qualifier,in Nepal,-17,17,1500,981,-1,0,86,189,1517,964,draw
1375,July 28,2011,Palestine,Thailand,2,2,World Cup qualifier,in Palestine,7,-7,1178,1393,3,0,161,110,1171,1400,draw
1376,July 28,2011,Kuwait,Philippines,2,1,World Cup qualifier,in the Philippines,2,-2,1597,1009,0,0,60,185,1595,1011,T2
1377,July 28,2011,Tajikistan,Syria,0,4,World Cup qualifier,in Tajikistan,-20,20,1262,1574,-5,7,140,64,1282,1554,T2
1378,July 28,2011,Vietnam,Qatar,2,1,World Cup qualifier,in Vietnam,30,-30,1275,1505,9,-6,135,85,1245,1535,T1
1379,July 29,2011,Mauritius,Mayotte,0,2,Friendly,in Mauritius,-15,15,1004,1141,-3,3,186,169,1019,1126,T2
1380,July 30,2011,Solomon Islands,Vanuatu,0,2,Friendly,in Vanuatu,-13,13,1276,1248,0,3,134,145,1289,1235,T1
1381,July 31,2011,Botswana,Swaziland,2,0,Friendly,in South Africa,5,-5,1432,1124,1,-1,103,172,1427,1129,T1
1382,August 4,2011,Mayotte,Madagascar,1,1,Indian Ocean Games,in the Seychelles,4,-4,1145,1232,2,-2,167,150,1141,1236,draw
1383,August 4,2011,Maldives,Mauritius,1,1,Indian Ocean Games,in the Seychelles,-5,5,1126,1009,-1,2,171,184,1131,1004,draw
1384,August 4,2011,Comoros,Seychelles,0,0,Indian Ocean Games,in the Seychelles,9,-9,887,1016,2,0,201,182,878,1025,draw
1385,August 6,2011,Maldives,Comoros,2,2,Indian Ocean Games,in the Seychelles,-9,9,1117,896,-3,2,174,199,1126,887,draw
1386,August 6,2011,Réunion,Madagascar,2,1,Indian Ocean Games,in the Seychelles,9,-9,1380,1223,3,-2,112,152,1371,1232,T1
1387,August 6,2011,Seychelles,Mauritius,2,1,Indian Ocean Games,in the Seychelles,11,-11,1027,998,0,-3,182,187,1016,1009,T1
1388,August 7,2011,Venezuela,El Salvador,1,2,Friendly,in the United States,-15,15,1737,1561,-4,4,36,70,1752,1546,T1
1389,August 8,2011,Réunion,Mayotte,0,2,Indian Ocean Games,in the Seychelles,-36,36,1344,1181,-9,6,121,161,1380,1145,T1
1390,August 9,2011,Mauritius,Comoros,2,0,Indian Ocean Games,in the Seychelles,16,-16,1014,880,4,-4,183,203,998,896,T1
1391,August 9,2011,Maldives,Seychelles,1,5,Indian Ocean Games,in the Seychelles,-27,27,1090,1054,0,2,174,180,1117,1027,T1
1392,August 10,2011,Montenegro,Albania,2,3,Friendly,in Albania,-13,13,1706,1536,-2,4,39,77,1719,1523,T1
1393,August 10,2011,Slovakia,Austria,2,1,Friendly,in Austria,11,-11,1643,1552,3,-3,54,72,1632,1563,T2
1394,August 10,2011,Azerbaijan,Macedonia,0,1,Friendly,in Azerbaijan,-10,10,1406,1539,0,4,107,75,1416,1529,T2
1395,August 10,2011,Bahrain,Oman,1,1,Friendly,in the United Arab Emirates,3,-3,1461,1551,1,-1,94,73,1458,1554,draw
1396,August 10,2011,Bulgaria,Belarus,0,1,Friendly,in Belarus,-10,10,1707,1643,0,2,38,54,1717,1633,T1
1397,August 10,2011,Panama,Bolivia,3,1,Friendly,in Bolivia,15,-15,1663,1527,3,-3,48,80,1648,1542,T2
1398,August 10,2011,Bosnia and Herzegovina,Greece,0,0,Friendly,in Bosnia and Herzegovina,0,0,1636,1753,-2,1,57,30,1636,1753,draw
1399,August 10,2011,Botswana,Kenya,1,0,Friendly,in Botswana,4,-4,1436,1269,2,-2,101,138,1432,1273,T1
1400,August 10,2011,China,Jamaica,1,0,Friendly,in China,8,-8,1661,1669,0,-1,49,46,1653,1677,T1
1401,August 10,2011,Costa Rica,Ecuador,0,2,Friendly,in Costa Rica,-18,18,1645,1715,-5,4,53,37,1663,1697,T2
1402,August 10,2011,Moldova,Cyprus,2,3,Friendly,in Cyprus,-5,5,1446,1527,-1,2,99,80,1451,1522,T1
1403,August 10,2011,Chile,France,1,1,Friendly,in France,1,-1,1906,1842,0,0,8,14,1905,1843,draw
1404,August 10,2011,Guinea,Gabon,1,1,Friendly,in France,1,-1,1508,1554,0,1,84,70,1507,1555,draw
1405,August 10,2011,Gambia,Democratic Republic of Congo,3,0,Friendly,in The Gambia,15,-15,1395,1406,2,-2,110,107,1380,1421,T1
1406,August 10,2011,Germany,Brazil,3,2,Friendly,in Germany,7,-7,2061,2032,0,0,3,4,2054,2039,T1
1407,August 10,2011,Equatorial Guinea,Guinea-Bissau,1,4,Friendly,in Portugal,-16,16,1209,1271,-4,7,155,137,1225,1255,T1
1408,August 10,2011,Honduras,Venezuela,2,0,Friendly,in the United States,19,-19,1661,1718,3,0,49,36,1642,1737,T1
1409,August 10,2011,Iceland,Hungary,0,4,Friendly,in Hungary,-5,5,1428,1647,-2,0,104,52,1433,1642,T1
1410,August 10,2011,Croatia,Ireland,0,0,Friendly,in Ireland,0,0,1888,1801,0,-1,10,19,1888,1801,draw
1411,August 10,2011,Italy,Spain,2,1,Friendly,in Italy,15,-15,1875,2121,0,0,11,1,1860,2136,T1
1412,August 10,2011,Ivory Coast,Israel,4,3,Friendly,in Switzerland,9,-9,1754,1692,3,-1,29,41,1745,1701,T1
1413,August 10,2011,South Korea,Japan,0,3,Friendly,in Japan,-12,12,1806,1835,-1,0,17,15,1818,1823,T1
1414,August 10,2011,Syria,Kazakhstan,1,1,Friendly,in Kazakhstan,-3,3,1571,1351,-1,0,65,120,1574,1348,draw
1415,August 10,2011,North Korea,Kuwait,0,0,Friendly,in Kuwait,5,-5,1498,1592,3,-2,87,62,1493,1597,draw
1416,August 10,2011,Finland,Latvia,2,0,Friendly,in Latvia,16,-16,1601,1482,2,-3,59,91,1585,1498,T2
1417,August 10,2011,Liberia,Angola,0,0,Friendly,in Liberia,2,-2,1260,1443,0,0,142,100,1258,1445,draw
1418,August 10,2011,Liechtenstein,Switzerland,1,2,Friendly,in Liechtenstein,-2,2,1225,1765,0,3,150,24,1227,1763,T2
1419,August 10,2011,Lithuania,Armenia,3,0,Friendly,in Lithuania,8,-8,1553,1434,4,-1,71,102,1545,1442,T1
1420,August 10,2011,Malta,Central African Republic,2,1,Friendly,in Malta,9,-9,1218,1248,3,-1,152,144,1209,1257,T1
1421,August 10,2011,Niger,Togo,3,3,Friendly,in Niger,-1,1,1307,1367,0,0,132,116,1308,1366,draw
1422,August 10,2011,Norway,Czechia,3,0,Friendly,in Norway,11,-11,1791,1729,2,-2,20,35,1780,1740,T1
1423,August 10,2011,Faroe Islands,Northern Ireland,0,4,European Championship qualifier,in Northern Ireland,-7,7,1226,1526,0,1,149,82,1233,1519,T1
1424,August 10,2011,Georgia,Poland,0,1,Friendly,in Poland,-4,4,1534,1687,0,0,78,43,1538,1683,T1
1425,August 10,2011,Portugal,Luxembourg,5,0,Friendly,in Portugal,0,0,1900,1124,0,0,9,171,1900,1124,T1
1426,August 10,2011,Serbia,Russia,0,1,Friendly,in Russia,-6,6,1749,1803,-2,1,32,18,1755,1797,T1
1427,August 10,2011,San Marino,Romania,0,1,Friendly,in San Marino,0,0,898,1706,0,0,198,39,898,1706,T2
1428,August 10,2011,Denmark,Scotland,1,2,Friendly,in Scotland,-9,9,1751,1690,-3,2,31,42,1760,1681,T1
1429,August 10,2011,Morocco,Senegal,2,0,Friendly,in Senegal,21,-21,1594,1594,5,-2,60,60,1573,1615,T2
1430,August 10,2011,Slovenia,Belgium,0,0,Friendly,in Slovenia,-3,3,1684,1667,-2,0,44,47,1687,1664,draw
1431,August 10,2011,Burkina Faso,South Africa,0,3,Friendly,in South Africa,-8,8,1520,1660,-3,-1,83,51,1528,1652,T1
1432,August 10,2011,Tunisia,Mali,4,2,Friendly,in Tunisia,8,-8,1586,1492,-1,-3,63,89,1578,1500,T1
1433,August 10,2011,Estonia,Turkey,0,3,Friendly,in Turkey,-3,3,1450,1787,-1,-1,98,21,1453,1784,T1
1434,August 10,2011,Ukraine,Sweden,0,1,Friendly,in Ukraine,-11,11,1760,1863,-3,1,27,12,1771,1852,T2
1435,August 10,2011,Mexico,United States,1,1,Friendly,in the United States,-1,1,1858,1739,-1,1,13,33,1859,1738,draw
1436,August 10,2011,Wales,Australia,1,2,Friendly,in Wales,-6,6,1539,1819,0,1,75,16,1545,1813,T2
1437,August 10,2011,Zambia,Zimbabwe,0,2,Friendly,in Zimbabwe,-19,19,1533,1369,-6,4,79,115,1552,1350,T1
1438,August 11,2011,Mauritius,Mayotte,0,0,Indian Ocean Games,in the Seychelles,7,-7,1021,1174,0,-3,183,164,1014,1181,draw
1439,August 11,2011,Seychelles,Réunion,2,1,Indian Ocean Games,in the Seychelles,22,-22,1076,1322,3,-5,177,126,1054,1344,T1
1440,August 13,2011,Réunion,Mayotte,1,0,Indian Ocean Games,in the Seychelles,9,-9,1331,1165,0,-1,126,165,1322,1174,T1
1441,August 13,2011,Seychelles,Mauritius,1,1,Indian Ocean Games,in the Seychelles,-6,6,1070,1027,-1,0,178,183,1076,1021,draw
1442,August 14,2011,Niger,Liberia,0,0,Friendly,in Liberia,2,-2,1309,1258,1,-1,131,143,1307,1260,draw
1443,August 17,2011,Samoa,Fiji,0,3,Friendly,in Fiji,-1,1,701,1316,0,0,214,130,702,1315,T1
1444,August 17,2011,Lebanon,Syria,2,3,Friendly,in Lebanon,-3,3,1167,1574,0,0,164,65,1170,1571,T2
1445,August 18,2011,Samoa,Fiji,1,5,Friendly,in Fiji,-1,1,700,1317,-1,0,215,130,701,1316,T1
1446,August 19,2011,Sudan,Eritrea,3,0,Friendly,in Eritrea,13,-13,1390,1165,1,-3,113,164,1377,1178,T2
1447,August 19,2011,Qatar,Iraq,0,1,Friendly,in Qatar,-12,12,1493,1561,-3,5,88,69,1505,1549,T2
1448,August 20,2011,Curaçao,Dominican Republic,0,1,Friendly,in the Dominican Republic,-9,9,1115,1062,-2,2,173,179,1124,1053,T1
1449,August 20,2011,Swaziland,Lesotho,0,0,Friendly,in Lesotho,4,-4,1128,1158,1,0,170,166,1124,1162,draw
1450,August 21,2011,Barbados,Saint Lucia,4,0,Friendly,in Barbados,6,-6,1246,1051,0,-1,146,181,1240,1057,T1
1451,August 21,2011,Curaçao,Dominican Republic,0,1,Friendly,in the Dominican Republic,-9,9,1106,1071,0,1,173,178,1115,1062,T1
1452,August 21,2011,Trinidad and Tobago,India,3,0,Friendly,in Trinidad and Tobago,4,-4,1498,1210,1,0,86,154,1494,1214,T1
1453,August 22,2011,Indonesia,Palestine,4,1,Friendly,in Indonesia,7,-7,1328,1171,0,-1,127,162,1321,1178,T1
1454,August 22,2011,Jordan,Tunisia,3,3,Friendly,in Jordan,0,0,1500,1586,0,0,85,63,1500,1586,draw
1455,August 22,2011,Lesotho,Swaziland,0,1,Friendly,in Lesotho,-14,14,1144,1142,-1,0,167,170,1158,1128,T2
1456,August 22,2011,Tuvalu,Samoa,3,0,Friendly,in Fiji,16,-16,737,684,2,-4,211,219,721,700,T1
1457,August 24,2011,Guyana,India,2,1,Friendly,in Guyana,5,-5,1326,1205,0,-1,128,155,1321,1210,T1
1458,August 24,2011,Singapore,Thailand,0,0,Friendly,in Thailand,4,-4,1342,1389,3,-2,122,113,1338,1393,draw
1459,August 25,2011,United Arab Emirates,Qatar,3,1,Friendly,in the United Arab Emirates,12,-12,1473,1481,2,-3,92,91,1461,1493,T1
1460,August 26,2011,Antigua and Barbuda,Saint Vincent and the Grenadines,1,0,Friendly,in Antigua and Barbuda,5,-5,1272,1185,2,-1,137,159,1267,1190,T1
1461,August 26,2011,Bahrain,Sudan,1,0,Friendly,in Bahrain,5,-5,1466,1385,1,-1,94,113,1461,1390,T1
1462,August 27,2011,Angola,Democratic Republic of Congo,1,2,Friendly,in Angola,-14,14,1429,1420,-3,2,103,105,1443,1406,T2
1463,August 27,2011,Tahiti,Fiji,0,3,Pacific Games,in New Caledonia,-21,21,1154,1338,-4,4,165,126,1175,1317,T1
1464,August 27,2011,Jordan,Indonesia,1,0,Friendly,in Jordan,3,-3,1503,1325,0,-2,85,129,1500,1328,T1
1465,August 27,2011,Vanuatu,New Caledonia,0,5,Pacific Games,in New Caledonia,-28,28,1220,1288,-7,8,151,134,1248,1260,T1
1466,August 27,2011,Oman,Kuwait,1,0,Friendly,in Oman,8,-8,1559,1584,3,-1,71,63,1551,1592,T1
1467,August 27,2011,Cook Islands,Papua New Guinea,0,4,Pacific Games,in New Caledonia,-10,10,716,1056,0,2,213,180,726,1046,T1
1468,August 27,2011,Guam,Solomon Islands,0,7,Pacific Games,in New Caledonia,-2,2,598,1278,0,-1,223,135,600,1276,T1
1469,August 27,2011,Tuvalu,Eastern Samoa,4,0,Pacific Games,in New Caledonia,7,-7,744,348,0,0,211,233,737,355,T1
1470,August 28,2011,Antigua and Barbuda,Saint Vincent and the Grenadines,2,2,Friendly,in Antigua and Barbuda,-5,5,1267,1190,-2,1,140,158,1272,1185,draw
1471,August 30,2011,Lesotho,Botswana,2,1,Friendly,in Botswana,18,-18,1162,1418,2,-6,165,106,1144,1436,T2
1472,August 30,2011,Kiribati,Fiji,0,9,Pacific Games,in New Caledonia,-1,1,578,1339,0,1,225,125,579,1338,T1
1473,August 30,2011,New Caledonia,Guam,9,0,Pacific Games,in New Caledonia,1,-1,1289,597,0,0,134,223,1288,598,T1
1474,August 30,2011,Eastern Samoa,Solomon Islands,0,4,Pacific Games,in New Caledonia,0,0,348,1278,0,0,233,135,348,1278,T1
1475,August 30,2011,Tahiti,Cook Islands,7,0,Pacific Games,in New Caledonia,7,-7,1161,709,-1,0,166,213,1154,716,T1
1476,August 30,2011,Vanuatu,Tuvalu,5,1,Pacific Games,in New Caledonia,5,-5,1225,739,2,0,149,211,1220,744,T1
1477,September 1,2011,Cook Islands,Kiribati,3,0,Pacific Games,in New Caledonia,22,-22,731,556,0,-3,213,228,709,578,T1
1478,September 1,2011,Guam,Eastern Samoa,2,0,Pacific Games,in New Caledonia,12,-12,609,336,0,0,223,233,597,348,T1
1479,September 1,2011,Tuvalu,New Caledonia,0,8,Pacific Games,in New Caledonia,-2,2,737,1291,0,1,211,133,739,1289,T1
1480,September 1,2011,Papua New Guinea,Tahiti,1,1,Pacific Games,in New Caledonia,6,-6,1062,1155,0,0,180,166,1056,1161,draw
1481,September 1,2011,Solomon Islands,Vanuatu,0,1,Pacific Games,in New Caledonia,-23,23,1255,1248,-8,5,143,144,1278,1225,T1
1482,September 2,2011,France,Albania,2,1,European Championship qualifier,in Albania,9,-9,1851,1527,1,-2,13,79,1842,1536,T2
1483,September 2,2011,Armenia,Andorra,3,0,European Championship qualifier,in Andorra,9,-9,1443,1000,1,-2,99,187,1434,1009,T2
1484,September 2,2011,Curaçao,Antigua and Barbuda,2,5,World Cup qualifier,in Antigua and Barbuda,-13,13,1093,1280,-2,4,175,135,1106,1267,T1
1485,September 2,2011,Venezuela,Argentina,0,1,Friendly tournament,in India,-7,7,1711,1922,-1,0,37,7,1718,1915,T1
1486,September 2,2011,Thailand,Australia,1,2,World Cup qualifier,in Australia,-2,2,1387,1821,0,0,112,16,1389,1819,T1
1487,September 2,2011,Azerbaijan,Belgium,1,1,European Championship qualifier,in Azerbaijan,9,-9,1415,1658,1,-4,107,51,1406,1667,draw
1488,September 2,2011,Qatar,Bahrain,0,0,World Cup qualifier,in Bahrain,5,-5,1486,1461,0,-1,91,95,1481,1466,draw
1489,September 2,2011,Belarus,Bosnia and Herzegovina,0,2,European Championship qualifier,in Belarus,-39,39,1604,1675,-5,13,59,44,1643,1636,T2
1490,September 2,2011,Bulgaria,England,0,3,European Championship qualifier,in Bulgaria,-24,24,1683,1944,-3,0,41,6,1707,1920,T2
1491,September 2,2011,Saint Lucia,Canada,1,4,World Cup qualifier,in Canada,-1,1,1050,1616,1,1,181,57,1051,1615,T1
1492,September 2,2011,Singapore,China,1,2,World Cup qualifier,in China,-3,3,1339,1664,-3,2,125,47,1342,1661,T1
1493,September 2,2011,Cyprus,Portugal,0,4,European Championship qualifier,in Cyprus,-13,13,1514,1913,-2,1,82,8,1527,1900,T2
1494,September 2,2011,Dominica,Nicaragua,0,2,World Cup qualifier,in Dominica,-39,39,1041,1111,-6,3,182,174,1080,1072,T2
1495,September 2,2011,Ecuador,Jamaica,5,2,Friendly,in Ecuador,11,-11,1726,1658,2,-5,35,51,1715,1669,T1
1496,September 2,2011,El Salvador,Dominican Republic,3,2,World Cup qualifier,in El Salvador,1,-1,1562,1070,-1,1,70,177,1561,1071,T1
1497,September 2,2011,Faroe Islands,Italy,0,1,European Championship qualifier,in the Faroe Islands,-2,2,1224,1877,0,0,149,11,1226,1875,T2
1498,September 2,2011,Moldova,Finland,1,4,European Championship qualifier,in Finland,-13,13,1433,1614,-1,1,100,58,1446,1601,T1
1499,September 2,2011,Georgia,Latvia,0,1,European Championship qualifier,in Georgia,-28,28,1506,1510,-8,6,86,84,1534,1482,T2
1500,September 2,2011,Austria,Germany,2,6,European Championship qualifier,in Germany,-2,2,1550,2063,1,0,73,3,1552,2061,T1
1501,September 2,2011,Swaziland,Ghana,0,2,African Nations Cup qualifier,in Ghana,-1,1,1141,1765,0,1,170,25,1142,1764,T1
1502,September 2,2011,Belize,Grenada,3,0,World Cup qualifier,in Grenada,57,-57,1138,1177,4,-11,171,159,1081,1234,T2
1503,September 2,2011,Guatemala,Saint Vincent and the Grenadines,4,0,World Cup qualifier,in Guatemala,8,-8,1459,1182,1,0,96,158,1451,1190,T1
1504,September 2,2011,Barbados,Guyana,0,2,World Cup qualifier,in Guyana,-16,16,1230,1342,-2,6,148,122,1246,1326,T1
1505,September 2,2011,Haiti,US Virgin Islands,6,0,World Cup qualifier,in Haiti,1,-1,1432,736,0,-1,101,212,1431,737,T1
1506,September 2,2011,Sweden,Hungary,1,2,European Championship qualifier,in Hungary,-26,26,1837,1673,-3,7,15,45,1863,1647,T1
1507,September 2,2011,Iran,Indonesia,3,0,World Cup qualifier,in Iran,3,-3,1741,1322,1,0,33,129,1738,1325,T1
1508,September 2,2011,Iraq,Jordan,0,2,World Cup qualifier,in Iraq,-43,43,1518,1546,-12,11,81,74,1561,1503,T2
1509,September 2,2011,Ireland,Slovakia,0,0,European Championship qualifier,in Ireland,-13,13,1788,1656,-3,1,22,53,1801,1643,draw
1510,September 2,2011,Greece,Israel,1,0,European Championship qualifier,in Israel,22,-22,1775,1670,7,-5,23,46,1753,1692,T2
1511,September 2,2011,North Korea,Japan,0,1,World Cup qualifier,in Japan,-3,3,1495,1838,-2,1,88,14,1498,1835,T1
1512,September 2,2011,Liechtenstein,Lithuania,0,0,European Championship qualifier,in Lithuania,17,-17,1242,1536,4,-2,146,75,1225,1553,draw
1513,September 2,2011,Luxembourg,Romania,0,2,European Championship qualifier,in Luxembourg,-4,4,1120,1710,-1,1,173,38,1124,1706,T2
1514,September 2,2011,Croatia,Malta,3,1,European Championship qualifier,in Malta,2,-2,1890,1216,0,1,10,151,1888,1218,T2
1515,September 2,2011,Netherlands,San Marino,11,0,European Championship qualifier,in the Netherlands,0,0,2113,898,0,0,2,198,2113,898,T1
1516,September 2,2011,Norway,Iceland,1,0,European Championship qualifier,in Norway,3,-3,1794,1425,0,0,20,103,1791,1428,T1
1517,September 2,2011,Serbia,Northern Ireland,1,0,European Championship qualifier,in Northern Ireland,13,-13,1762,1513,4,-1,28,83,1749,1526,T2
1518,September 2,2011,Saudi Arabia,Oman,0,0,World Cup qualifier,in Oman,5,-5,1575,1554,0,0,66,71,1570,1559,draw
1519,September 2,2011,Paraguay,Panama,2,0,Friendly,in Panama,14,-14,1798,1649,3,-6,19,54,1784,1663,T2
1520,September 2,2011,Bolivia,Peru,2,2,Friendly,in Peru,8,-8,1535,1771,4,-1,76,24,1527,1779,draw
1521,September 2,2011,Poland,Mexico,1,1,Friendly,in Poland,2,-2,1689,1856,3,1,40,12,1687,1858,draw
1522,September 2,2011,Russia,Macedonia,1,0,European Championship qualifier,in Russia,4,-4,1807,1535,1,-1,17,76,1803,1539,T1
1523,September 2,2011,Slovenia,Estonia,1,2,European Championship qualifier,in Slovenia,-35,35,1649,1485,-10,6,54,92,1684,1450,T2
1524,September 2,2011,Lebanon,South Korea,0,6,World Cup qualifier,in South Korea,-1,1,1166,1807,0,0,162,17,1167,1806,T1
1525,September 2,2011,Chile,Spain,2,3,Friendly,in Switzerland,-4,4,1902,2125,-1,0,9,1,1906,2121,T1
1526,September 2,2011,Puerto Rico,Saint Kitts and Nevis,0,0,World Cup qualifier,in Saint Kitts and Nevis,14,-14,1013,1174,3,-1,184,160,999,1188,draw
1527,September 2,2011,Cayman Islands,Suriname,0,1,World Cup qualifier,in Suriname,-4,4,957,1269,-1,1,192,139,961,1265,T1
1528,September 2,2011,Uzbekistan,Tajikistan,1,0,World Cup qualifier,in Tajikistan,9,-9,1579,1253,2,-2,64,143,1570,1262,T2
1529,September 2,2011,Bermuda,Trinidad and Tobago,0,1,World Cup qualifier,in Trinidad and Tobago,-3,3,1150,1501,0,-1,167,87,1153,1498,T1
1530,September 2,2011,Turkey,Kazakhstan,2,1,European Championship qualifier,in Turkey,2,-2,1789,1349,0,0,21,120,1787,1351,T1
1531,September 2,2011,Kuwait,United Arab Emirates,3,2,World Cup qualifier,in the United Arab Emirates,19,-19,1603,1454,3,-5,60,97,1584,1473,T2
1532,September 2,2011,Ukraine,Uruguay,2,3,Friendly,in Ukraine,-7,7,1753,1963,-4,0,31,5,1760,1956,T2
1533,September 2,2011,United States,Costa Rica,0,1,Friendly,in the United States,-15,15,1724,1660,-3,4,36,49,1739,1645,T2
1534,September 2,2011,Montenegro,Wales,1,2,European Championship qualifier,in Wales,-24,24,1682,1563,-3,6,42,69,1706,1539,T1
1535,September 3,2011,Burkina Faso,Equatorial Guinea,1,0,Friendly,in Burkina Faso,2,-2,1522,1207,0,0,80,153,1520,1209,T1
1536,September 3,2011,Cameroon,Mauritius,5,0,African Nations Cup qualifier,in Cameroon,1,-1,1640,1026,0,0,56,183,1639,1027,T1
1537,September 3,2011,Colombia,Honduras,2,0,Friendly,in the United States,11,-11,1776,1650,2,-5,23,53,1765,1661,T1
1538,September 3,2011,Cook Islands,Fiji,1,4,Pacific Games,in New Caledonia,-2,2,729,1341,0,3,213,122,731,1339,T1
1539,September 3,2011,Kenya,Guinea-Bissau,2,1,African Nations Cup qualifier,in Kenya,15,-15,1284,1256,3,-4,136,142,1269,1271,T1
1540,September 3,2011,Mozambique,Libya,0,1,African Nations Cup qualifier,in Egypt,-12,12,1341,1502,-3,2,122,88,1353,1490,T1
1541,September 3,2011,Tunisia,Malawi,0,0,African Nations Cup qualifier,in Malawi,-4,4,1582,1423,0,1,63,104,1586,1419,draw
1542,September 3,2011,Mali,Cape Verde,3,0,African Nations Cup qualifier,in Mali,17,-17,1509,1384,4,-3,85,112,1492,1401,T1
1543,September 3,2011,Gambia,Namibia,0,1,African Nations Cup qualifier,in Namibia,-21,21,1374,1294,-4,3,114,134,1395,1273,T1
1544,September 3,2011,New Caledonia,Eastern Samoa,8,0,Pacific Games,in New Caledonia,0,0,1291,336,-2,0,135,233,1291,336,T1
1545,September 3,2011,Papua New Guinea,Kiribati,17,1,Pacific Games,in New Caledonia,7,-7,1069,549,0,0,179,228,1062,556,T1
1546,September 3,2011,Rwanda,Ivory Coast,0,5,African Nations Cup qualifier,in Rwanda,-11,11,1328,1765,-3,4,128,26,1339,1754,T2
1547,September 3,2011,Czechia,Scotland,2,2,European Championship qualifier,in Scotland,3,-3,1732,1687,1,-1,33,40,1729,1690,draw
1548,September 3,2011,Senegal,Democratic Republic of Congo,2,0,African Nations Cup qualifier,in Senegal,10,-10,1604,1410,2,-4,59,108,1594,1420,T1
1549,September 3,2011,Egypt,Sierra Leone,1,2,African Nations Cup qualifier,in Sierra Leone,-36,36,1720,1326,-7,5,36,129,1756,1290,T1
1550,September 3,2011,Solomon Islands,Tuvalu,6,1,Pacific Games,in New Caledonia,4,-4,1259,733,2,-1,140,212,1255,737,T1
1551,September 3,2011,Algeria,Tanzania,1,1,African Nations Cup qualifier,in Tanzania,-1,1,1462,1341,0,1,94,122,1463,1340,draw
1552,September 3,2011,Vanuatu,Guam,4,1,Pacific Games,in New Caledonia,2,-2,1250,607,0,0,144,223,1248,609,T1
1553,September 4,2011,Angola,Uganda,2,0,African Nations Cup qualifier,in Angola,34,-34,1463,1542,8,-9,94,74,1429,1576,T1
1554,September 4,2011,Burundi,Benin,1,1,African Nations Cup qualifier,in Burundi,4,-4,1243,1411,2,0,145,106,1239,1415,draw
1555,September 4,2011,Morocco,Central African Republic,0,0,African Nations Cup qualifier,in Central African Republic,-12,12,1582,1260,0,5,62,140,1594,1248,draw
1556,September 4,2011,Comoros,Zambia,1,2,African Nations Cup qualifier,in the Comoros,-2,2,878,1535,0,2,203,76,880,1533,T2
1557,September 4,2011,Sudan,Congo,1,0,African Nations Cup qualifier,in Congo,25,-25,1410,1342,4,-4,107,120,1385,1367,T2
1558,September 4,2011,Guinea,Ethiopia,1,0,African Nations Cup qualifier,in Guinea,6,-6,1514,1313,4,-1,82,132,1508,1319,T1
1559,September 4,2011,Nigeria,Madagascar,2,0,African Nations Cup qualifier,in Madagascar,7,-7,1683,1216,2,0,41,150,1676,1223,T2
1560,September 4,2011,Mexico,Chile,1,0,Friendly,in Spain,11,-11,1867,1891,0,0,12,9,1856,1902,T1
1561,September 4,2011,Niger,South Africa,2,1,African Nations Cup qualifier,in Niger,32,-32,1341,1628,10,-8,122,56,1309,1660,T1
1562,September 4,2011,Botswana,Togo,0,1,African Nations Cup qualifier,in Togo,-17,17,1401,1384,-4,3,109,113,1418,1367,T1
1563,September 4,2011,Zimbabwe,Liberia,3,0,African Nations Cup qualifier,in Zimbabwe,16,-16,1385,1242,3,-5,112,146,1369,1258,T1
1564,September 5,2011,Bolivia,Peru,0,0,Friendly,in Bolivia,4,-4,1539,1767,1,0,75,25,1535,1771,draw
1565,September 5,2011,Ghana,Brazil,0,1,Friendly,in England,-4,4,1761,2036,-3,0,29,4,1765,2032,T1
1566,September 5,2011,Fiji,Papua New Guinea,2,0,Pacific Games,in New Caledonia,10,-10,1351,1059,4,0,118,179,1341,1069,T1
1567,September 5,2011,Tuvalu,Guam,1,1,Pacific Games,in New Caledonia,-7,7,726,614,-1,0,213,223,733,607,draw
1568,September 5,2011,New Caledonia,Solomon Islands,1,2,Pacific Games,in New Caledonia,-27,27,1264,1286,-5,6,140,135,1291,1259,T2
1569,September 5,2011,Tahiti,Kiribati,17,1,Pacific Games,in New Caledonia,4,-4,1159,545,0,0,166,228,1155,549,T1
1570,September 5,2011,Vanuatu,Eastern Samoa,8,0,Pacific Games,in New Caledonia,0,0,1250,336,0,0,144,233,1250,336,T1
1571,September 6,2011,Argentina,Nigeria,3,1,Friendly,in Bangladesh,6,-6,1928,1677,0,-3,7,44,1922,1683,T1
1572,September 6,2011,Turkey,Austria,0,0,European Championship qualifier,in Austria,-8,8,1781,1558,-1,1,22,71,1789,1550,draw
1573,September 6,2011,Kazakhstan,Azerbaijan,2,3,European Championship qualifier,in Azerbaijan,-11,11,1338,1426,-6,2,125,103,1349,1415,T1
1574,September 6,2011,Barbados,Trinidad and Tobago,0,2,World Cup qualifier,in Barbados,-16,16,1214,1517,-4,8,152,81,1230,1501,T2
1575,September 6,2011,United States,Belgium,0,1,Friendly,in Belgium,-9,9,1715,1667,-1,4,36,45,1724,1658,T1
1576,September 6,2011,Belize,Guatemala,1,2,World Cup qualifier,in Belize,-9,9,1129,1468,-1,2,172,95,1138,1459,T2
1577,September 6,2011,Belarus,Bosnia and Herzegovina,0,1,European Championship qualifier,in Bosnia and Herzegovina,-11,11,1593,1686,-1,2,60,42,1604,1675,T1
1578,September 6,2011,Cayman Islands,El Salvador,1,4,World Cup qualifier,in the Cayman Islands,-4,4,953,1566,0,1,192,68,957,1562,T2
1579,September 6,2011,Jamaica,Colombia,0,2,Friendly,in the United States,-10,10,1648,1786,-1,2,50,21,1658,1776,T1
1580,September 6,2011,Croatia,Israel,3,1,European Championship qualifier,in Croatia,8,-8,1898,1662,1,-1,9,47,1890,1670,T1
1581,September 6,2011,Curaçao,Haiti,2,4,World Cup qualifier,in Curaçao,-12,12,1081,1444,-1,2,176,100,1093,1432,T2
1582,September 6,2011,Czechia,Ukraine,4,0,Friendly,in Czechia,15,-15,1747,1738,2,-2,31,32,1732,1753,T1
1583,September 6,2011,Norway,Denmark,0,2,European Championship qualifier,in Denmark,-25,25,1769,1776,-5,7,25,24,1794,1751,T1
1584,September 6,2011,Suriname,Dominican Republic,1,1,World Cup qualifier,in the Dominican Republic,-6,6,1263,1076,-1,0,140,177,1269,1070,draw
1585,September 6,2011,Costa Rica,Ecuador,0,4,Friendly,in Ecuador,-10,10,1650,1736,-1,1,49,33,1660,1726,T1
1586,September 6,2011,Wales,England,0,1,European Championship qualifier,in England,-2,2,1561,1946,-1,0,69,6,1563,1944,T1
1587,September 6,2011,Northern Ireland,Estonia,1,4,European Championship qualifier,in Estonia,-28,28,1485,1513,-10,10,94,82,1513,1485,T1
1588,September 6,2011,Netherlands,Finland,2,0,European Championship qualifier,in Finland,5,-5,2118,1609,0,1,2,57,2113,1614,T2
1589,September 6,2011,Niger,Gabon,0,1,Friendly,in France,-5,5,1336,1559,-3,0,126,70,1341,1554,T1
1590,September 6,2011,Guyana,Bermuda,2,1,World Cup qualifier,in Guyana,6,-6,1348,1144,2,-1,119,168,1342,1150,T1
1591,September 6,2011,Paraguay,Honduras,3,0,Friendly,in Honduras,15,-15,1813,1635,2,-2,17,54,1798,1650,T2
1592,September 6,2011,Iceland,Cyprus,1,0,European Championship qualifier,in Iceland,19,-19,1444,1495,3,-8,100,90,1425,1514,T1
1593,September 6,2011,Bahrain,Indonesia,2,0,World Cup qualifier,in Indonesia,27,-27,1488,1295,3,-2,93,133,1461,1322,T2
1594,September 6,2011,Italy,Slovenia,1,0,European Championship qualifier,in Italy,5,-5,1882,1644,0,2,11,51,1877,1649,T1
1595,September 6,2011,China,Jordan,1,2,World Cup qualifier,in Jordan,-21,21,1643,1567,-5,7,52,66,1664,1546,T1
1596,September 6,2011,Kuwait,South Korea,1,1,World Cup qualifier,in Kuwait,6,-6,1609,1801,4,-1,57,18,1603,1807,draw
1597,September 6,2011,Greece,Latvia,1,1,European Championship qualifier,in Latvia,-9,9,1766,1519,-3,5,27,80,1775,1510,draw
1598,September 6,2011,Lebanon,United Arab Emirates,3,1,World Cup qualifier,in Lebanon,45,-45,1211,1409,9,-11,153,109,1166,1454,T1
1599,September 6,2011,Albania,Luxembourg,1,2,European Championship qualifier,in Luxembourg,-34,34,1493,1154,-13,6,92,167,1527,1120,T1
1600,September 6,2011,Andorra,Macedonia,0,1,European Championship qualifier,in Macedonia,-1,1,999,1536,0,1,187,76,1000,1535,T1
1601,September 6,2011,Georgia,Malta,1,1,European Championship qualifier,in Malta,-10,10,1496,1226,-2,2,89,148,1506,1216,draw
1602,September 6,2011,Moldova,Hungary,0,2,European Championship qualifier,in Moldova,-19,19,1414,1692,-4,4,105,41,1433,1673,T2
1603,September 6,2011,Panama,Nicaragua,2,1,World Cup qualifier,in Nicaragua,3,-3,1652,1108,5,0,48,174,1649,1111,T2
1604,September 6,2011,North Korea,Tajikistan,1,0,World Cup qualifier,in North Korea,5,-5,1500,1248,2,-1,88,144,1495,1253,T1
1605,September 6,2011,Germany,Poland,2,2,Friendly,in Poland,-7,7,2056,1696,0,0,3,39,2063,1689,draw
1606,September 6,2011,Puerto Rico,Canada,0,3,World Cup qualifier,in Puerto Rico,-4,4,1009,1620,-1,1,185,56,1013,1616,T2
1607,September 6,2011,Qatar,Iran,1,1,World Cup qualifier,in Qatar,8,-8,1494,1733,0,-2,91,34,1486,1741,draw
1608,September 6,2011,France,Romania,0,0,European Championship qualifier,in Romania,-2,2,1849,1712,0,0,13,38,1851,1710,draw
1609,September 6,2011,Ireland,Russia,0,0,European Championship qualifier,in Russia,7,-7,1795,1800,2,-2,20,19,1788,1807,draw
1610,September 6,2011,Sweden,San Marino,5,0,European Championship qualifier,in San Marino,1,-1,1838,897,0,0,15,198,1837,898,T2
1611,September 6,2011,Australia,Saudi Arabia,3,1,World Cup qualifier,in Saudi Arabia,18,-18,1839,1557,2,-7,14,72,1821,1575,T2
1612,September 6,2011,Scotland,Lithuania,1,0,European Championship qualifier,in Scotland,8,-8,1695,1528,0,-2,40,78,1687,1536,T1
1613,September 6,2011,Serbia,Faroe Islands,3,1,European Championship qualifier,in Serbia,1,-1,1763,1223,-1,0,29,149,1762,1224,T1
1614,September 6,2011,Singapore,Iraq,0,2,World Cup qualifier,in Singapore,-23,23,1316,1541,-3,7,130,74,1339,1518,T2
1615,September 6,2011,Slovakia,Armenia,0,4,European Championship qualifier,in Slovakia,-64,64,1592,1507,-10,14,61,86,1656,1443,T2
1616,September 6,2011,Liechtenstein,Spain,0,6,European Championship qualifier,in Spain,0,0,1242,2125,0,0,146,1,1242,2125,T1
1617,September 6,2011,Saint Kitts and Nevis,Saint Lucia,4,2,World Cup qualifier,in Saint Lucia,28,-28,1202,1022,4,-2,156,183,1174,1050,T2
1618,September 6,2011,Switzerland,Bulgaria,3,1,European Championship qualifier,in Switzerland,16,-16,1781,1667,4,-4,22,45,1765,1683,T1
1619,September 6,2011,Thailand,Oman,3,0,World Cup qualifier,in Thailand,42,-42,1429,1512,9,-13,102,83,1387,1554,T1
1620,September 6,2011,Antigua and Barbuda,US Virgin Islands,8,1,World Cup qualifier,in the US Virgin Islands,6,-6,1286,730,2,0,135,211,1280,736,T2
1621,September 6,2011,Japan,Uzbekistan,1,1,World Cup qualifier,in Uzbekistan,-9,9,1829,1588,-2,2,16,62,1838,1579,draw
1622,September 6,2011,Guinea,Venezuela,1,2,Friendly,in Venezuela,-3,3,1511,1714,-2,0,84,37,1514,1711,T1
1623,September 7,2011,Central African Republic,Equatorial Guinea,0,3,Friendly,in Equatorial Guinea,-15,15,1245,1222,-3,4,144,150,1260,1207,T1
1624,September 7,2011,Tahiti,New Caledonia,1,3,Pacific Games,in New Caledonia,-14,14,1145,1278,-1,1,167,138,1159,1264,T1
1625,September 7,2011,Fiji,Solomon Islands,1,2,Pacific Games,in New Caledonia,-24,24,1327,1310,-10,3,128,132,1351,1286,T1
1626,September 9,2011,Solomon Islands,New Caledonia,0,2,Pacific Games,in New Caledonia,-24,24,1286,1302,-4,6,136,132,1310,1278,T1
1627,September 9,2011,Fiji,Tahiti,1,2,Pacific Games,in New Caledonia,-30,30,1297,1175,-5,5,133,162,1327,1145,T1
1628,September 11,2011,Saint Vincent and the Grenadines,Dominica,1,0,Friendly,in Saint Vincent and the Grenadines,4,-4,1186,1037,1,0,159,181,1182,1041,T1
1629,September 14,2011,Argentina,Brazil,0,0,Friendly tournament,in Argentina,0,0,1928,2036,0,0,7,4,1928,2036,draw
1630,September 18,2011,Saint Vincent and the Grenadines,Grenada,2,1,World Cup qualifier,in Saint Vincent and the Grenadines,14,-14,1200,1163,2,-4,157,165,1186,1177,T1
1631,September 23,2011,Suriname,Curaçao,2,0,Friendly,in Suriname,5,-5,1268,1076,0,0,140,176,1263,1081,T1
1632,September 25,2011,Suriname,Curaçao,2,2,Friendly,in Suriname,-7,7,1261,1083,0,0,140,176,1268,1076,draw
1633,September 28,2011,Brazil,Argentina,2,0,Friendly tournament,in Brazil,10,-10,2046,1918,0,0,4,7,2036,1928,T1
1634,September 30,2011,Martinique,Antigua and Barbuda,0,1,Friendly,in Antigua and Barbuda,-9,9,1331,1295,-2,2,125,134,1340,1286,T1
1635,September 30,2011,Hong Kong,Philippines,3,3,Friendly tournament,in Taiwan,-7,7,1177,1016,0,1,160,184,1184,1009,draw
1636,September 30,2011,Macao,Taiwan,0,3,Friendly tournament,in Taiwan,-6,6,668,923,0,0,220,196,674,917,T1
1637,October 1,2011,Ethiopia,Sudan,1,2,Friendly,in Ethiopia,-10,10,1303,1420,-1,2,131,105,1313,1410,T2
1638,October 2,2011,Martinique,Antigua and Barbuda,2,1,Friendly,in Antigua and Barbuda,12,-12,1343,1283,5,-4,120,138,1331,1295,T2
1639,October 2,2011,Macao,Hong Kong,1,5,Friendly tournament,in Taiwan,-3,3,665,1180,0,0,220,160,668,1177,T1
1640,October 2,2011,Taiwan,Philippines,0,0,Friendly tournament,in Taiwan,0,0,923,1016,0,0,196,184,923,1016,draw
1641,October 4,2011,Malawi,Ethiopia,0,0,Friendly,in Ethiopia,-1,1,1422,1304,0,0,104,131,1423,1303,draw
1642,October 4,2011,Macao,Philippines,0,2,Friendly tournament,in Taiwan,-5,5,660,1021,0,0,220,184,665,1016,T1
1643,October 4,2011,Taiwan,Hong Kong,0,6,Friendly tournament,in Taiwan,-18,18,905,1198,-1,1,197,159,923,1180,T2
1644,October 5,2011,Iran,Palestine,7,0,Friendly,in Iran,1,-1,1734,1170,0,0,34,162,1733,1171,T1
1645,October 6,2011,China,United Arab Emirates,2,1,Friendly,in China,3,-3,1646,1406,1,0,51,109,1643,1409,T1
1646,October 6,2011,Jordan,Thailand,0,0,Friendly,in Thailand,-1,1,1566,1430,-1,0,67,102,1567,1429,draw
1647,October 7,2011,Andorra,Ireland,0,2,European Championship qualifier,in Andorra,-1,1,998,1796,0,1,187,19,999,1795,T2
1648,October 7,2011,Chile,Argentina,1,4,World Cup qualifier,in Argentina,-23,23,1868,1941,0,1,10,6,1891,1918,T1
1649,October 7,2011,Armenia,Macedonia,4,1,European Championship qualifier,in Armenia,28,-28,1535,1508,9,-9,77,85,1507,1536,T1
1650,October 7,2011,Australia,Malaysia,5,0,Friendly,in Australia,1,-1,1840,1214,-1,0,15,152,1839,1215,T1
1651,October 7,2011,Austria,Azerbaijan,4,1,European Championship qualifier,in Azerbaijan,32,-32,1590,1394,9,-7,62,110,1558,1426,T2
1652,October 7,2011,Barbados,Guyana,0,2,World Cup qualifier,in Barbados,-27,27,1187,1375,-7,2,160,116,1214,1348,T2
1653,October 7,2011,Kazakhstan,Belgium,1,4,European Championship qualifier,in Belgium,-5,5,1333,1672,-1,0,125,45,1338,1667,T1
1654,October 7,2011,Grenada,Belize,4,1,World Cup qualifier,in Belize,42,-42,1205,1087,11,-3,154,175,1163,1129,T2
1655,October 7,2011,Bermuda,Trinidad and Tobago,2,1,World Cup qualifier,in Bermuda,33,-33,1177,1484,6,-12,162,93,1144,1517,T1
1656,October 7,2011,Bosnia and Herzegovina,Luxembourg,5,0,European Championship qualifier,in Bosnia and Herzegovina,2,-2,1688,1152,-1,-1,43,168,1686,1154,T1
1657,October 7,2011,Suriname,Cayman Islands,1,0,World Cup qualifier,in the Cayman Islands,9,-9,1270,944,0,-1,140,193,1261,953,T2
1658,October 7,2011,Brazil,Costa Rica,1,0,Friendly,in Costa Rica,3,-3,2049,1647,0,-2,4,51,2046,1650,T2
1659,October 7,2011,Curaçao,Antigua and Barbuda,0,1,World Cup qualifier,in Curaçao,-14,14,1069,1297,-2,4,178,134,1083,1283,T2
1660,October 7,2011,Cyprus,Denmark,1,4,European Championship qualifier,in Cyprus,-18,18,1477,1794,-4,3,94,21,1495,1776,T2
1661,October 7,2011,Czechia,Spain,0,2,European Championship qualifier,in Czechia,-10,10,1737,2135,-2,0,33,1,1747,2125,T2
1662,October 7,2011,Panama,Dominica,5,0,World Cup qualifier,in Dominica,4,-4,1656,1033,0,0,48,181,1652,1037,T2
1663,October 7,2011,El Salvador,Dominican Republic,2,1,World Cup qualifier,in the Dominican Republic,4,-4,1570,1072,-1,1,68,176,1566,1076,T2
1664,October 7,2011,Cameroon,Democratic Republic of Congo,3,2,African Nations Cup qualifier,in the Democratic Republic of the Congo,13,-13,1653,1397,4,-1,49,109,1640,1410,T2
1665,October 7,2011,Ecuador,Venezuela,2,0,World Cup qualifier,in Ecuador,20,-20,1756,1694,3,-3,30,40,1736,1714,T1
1666,October 7,2011,Sweden,Finland,2,1,European Championship qualifier,in Finland,13,-13,1851,1596,1,-4,14,61,1838,1609,T2
1667,October 7,2011,France,Albania,3,0,European Championship qualifier,in France,5,-5,1854,1488,0,2,13,90,1849,1493,T1
1668,October 7,2011,Gabon,Equatorial Guinea,2,0,Friendly,in France,4,-4,1563,1218,-1,0,71,150,1559,1222,T1
1669,October 7,2011,Croatia,Greece,0,2,European Championship qualifier,in Greece,-33,33,1865,1799,-3,9,12,18,1898,1766,T1
1670,October 7,2011,Saudi Arabia,Indonesia,0,0,Friendly,in Malaysia,-6,6,1551,1301,0,1,72,133,1557,1295,draw
1671,October 7,2011,Vietnam,Japan,0,1,Friendly,in Japan,0,0,1275,1829,0,0,139,16,1275,1829,T1
1672,October 7,2011,Malta,Latvia,0,2,European Championship qualifier,in Latvia,-6,6,1220,1525,-1,0,149,80,1226,1519,T1
1673,October 7,2011,Montenegro,England,2,2,European Championship qualifier,in Montenegro,9,-9,1691,1937,1,-1,42,7,1682,1946,draw
1674,October 7,2011,Moldova,Netherlands,0,1,European Championship qualifier,in the Netherlands,0,0,1414,2118,1,0,105,2,1414,2118,T1
1675,October 7,2011,Northern Ireland,Estonia,1,2,European Championship qualifier,in Northern Ireland,-24,24,1461,1537,-4,7,98,75,1485,1513,T2
1676,October 7,2011,Peru,Paraguay,2,0,World Cup qualifier,in Peru,25,-25,1792,1788,4,-6,22,23,1767,1813,T1
1677,October 7,2011,Iceland,Portugal,3,5,European Championship qualifier,in Portugal,-2,2,1442,1915,-1,0,101,8,1444,1913,T1
1678,October 7,2011,Saint Kitts and Nevis,Puerto Rico,1,1,World Cup qualifier,in Puerto Rico,-5,5,1197,1014,-2,1,158,185,1202,1009,draw
1679,October 7,2011,Romania,Belarus,2,2,European Championship qualifier,in Romania,-11,11,1701,1604,1,2,37,58,1712,1593,draw
1680,October 7,2011,Italy,Serbia,1,1,European Championship qualifier,in Serbia,-1,1,1881,1764,2,1,9,28,1882,1763,draw
1681,October 7,2011,Singapore,Philippines,2,0,Friendly,in Singapore,3,-3,1319,1018,0,1,129,183,1316,1021,T1
1682,October 7,2011,Russia,Slovakia,1,0,European Championship qualifier,in Slovakia,14,-14,1814,1578,2,-5,17,66,1800,1592,T2
1683,October 7,2011,Poland,South Korea,2,2,Friendly,in South Korea,5,-5,1701,1796,2,-1,37,19,1696,1801,draw
1684,October 7,2011,Saint Lucia,Canada,0,7,World Cup qualifier,in Saint Lucia,-5,5,1017,1625,-1,0,184,56,1022,1620,T2
1685,October 7,2011,Guatemala,Saint Vincent and the Grenadines,3,0,World Cup qualifier,in Saint Vincent and the Grenadines,19,-19,1487,1181,3,-4,92,161,1468,1200,T2
1686,October 7,2011,Turkey,Germany,1,3,European Championship qualifier,in Turkey,-16,16,1765,2072,-4,0,26,3,1781,2056,T2
1687,October 7,2011,Ukraine,Bulgaria,3,0,Friendly,in Ukraine,10,-10,1748,1657,1,-2,31,47,1738,1667,T1
1688,October 7,2011,Bolivia,Uruguay,2,4,World Cup qualifier,in Uruguay,-3,3,1536,1966,-1,0,76,5,1539,1963,T1
1689,October 7,2011,Haiti,US Virgin Islands,7,0,World Cup qualifier,in the US Virgin Islands,3,-3,1447,727,0,-1,100,212,1444,730,T2
1690,October 7,2011,Switzerland,Wales,0,2,European Championship qualifier,in Wales,-40,40,1741,1601,-10,9,32,60,1781,1561,T1
1691,October 8,2011,Cape Verde,Zimbabwe,2,1,African Nations Cup qualifier,in Cape Verde,14,-14,1398,1371,4,-5,109,117,1384,1385,T1
1692,October 8,2011,Malawi,Chad,2,2,African Nations Cup qualifier,in Chad,-7,7,1415,1206,0,3,103,153,1422,1199,draw
1693,October 8,2011,Egypt,Niger,3,0,African Nations Cup qualifier,in Egypt,4,-4,1724,1332,0,-2,35,126,1720,1336,T1
1694,October 8,2011,Ethiopia,Madagascar,4,2,African Nations Cup qualifier,in Ethiopia,15,-15,1319,1201,2,-5,129,156,1304,1216,T1
1695,October 8,2011,Burkina Faso,Gambia,1,1,African Nations Cup qualifier,in The Gambia,-3,3,1519,1377,-1,3,82,114,1522,1374,draw
1696,October 8,2011,Guinea-Bissau,Angola,0,2,African Nations Cup qualifier,in Guinea-Bissau,-21,21,1235,1484,-6,3,147,93,1256,1463,T2
1697,October 8,2011,Mali,Liberia,2,2,African Nations Cup qualifier,in Liberia,-9,9,1500,1251,-2,5,86,141,1509,1242,draw
1698,October 8,2011,Scotland,Liechtenstein,1,0,European Championship qualifier,in Liechtenstein,5,-5,1700,1237,0,0,39,146,1695,1242,T2
1699,October 8,2011,Mozambique,Comoros,3,0,African Nations Cup qualifier,in Mozambique,3,-3,1344,875,2,0,120,203,1341,878,T1
1700,October 8,2011,Guinea,Nigeria,2,2,African Nations Cup qualifier,in Nigeria,13,-13,1524,1664,2,-1,81,45,1511,1677,draw
1701,October 8,2011,South Africa,Sierra Leone,0,0,African Nations Cup qualifier,in South Africa,-16,16,1612,1342,-1,5,56,123,1628,1326,draw
1702,October 8,2011,Ghana,Sudan,2,0,African Nations Cup qualifier,in Sudan,12,-12,1773,1408,4,-2,25,106,1761,1420,T2
1703,October 8,2011,Swaziland,Congo,0,1,African Nations Cup qualifier,in Swaziland,-14,14,1127,1356,-1,3,172,118,1141,1342,T2
1704,October 8,2011,Tunisia,Togo,2,0,African Nations Cup qualifier,in Tunisia,9,-9,1591,1375,2,-2,62,115,1582,1384,T1
1705,October 8,2011,Uganda,Kenya,0,0,African Nations Cup qualifier,in Uganda,-15,15,1527,1299,-6,4,79,134,1542,1284,draw
1706,October 8,2011,Honduras,United States,0,1,Friendly,in the United States,-5,5,1630,1720,0,0,54,36,1635,1715,T1
1707,October 8,2011,Zambia,Libya,0,0,African Nations Cup qualifier,in Zambia,-7,7,1528,1509,0,2,77,84,1535,1502,draw
1708,October 9,2011,Central African Republic,Algeria,0,2,African Nations Cup qualifier,in Algeria,-8,8,1237,1470,-1,1,145,96,1245,1462,T1
1709,October 9,2011,Benin,Rwanda,0,1,African Nations Cup qualifier,in Benin,-30,30,1381,1358,-7,10,112,118,1411,1328,T2
1710,October 9,2011,Ivory Coast,Burundi,2,1,African Nations Cup qualifier,in Ivory Coast,1,-1,1766,1242,0,1,27,144,1765,1243,T1
1711,October 9,2011,Senegal,Mauritius,2,0,African Nations Cup qualifier,in Mauritius,4,-4,1608,1022,0,0,58,182,1604,1026,T2
1712,October 9,2011,Morocco,Tanzania,3,1,African Nations Cup qualifier,in Morocco,7,-7,1589,1334,1,-1,64,125,1582,1341,T1
1713,October 11,2011,Romania,Albania,1,1,European Championship qualifier,in Albania,-6,6,1695,1494,-4,2,41,88,1701,1488,draw
1714,October 11,2011,US Virgin Islands,Antigua and Barbuda,0,10,World Cup qualifier,in Antigua and Barbuda,-2,2,725,1299,-1,3,213,132,727,1297,T1
1715,October 11,2011,Oman,Australia,0,3,World Cup qualifier,in Australia,-5,5,1507,1845,-1,1,84,14,1512,1840,T1
1716,October 11,2011,Guyana,Bermuda,1,1,World Cup qualifier,in Bermuda,-5,5,1370,1182,-2,2,117,160,1375,1177,draw
1717,October 11,2011,Colombia,Bolivia,2,1,World Cup qualifier,in Bolivia,12,-12,1798,1524,3,-3,21,78,1786,1536,T2
1718,October 11,2011,Bulgaria,Wales,0,1,European Championship qualifier,in Bulgaria,-28,28,1629,1629,-6,7,53,53,1657,1601,T2
1719,October 11,2011,Puerto Rico,Canada,0,0,World Cup qualifier,in Canada,19,-19,1033,1606,4,-4,181,59,1014,1625,draw
1720,October 11,2011,Chile,Peru,4,2,World Cup qualifier,in Chile,16,-16,1884,1776,1,-2,9,24,1868,1792,T1
1721,October 11,2011,Iraq,China,1,0,World Cup qualifier,in China,31,-31,1572,1615,4,-3,69,55,1541,1646,T2
1722,October 11,2011,Croatia,Latvia,2,0,European Championship qualifier,in Croatia,4,-4,1869,1521,0,0,12,80,1865,1525,T1
1723,October 11,2011,Portugal,Denmark,1,2,European Championship qualifier,in Denmark,-21,21,1894,1815,0,4,8,17,1915,1794,T1
1724,October 11,2011,El Salvador,Cayman Islands,4,0,World Cup qualifier,in El Salvador,1,-1,1571,943,-2,0,70,193,1570,944,T1
1725,October 11,2011,Equatorial Guinea,Cameroon,1,1,Friendly,in Equatorial Guinea,7,-7,1225,1646,3,-1,147,50,1218,1653,draw
1726,October 11,2011,Estonia,Ukraine,0,2,Friendly,in Estonia,-10,10,1527,1758,-2,-1,76,32,1537,1748,T2
1727,October 11,2011,France,Bosnia and Herzegovina,1,1,European Championship qualifier,in France,-13,13,1841,1701,-2,4,15,39,1854,1688,draw
1728,October 11,2011,Greece,Georgia,2,1,European Championship qualifier,in Georgia,9,-9,1808,1487,-1,-3,19,91,1799,1496,T2
1729,October 11,2011,Belgium,Germany,1,3,European Championship qualifier,in Germany,-3,3,1669,2075,0,0,44,3,1672,2072,T1
1730,October 11,2011,Ghana,Nigeria,0,0,Friendly,in England,-3,3,1770,1667,-1,-1,26,46,1773,1664,draw
1731,October 11,2011,Belize,Guatemala,1,3,World Cup qualifier,in Guatemala,-3,3,1084,1490,-2,2,177,90,1087,1487,T1
1732,October 11,2011,Haiti,Curaçao,2,2,World Cup qualifier,in Haiti,-18,18,1429,1087,-2,2,102,176,1447,1069,draw
1733,October 11,2011,Honduras,Jamaica,2,1,Friendly,in Honduras,8,-8,1638,1640,2,-1,52,51,1630,1648,T1
1734,October 11,2011,Finland,Hungary,0,0,European Championship qualifier,in Hungary,10,-10,1606,1682,2,-1,59,42,1596,1692,draw
1735,October 11,2011,Indonesia,Qatar,2,3,World Cup qualifier,in Indonesia,-15,15,1286,1509,-4,7,137,82,1301,1494,T2
1736,October 11,2011,Iran,Bahrain,6,0,World Cup qualifier,in Iran,10,-10,1744,1478,1,-4,33,94,1734,1488,T1
1737,October 11,2011,Ireland,Armenia,2,1,European Championship qualifier,in Ireland,4,-4,1800,1531,-1,2,20,74,1796,1535,T1
1738,October 11,2011,Italy,Northern Ireland,3,0,European Championship qualifier,in Italy,3,-3,1884,1458,0,0,9,98,1881,1461,T1
1739,October 11,2011,Tajikistan,Japan,0,8,World Cup qualifier,in Japan,-2,2,1246,1831,1,0,142,16,1248,1829,T1
1740,October 11,2011,Austria,Kazakhstan,0,0,European Championship qualifier,in Kazakhstan,-8,8,1582,1341,-3,1,66,125,1590,1333,draw
1741,October 11,2011,Lebanon,Kuwait,2,2,World Cup qualifier,in Lebanon,14,-14,1225,1595,5,-4,147,61,1211,1609,draw
1742,October 11,2011,Czechia,Lithuania,4,1,European Championship qualifier,in Lithuania,24,-24,1761,1504,3,-9,30,86,1737,1528,T2
1743,October 11,2011,Slovakia,Macedonia,1,1,European Championship qualifier,in Macedonia,2,-2,1580,1506,-1,0,67,85,1578,1508,draw
1744,October 11,2011,Israel,Malta,2,0,European Championship qualifier,in Malta,7,-7,1669,1213,2,-3,44,152,1662,1220,T2
1745,October 11,2011,Mexico,Brazil,1,2,Friendly,in Mexico,-8,8,1859,2057,-2,0,13,4,1867,2049,T2
1746,October 11,2011,San Marino,Moldova,0,4,European Championship qualifier,in Moldova,-2,2,895,1416,0,1,198,103,897,1414,T1
1747,October 11,2011,North Korea,Uzbekistan,0,1,World Cup qualifier,in North Korea,-21,21,1479,1609,-7,8,93,57,1500,1588,T2
1748,October 11,2011,Cyprus,Norway,1,3,European Championship qualifier,in Norway,-6,6,1471,1775,0,1,95,25,1477,1769,T1
1749,October 11,2011,Nicaragua,Panama,1,5,World Cup qualifier,in Panama,-2,2,1106,1658,-1,0,174,48,1108,1656,T1
1750,October 11,2011,Paraguay,Uruguay,1,1,World Cup qualifier,in Paraguay,4,-4,1792,1962,0,0,23,5,1788,1966,draw
1751,October 11,2011,Nepal,Philippines,0,4,Friendly,in the Philippines,-12,12,969,1030,-1,0,190,183,981,1018,T1
1752,October 11,2011,Poland,Belarus,2,0,Friendly,in Germany,11,-11,1712,1593,0,-3,37,62,1701,1604,T1
1753,October 11,2011,Andorra,Russia,0,6,European Championship qualifier,in Russia,0,0,998,1814,0,-1,187,18,998,1814,T1
1754,October 11,2011,Jordan,Singapore,3,0,World Cup qualifier,in Singapore,21,-21,1587,1298,5,-5,65,134,1566,1319,T2
1755,October 11,2011,Serbia,Slovenia,0,1,European Championship qualifier,in Slovenia,-21,21,1743,1665,-5,6,34,47,1764,1644,T1
1756,October 11,2011,South Korea,United Arab Emirates,2,1,World Cup qualifier,in South Korea,2,-2,1798,1404,-2,0,21,106,1796,1406,T1
1757,October 11,2011,Spain,Scotland,3,1,European Championship qualifier,in Spain,3,-3,2138,1697,0,-1,1,40,2135,1700,T1
1758,October 11,2011,Saint Kitts and Nevis,Saint Lucia,1,1,World Cup qualifier,in Saint Kitts and Nevis,-13,13,1184,1030,-1,1,159,183,1197,1017,draw
1759,October 11,2011,Suriname,Dominican Republic,1,3,World Cup qualifier,in Suriname,-51,51,1219,1123,-10,3,150,173,1270,1072,T2
1760,October 11,2011,Sweden,Netherlands,3,2,European Championship qualifier,in Sweden,29,-29,1880,2089,3,0,11,2,1851,2118,T1
1761,October 11,2011,Switzerland,Montenegro,2,0,European Championship qualifier,in Switzerland,18,-18,1759,1673,1,-1,31,43,1741,1691,T1
1762,October 11,2011,Saudi Arabia,Thailand,0,0,World Cup qualifier,in Thailand,-1,1,1550,1431,-1,1,73,101,1551,1430,draw
1763,October 11,2011,Barbados,Trinidad and Tobago,0,4,World Cup qualifier,in Trinidad and Tobago,-7,7,1180,1491,-2,4,162,89,1187,1484,T1
1764,October 11,2011,Turkey,Azerbaijan,1,0,European Championship qualifier,in Turkey,2,-2,1767,1392,0,0,28,110,1765,1394,T1
1765,October 11,2011,United States,Ecuador,0,1,Friendly,in the United States,-12,12,1708,1768,-2,3,38,27,1720,1756,T2
1766,October 11,2011,Venezuela,Argentina,1,0,World Cup qualifier,in Venezuela,28,-28,1722,1913,4,-1,36,7,1694,1941,T1
1767,October 15,2011,Saint Vincent and the Grenadines,Grenada,1,1,World Cup qualifier,in Grenada,7,-7,1188,1198,2,-2,159,156,1181,1205,draw
1768,October 31,2011,Lesotho,Namibia,0,0,Friendly,in Namibia,6,-6,1168,1288,2,0,165,136,1162,1294,draw
1769,November 1,2011,Djibouti,Somalia,1,0,Friendly,in Djibouti,10,-10,803,898,0,-1,207,197,793,908,T1
1770,November 4,2011,Kuwait,Bahrain,0,1,Friendly,in Kuwait,-16,16,1579,1494,-6,6,67,88,1595,1478,T2
1771,November 4,2011,Oman,Qatar,0,0,Friendly,in Qatar,3,-3,1510,1506,2,-2,82,84,1507,1509,draw
1772,November 5,2011,Antigua and Barbuda,Guadeloupe,0,0,Friendly,in Antigua and Barbuda,2,-2,1301,1465,0,0,132,97,1299,1467,draw
1773,November 6,2011,Lesotho,Democratic Republic of Congo,0,3,Friendly,in South Africa,-7,7,1161,1404,-2,3,167,106,1168,1397,T1
1774,November 6,2011,Lebanon,Iraq,0,1,Friendly,in Qatar,-2,2,1223,1574,-1,1,148,68,1225,1572,T1
1775,November 8,2011,Lebanon,Thailand,3,1,Friendly,in Qatar,23,-23,1246,1408,6,-3,142,104,1223,1431,T1
1776,November 10,2011,Gabon,Brazil,0,2,Friendly,in Gabon,-3,3,1560,2060,0,0,72,4,1563,2057,T2
1777,November 11,2011,Azerbaijan,Albania,1,0,Friendly,in Albania,15,-15,1407,1479,6,-4,104,92,1392,1494,T2
1778,November 11,2011,Haiti,Antigua and Barbuda,0,1,World Cup qualifier,in Antigua and Barbuda,-22,22,1407,1323,-3,3,104,129,1429,1301,T1
1779,November 11,2011,Argentina,Bolivia,1,1,World Cup qualifier,in Argentina,-18,18,1895,1542,-2,4,9,74,1913,1524,draw
1780,November 11,2011,Bahrain,Iran,1,1,World Cup qualifier,in Bahrain,8,-8,1502,1736,1,1,87,32,1494,1744,draw
1781,November 11,2011,Belgium,Romania,2,1,Friendly,in Belgium,8,-8,1677,1687,1,0,43,41,1669,1695,T1
1782,November 11,2011,Belize,Saint Vincent and the Grenadines,1,1,World Cup qualifier,in Belize,0,0,1084,1188,0,0,177,159,1084,1188,draw
1783,November 11,2011,Bermuda,Barbados,2,1,World Cup qualifier,in Bermuda,14,-14,1196,1166,5,-4,156,166,1182,1180,T1
1784,November 11,2011,Portugal,Bosnia and Herzegovina,0,0,European Championship qualifier,in Bosnia and Herzegovina,-5,5,1889,1706,-2,2,10,37,1894,1701,draw
1785,November 11,2011,Burkina Faso,Mali,1,1,Friendly,in France,-1,1,1518,1501,1,-1,80,88,1519,1500,draw
1786,November 11,2011,Cameroon,Sudan,3,1,Friendly tournament,in Morocco,9,-9,1655,1399,1,-3,49,107,1646,1408,T1
1787,November 11,2011,Chad,Tanzania,1,2,World Cup qualifier,in Chad,-18,18,1188,1352,-6,5,159,121,1206,1334,T2
1788,November 11,2011,Colombia,Venezuela,1,1,World Cup qualifier,in Colombia,-9,9,1789,1731,-2,1,23,35,1798,1722,draw
1789,November 11,2011,Mozambique,Comoros,1,0,World Cup qualifier,in the Comoros,4,-4,1348,871,-1,0,122,203,1344,875,T2
1790,November 11,2011,Scotland,Cyprus,2,1,Friendly,in Cyprus,7,-7,1704,1464,2,-2,38,97,1697,1471,T2
1791,November 11,2011,Czechia,Montenegro,2,0,European Championship qualifier,in Czechia,15,-15,1776,1658,6,-5,24,48,1761,1673,T1
1792,November 11,2011,Denmark,Sweden,2,0,Friendly,in Denmark,13,-13,1828,1867,1,0,16,11,1815,1880,T1
1793,November 11,2011,Namibia,Djibouti,4,0,World Cup qualifier,in Djibouti,7,-7,1295,796,1,0,135,207,1288,803,T2
1794,November 11,2011,Cayman Islands,Dominican Republic,0,4,World Cup qualifier,in the Dominican Republic,-12,12,931,1135,-1,2,194,171,943,1123,T1
1795,November 11,2011,Equatorial Guinea,Madagascar,2,0,World Cup qualifier,in Equatorial Guinea,20,-20,1245,1181,5,-6,143,161,1225,1201,T1
1796,November 11,2011,Eritrea,Rwanda,1,1,World Cup qualifier,in Eritrea,5,-5,1170,1353,1,-2,164,120,1165,1358,draw
1797,November 11,2011,Ireland,Estonia,4,0,European Championship qualifier,in Estonia,20,-20,1820,1507,3,-8,17,84,1800,1527,T2
1798,November 11,2011,France,United States,1,0,Friendly,in France,4,-4,1845,1704,1,0,14,38,1841,1708,T1
1799,November 11,2011,Moldova,Georgia,0,2,Friendly,in Georgia,-8,8,1408,1495,-1,2,103,90,1416,1487,T1
1800,November 11,2011,Russia,Greece,1,1,Friendly,in Greece,3,-3,1817,1805,0,-2,18,21,1814,1808,draw
1801,November 11,2011,Grenada,Guatemala,0,3,World Cup qualifier,in Guatemala,-7,7,1191,1497,-2,2,158,89,1198,1490,T1
1802,November 11,2011,Togo,Guinea-Bissau,1,1,World Cup qualifier,in Guinea-Bissau,-2,2,1373,1237,-2,2,117,145,1375,1235,draw
1803,November 11,2011,Guyana,Trinidad and Tobago,2,1,World Cup qualifier,in Guyana,21,-21,1391,1470,5,-4,112,94,1370,1491,T1
1804,November 11,2011,Liechtenstein,Hungary,0,5,Friendly,in Hungary,-2,2,1235,1684,-2,0,147,42,1237,1682,T1
1805,November 11,2011,China,Iraq,0,1,World Cup qualifier,in Qatar,-22,22,1593,1596,-5,9,60,59,1615,1574,T1
1806,November 11,2011,Jordan,Singapore,2,0,World Cup qualifier,in Jordan,6,-6,1593,1292,4,-2,60,136,1587,1298,T1
1807,November 11,2011,Kuwait,Lebanon,0,1,World Cup qualifier,in Kuwait,-37,37,1542,1283,-7,4,74,138,1579,1246,T2
1808,November 11,2011,Lesotho,Burundi,1,0,World Cup qualifier,in Lesotho,19,-19,1180,1223,5,-4,162,148,1161,1242,T1
1809,November 11,2011,Serbia,Mexico,0,2,Friendly,in Mexico,-7,7,1736,1866,2,1,32,12,1743,1859,T1
1810,November 11,2011,Uganda,Morocco,1,0,Friendly tournament,in Morocco,22,-22,1549,1567,3,-6,73,69,1527,1589,T2
1811,November 11,2011,Netherlands,Switzerland,0,0,Friendly,in the Netherlands,-8,8,2081,1767,0,3,2,28,2089,1759,draw
1812,November 11,2011,Nicaragua,Dominica,1,0,World Cup qualifier,in Nicaragua,11,-11,1117,1022,1,-2,173,183,1106,1033,T1
1813,November 11,2011,Australia,Oman,0,1,World Cup qualifier,in Oman,-32,32,1813,1542,-5,8,19,74,1845,1510,T1
1814,November 11,2011,Costa Rica,Panama,0,2,Friendly,in Panama,-10,10,1637,1668,-3,3,52,45,1647,1658,T1
1815,November 11,2011,Ecuador,Paraguay,1,2,World Cup qualifier,in Paraguay,-13,13,1755,1805,-4,2,31,21,1768,1792,T1
1816,November 11,2011,Italy,Poland,2,0,Friendly,in Poland,12,-12,1896,1700,1,-3,8,40,1884,1712,T2
1817,November 11,2011,Saint Lucia,Puerto Rico,0,4,World Cup qualifier,in Puerto Rico,-27,27,1003,1060,-3,3,186,178,1030,1033,T1
1818,November 11,2011,Qatar,Indonesia,4,0,World Cup qualifier,in Qatar,10,-10,1516,1276,3,-2,81,139,1506,1286,T1
1819,November 11,2011,Congo,São Tomé and Príncipe,5,0,World Cup qualifier,in São Tomé and Príncipe,19,-19,1375,1037,3,-1,116,181,1356,1056,T2
1820,November 11,2011,Saudi Arabia,Thailand,3,0,World Cup qualifier,in Saudi Arabia,14,-14,1564,1394,2,-6,71,110,1550,1408,T1
1821,November 11,2011,Senegal,Guinea,4,1,Friendly,in France,13,-13,1621,1511,3,-4,55,82,1608,1524,T1
1822,November 11,2011,Kenya,Seychelles,3,0,World Cup qualifier,in the Seychelles,23,-23,1322,1047,3,-2,130,180,1299,1070,T2
1823,November 11,2011,Canada,Saint Kitts and Nevis,0,0,World Cup qualifier,in Saint Kitts and Nevis,-15,15,1591,1199,-4,6,63,154,1606,1184,draw
1824,November 11,2011,Suriname,El Salvador,1,3,World Cup qualifier,in Suriname,-11,11,1208,1582,-2,5,152,65,1219,1571,T2
1825,November 11,2011,Swaziland,Democratic Republic of Congo,1,3,World Cup qualifier,in Swaziland,-16,16,1111,1420,-2,5,174,101,1127,1404,T2
1826,November 11,2011,Japan,Tajikistan,4,0,World Cup qualifier,in Tajikistan,4,-4,1835,1242,1,-2,15,144,1831,1246,T2
1827,November 11,2011,Croatia,Turkey,3,0,European Championship qualifier,in Turkey,35,-35,1904,1732,5,-6,7,34,1869,1767,T2
1828,November 11,2011,South Korea,United Arab Emirates,2,0,World Cup qualifier,in the United Arab Emirates,9,-9,1807,1395,1,-3,20,109,1798,1404,T2
1829,November 11,2011,Germany,Ukraine,3,3,Friendly,in Ukraine,-6,6,2069,1764,0,2,3,30,2075,1758,draw
1830,November 11,2011,Chile,Uruguay,0,4,World Cup qualifier,in Uruguay,-20,20,1864,1982,-4,0,13,5,1884,1962,T1
1831,November 11,2011,US Virgin Islands,Curaçao,0,3,World Cup qualifier,in the US Virgin Islands,-13,13,712,1100,0,1,213,175,725,1087,T2
1832,November 11,2011,Uzbekistan,North Korea,1,0,World Cup qualifier,in Uzbekistan,8,-8,1617,1471,1,1,56,93,1609,1479,T1
1833,November 12,2011,Algeria,Tunisia,1,0,Friendly,in Algeria,11,-11,1481,1580,2,-3,92,66,1470,1591,T1
1834,November 12,2011,Spain,England,0,1,Friendly,in England,-13,13,2125,1950,0,0,1,6,2138,1937,T1
1835,November 12,2011,Ethiopia,Somalia,0,0,World Cup qualifier,in Djibouti,-17,17,1302,915,-1,1,132,196,1319,898,draw
1836,November 12,2011,Botswana,Nigeria,0,0,Friendly,in Nigeria,8,-8,1409,1659,3,-1,103,47,1401,1667,draw
1837,November 12,2011,South Africa,Ivory Coast,1,1,Friendly,in South Africa,2,-2,1614,1764,0,1,57,28,1612,1766,draw
1838,November 12,2011,Wales,Norway,4,1,Friendly,in Wales,20,-20,1649,1755,3,-4,50,30,1629,1775,T1
1839,November 13,2011,India,Malaysia,1,1,Friendly,in India,-3,3,1202,1217,0,0,153,150,1205,1214,draw
1840,November 13,2011,Morocco,Cameroon,1,1,Friendly tournament,in Morocco,-1,1,1566,1656,-1,0,70,49,1567,1655,draw
1841,November 13,2011,Sudan,Uganda,0,0,Friendly tournament,in Morocco,6,-6,1405,1543,0,0,107,73,1399,1549,draw
1842,November 14,2011,Bermuda,Barbados,2,1,World Cup qualifier,in Bermuda,13,-13,1209,1153,4,-1,152,167,1196,1166,T1
1843,November 14,2011,Brazil,Egypt,2,0,Friendly,in Qatar,4,-4,2064,1720,0,0,4,36,2060,1724,T1
1844,November 14,2011,Cayman Islands,Dominican Republic,1,1,World Cup qualifier,in the Cayman Islands,6,-6,937,1129,1,0,193,171,931,1135,draw
1845,November 14,2011,Honduras,Serbia,2,0,Friendly,in Honduras,15,-15,1653,1721,2,-3,50,35,1638,1736,T1
1846,November 14,2011,Puerto Rico,Saint Lucia,3,0,World Cup qualifier,in Puerto Rico,20,-20,1080,983,0,-2,178,188,1060,1003,T1
1847,November 15,2011,Libya,Belarus,1,1,Friendly,in the United Arab Emirates,2,-2,1511,1591,0,-2,83,62,1509,1593,draw
1848,November 15,2011,Burkina Faso,Guinea,1,1,Friendly,in France,0,0,1518,1511,-1,-1,81,83,1518,1511,draw
1849,November 15,2011,Burundi,Lesotho,2,2,World Cup qualifier,in Burundi,-8,8,1215,1188,-3,2,151,160,1223,1180,draw
1850,November 15,2011,Saint Kitts and Nevis,Canada,0,4,World Cup qualifier,in Canada,-4,4,1195,1595,-3,2,158,61,1199,1591,T1
1851,November 15,2011,Chile,Paraguay,2,0,World Cup qualifier,in Chile,17,-17,1881,1788,2,0,11,21,1864,1805,T1
1852,November 15,2011,Colombia,Argentina,1,2,World Cup qualifier,in Colombia,-20,20,1769,1915,-3,2,26,7,1789,1895,T2
1853,November 15,2011,São Tomé and Príncipe,Congo,1,1,World Cup qualifier,in Congo,17,-17,1054,1358,1,-3,180,119,1037,1375,draw
1854,November 15,2011,Costa Rica,Spain,2,2,Friendly,in Costa Rica,8,-8,1645,2117,2,0,51,1,1637,2125,draw
1855,November 15,2011,Croatia,Turkey,0,0,European Championship qualifier,in Croatia,-13,13,1891,1745,-2,1,9,32,1904,1732,draw
1856,November 15,2011,US Virgin Islands,Curaçao,1,6,World Cup qualifier,in Curaçao,-5,5,707,1105,0,0,213,175,712,1100,T1
1857,November 15,2011,Denmark,Finland,2,1,Friendly,in Denmark,3,-3,1831,1603,1,-1,15,59,1828,1606,T1
1858,November 15,2011,Swaziland,Democratic Republic of Congo,1,5,World Cup qualifier,in the Democratic Republic of the Congo,-7,7,1104,1427,-2,0,176,101,1111,1420,T1
1859,November 15,2011,Ecuador,Peru,2,0,World Cup qualifier,in Ecuador,23,-23,1778,1753,7,-7,23,31,1755,1776,T1
1860,November 15,2011,Suriname,El Salvador,0,4,World Cup qualifier,in El Salvador,-5,5,1203,1587,-1,1,154,63,1208,1582,T1
1861,November 15,2011,England,Sweden,1,0,Friendly,in England,5,-5,1955,1862,0,-2,6,13,1950,1867,T1
1862,November 15,2011,France,Belgium,0,0,Friendly,in France,-6,6,1839,1683,0,1,14,42,1845,1677,draw
1863,November 15,2011,Netherlands,Germany,0,3,Friendly,in Germany,-13,13,2068,2082,-1,1,3,2,2081,2069,T1
1864,November 15,2011,Ghana,Gabon,2,1,Friendly,in France,5,-5,1775,1555,2,1,24,71,1770,1560,T1
1865,November 15,2011,Grenada,Guatemala,1,4,World Cup qualifier,in Grenada,-16,16,1175,1513,-3,7,161,82,1191,1497,T2
1866,November 15,2011,Haiti,Antigua and Barbuda,2,1,World Cup qualifier,in Haiti,10,-10,1417,1313,3,-2,102,131,1407,1323,T1
1867,November 15,2011,Iran,Indonesia,4,1,World Cup qualifier,in Indonesia,8,-8,1744,1268,-1,-1,33,140,1736,1276,T2
1868,November 15,2011,Estonia,Ireland,1,1,European Championship qualifier,in Ireland,17,-17,1524,1803,6,-1,78,18,1507,1820,draw
1869,November 15,2011,Italy,Uruguay,0,1,Friendly,in Italy,-10,10,1886,1992,-2,0,10,5,1896,1982,T2
1870,November 15,2011,Jordan,Iraq,1,3,World Cup qualifier,in Jordan,-38,38,1555,1634,-11,5,71,54,1593,1596,T2
1871,November 15,2011,Kenya,Seychelles,4,0,World Cup qualifier,in Kenya,8,-8,1330,1039,2,-1,128,181,1322,1047,T1
1872,November 15,2011,Kuwait,United Arab Emirates,2,1,World Cup qualifier,in Kuwait,8,-8,1550,1387,1,-2,73,111,1542,1395,T1
1873,November 15,2011,South Korea,Lebanon,1,2,World Cup qualifier,in Lebanon,-37,37,1770,1320,-5,9,25,129,1807,1283,T1
1874,November 15,2011,Switzerland,Luxembourg,1,0,Friendly,in Luxembourg,1,-1,1768,1151,0,1,27,167,1767,1152,T2
1875,November 15,2011,Albania,Macedonia,0,0,Friendly,in Macedonia,4,-4,1483,1502,-1,-4,94,89,1479,1506,draw
1876,November 15,2011,Madagascar,Equatorial Guinea,2,1,World Cup qualifier,in Madagascar,18,-18,1199,1227,5,-4,156,147,1181,1245,T1
1877,November 15,2011,Montenegro,Czechia,0,1,European Championship qualifier,in Montenegro,-19,19,1639,1795,-5,4,53,20,1658,1776,T2
1878,November 15,2011,Mozambique,Comoros,4,1,World Cup qualifier,in Mozambique,2,-2,1350,869,1,0,121,203,1348,871,T1
1879,November 15,2011,Namibia,Djibouti,4,0,World Cup qualifier,in Namibia,2,-2,1297,794,0,0,135,207,1295,796,T1
1880,November 15,2011,Niger,Botswana,1,1,Friendly,in Niger,-1,1,1331,1410,1,-1,126,104,1332,1409,draw
1881,November 15,2011,Nigeria,Zambia,2,0,Friendly,in Nigeria,6,-6,1665,1522,1,-1,46,79,1659,1528,T1
1882,November 15,2011,North Korea,Japan,1,0,World Cup qualifier,in North Korea,33,-33,1504,1802,7,-4,87,19,1471,1835,T1
1883,November 15,2011,Dominica,Panama,0,3,World Cup qualifier,in Panama,-1,1,1021,1669,-1,1,184,44,1022,1668,T1
1884,November 15,2011,Poland,Hungary,2,1,Friendly,in Poland,7,-7,1707,1677,2,-1,38,43,1700,1684,T1
1885,November 15,2011,Bosnia and Herzegovina,Portugal,2,6,European Championship qualifier,in Portugal,-12,12,1694,1901,-4,2,41,8,1706,1889,T1
1886,November 15,2011,Qatar,Bahrain,0,0,World Cup qualifier,in Qatar,-6,6,1510,1508,-4,1,85,86,1516,1502,draw
1887,November 15,2011,Greece,Romania,1,3,Friendly,in Austria,-20,20,1785,1707,-1,3,22,38,1805,1687,T1
1888,November 15,2011,Rwanda,Eritrea,3,1,World Cup qualifier,in Rwanda,10,-10,1363,1160,2,-1,118,165,1353,1170,T1
1889,November 15,2011,Oman,Saudi Arabia,0,0,World Cup qualifier,in Saudi Arabia,7,-7,1549,1557,0,1,74,70,1542,1564,draw
1890,November 15,2011,Singapore,China,0,4,World Cup qualifier,in Singapore,-18,18,1274,1611,-3,2,139,58,1292,1593,T2
1891,November 15,2011,Slovenia,United States,2,3,Friendly,in Slovenia,-12,12,1653,1716,-2,1,48,37,1665,1704,T2
1892,November 15,2011,Saint Vincent and the Grenadines,Belize,0,2,World Cup qualifier,in Saint Vincent and the Grenadines,-46,46,1142,1130,-11,6,170,171,1188,1084,T2
1893,November 15,2011,Tanzania,Chad,0,1,World Cup qualifier,in Tanzania,-33,33,1319,1221,-9,10,130,149,1352,1188,T2
1894,November 15,2011,Australia,Thailand,1,0,World Cup qualifier,in Thailand,5,-5,1818,1389,3,0,16,110,1813,1394,T2
1895,November 15,2011,Togo,Guinea-Bissau,1,0,World Cup qualifier,in Togo,8,-8,1381,1229,4,-1,113,146,1373,1237,T1
1896,November 15,2011,Trinidad and Tobago,Guyana,2,0,World Cup qualifier,in Trinidad and Tobago,16,-16,1486,1375,3,-5,92,117,1470,1391,T1
1897,November 15,2011,Ukraine,Austria,2,1,Friendly,in Ukraine,3,-3,1767,1579,0,-2,28,66,1764,1582,T1
1898,November 15,2011,Uzbekistan,Tajikistan,3,0,World Cup qualifier,in Uzbekistan,4,-4,1621,1238,0,1,56,143,1617,1242,T1
1899,November 15,2011,Bolivia,Venezuela,0,1,World Cup qualifier,in Venezuela,-6,6,1536,1737,-2,0,76,34,1542,1731,T1
1900,November 15,2011,Zimbabwe,South Africa,2,1,Friendly,in Zimbabwe,14,-14,1385,1600,6,-3,112,60,1371,1614,T1
1901,November 16,2011,Somalia,Ethiopia,0,5,World Cup qualifier,in Ethiopia,-5,5,910,1307,0,0,196,133,915,1302,T1
1902,November 16,2011,India,Malaysia,3,2,Friendly,in India,8,-8,1210,1209,3,-3,152,153,1202,1217,T1
1903,November 22,2011,Tonga,Eastern Samoa,1,2,World Cup and Oceania Cup qualifier,in Samoa,-35,35,655,371,-3,0,220,233,690,336,T1
1904,November 22,2011,Seychelles,Maldives,0,3,Friendly,in the Maldives,-10,10,1029,1100,-1,0,182,177,1039,1090,T1
1905,November 22,2011,Samoa,Cook Islands,3,2,World Cup and Oceania Cup qualifier,in Samoa,17,-17,701,712,5,-1,214,212,684,729,T1
1906,November 24,2011,Cook Islands,Eastern Samoa,1,1,World Cup and Oceania Cup qualifier,in Samoa,-15,15,697,386,-3,0,215,233,712,371,draw
1907,November 24,2011,Maldives,Seychelles,2,1,Friendly,in the Maldives,5,-5,1105,1024,2,0,175,182,1100,1029,T1
1908,November 24,2011,Tonga,Samoa,1,1,World Cup and Oceania Cup qualifier,in Samoa,8,-8,663,693,1,-3,219,217,655,701,draw
1909,November 25,2011,Somalia,Burundi,1,4,CECAFA Cup,in Tanzania,-10,10,900,1225,-1,2,197,148,910,1215,T1
1910,November 25,2011,Uganda,Zanzibar,2,1,CECAFA Cup,in Tanzania,10,-10,1553,1344,2,-1,73,121,1543,1354,T1
1911,November 26,2011,Tanzania,Rwanda,0,1,CECAFA Cup,in Tanzania,-23,23,1296,1386,-6,6,136,112,1319,1363,T2
1912,November 26,2011,Tonga,Cook Islands,2,1,World Cup and Oceania Cup qualifier,in Samoa,22,-22,685,675,1,-4,218,219,663,697,T1
1913,November 26,2011,Samoa,Eastern Samoa,1,0,World Cup and Oceania Cup qualifier,in Samoa,4,-4,697,382,2,0,215,233,693,386,T1
1914,November 27,2011,Burundi,Zanzibar,0,0,CECAFA Cup,in Tanzania,7,-7,1232,1337,2,-4,146,125,1225,1344,draw
1915,November 27,2011,Djibouti,Zimbabwe,0,2,CECAFA Cup,in Tanzania,-2,2,792,1387,0,2,207,111,794,1385,T1
1916,November 28,2011,Ethiopia,Sudan,1,1,CECAFA Cup,in Tanzania,5,-5,1312,1400,2,0,130,107,1307,1405,draw
1917,November 28,2011,Malawi,Kenya,2,0,CECAFA Cup,in Tanzania,23,-23,1438,1307,2,-4,101,132,1415,1330,T1
1918,November 28,2011,Uganda,Somalia,4,0,CECAFA Cup,in Tanzania,2,-2,1555,898,2,0,71,197,1553,900,T1
1919,November 29,2011,Zambia,India,5,0,Friendly,in India,9,-9,1531,1201,2,-3,77,155,1522,1210,T2
1920,November 29,2011,Rwanda,Zimbabwe,2,0,CECAFA Cup,in Tanzania,30,-30,1416,1357,9,-8,104,119,1386,1387,T1
1921,November 29,2011,Tanzania,Djibouti,3,0,CECAFA Cup,in Tanzania,2,-2,1298,790,2,0,134,207,1296,792,T1
1922,November 30,2011,Kenya,Ethiopia,2,0,CECAFA Cup,in Tanzania,30,-30,1337,1282,7,-7,125,137,1307,1312,T1
1923,November 30,2011,Malawi,Sudan,0,0,CECAFA Cup,in Tanzania,-2,2,1436,1402,0,0,101,108,1438,1400,draw
1924,December 1,2011,Burundi,Uganda,1,0,CECAFA Cup,in Tanzania,35,-35,1267,1520,5,-9,141,80,1232,1555,T1
1925,December 1,2011,Zanzibar,Somalia,3,0,CECAFA Cup,in Tanzania,5,-5,1342,893,2,-2,123,199,1337,898,T1
1926,December 2,2011,Bangladesh,Pakistan,0,0,South Asian Cup,in India,-6,6,989,892,-1,2,188,200,995,886,draw
1927,December 2,2011,Curaçao,Bonaire,1,3,Friendly tournament,in Suriname,-30,30,1075,1011,-3,3,178,186,1105,981,T1
1928,December 2,2011,Malawi,Ethiopia,1,1,CECAFA Cup,in Tanzania,-8,8,1428,1290,0,1,101,136,1436,1282,draw
1929,December 2,2011,Maldives,Nepal,1,1,South Asian Cup,in India,-7,7,1098,976,-1,0,176,190,1105,969,draw
1930,December 2,2011,Rwanda,Djibouti,5,2,CECAFA Cup,in Tanzania,2,-2,1418,788,1,0,103,207,1416,790,T1
1931,December 2,2011,Aruba,Suriname,0,0,Friendly tournament,in Suriname,12,-12,962,1191,1,-5,191,159,950,1203,draw
1932,December 3,2011,Afghanistan,India,1,1,South Asian Cup,in India,17,-17,856,1184,1,-6,204,160,839,1201,draw
1933,December 3,2011,Bhutan,Sri Lanka,0,3,South Asian Cup,in India,-9,9,556,899,-1,4,227,197,565,890,T1
1934,December 3,2011,Sudan,Kenya,1,0,CECAFA Cup,in Tanzania,16,-16,1418,1321,5,-2,103,128,1402,1337,T1
1935,December 3,2011,Tanzania,Zimbabwe,1,2,CECAFA Cup,in Tanzania,-22,22,1276,1379,-4,4,137,115,1298,1357,T2
1936,December 4,2011,Bonaire,Aruba,2,2,Friendly tournament,in Suriname,-2,2,1009,964,0,0,186,191,1011,962,draw
1937,December 4,2011,Pakistan,Maldives,0,0,South Asian Cup,in India,11,-11,903,1087,4,0,197,176,892,1098,draw
1938,December 4,2011,Bangladesh,Nepal,0,1,South Asian Cup,in India,-21,21,968,997,-2,2,190,188,989,976,T1
1939,December 4,2011,Suriname,Curaçao,2,0,Friendly tournament,in Suriname,10,-10,1201,1065,4,0,154,178,1191,1075,T1
1940,December 5,2011,Sri Lanka,Afghanistan,1,3,South Asian Cup,in India,-34,34,865,890,-6,3,204,201,899,856,T1
1941,December 5,2011,India,Bhutan,5,0,South Asian Cup,in India,1,-1,1185,555,0,0,160,227,1184,556,T1
1942,December 5,2011,Zanzibar,Rwanda,1,2,CECAFA Cup,in Tanzania,-16,16,1326,1434,-4,1,127,102,1342,1418,T1
1943,December 5,2011,Sudan,Burundi,2,0,CECAFA Cup,in Tanzania,18,-18,1436,1249,2,-2,101,143,1418,1267,T1
1944,December 6,2011,Palestine,Bahrain,1,0,Friendly,in Bahrain,19,-19,1189,1489,4,-5,159,91,1170,1508,T2
1945,December 6,2011,Bangladesh,Maldives,1,3,South Asian Cup,in India,-20,20,948,1107,-2,1,192,175,968,1087,T1
1946,December 6,2011,Nepal,Pakistan,1,1,South Asian Cup,in India,-5,5,992,908,0,1,188,196,997,903,draw
1947,December 6,2011,Malawi,Tanzania,0,1,CECAFA Cup,in Tanzania,-23,23,1405,1299,-5,4,108,133,1428,1276,T1
1948,December 6,2011,Zimbabwe,Uganda,0,1,CECAFA Cup,in Tanzania,-12,12,1367,1532,-3,4,118,76,1379,1520,T1
1949,December 7,2011,Afghanistan,Bhutan,8,1,South Asian Cup,in India,11,-11,901,544,3,-1,198,228,890,555,T1
1950,December 7,2011,India,Sri Lanka,3,0,South Asian Cup,in India,6,-6,1191,859,2,0,159,204,1185,865,T1
1951,December 8,2011,Rwanda,Sudan,2,1,CECAFA Cup,in Tanzania,20,-20,1454,1416,3,-3,99,104,1434,1436,T1
1952,December 8,2011,Tanzania,Uganda,1,3,CECAFA Cup,in Tanzania,-19,19,1280,1551,-4,3,137,73,1299,1532,T2
1953,December 9,2011,Nepal,Afghanistan,0,1,South Asian Cup,in India,-25,25,967,926,-1,2,189,196,992,901,T1
1954,December 9,2011,India,Maldives,3,1,South Asian Cup,in India,15,-15,1206,1092,5,-1,154,176,1191,1107,T1
1955,December 10,2011,Qatar,Bahrain,2,2,Pan Arab Games,in Qatar,-7,7,1503,1496,-2,1,87,90,1510,1489,draw
1956,December 10,2011,Rwanda,Uganda,2,2,CECAFA Cup,in Tanzania,5,-5,1459,1546,1,-2,98,75,1454,1551,draw
1957,December 10,2011,Tanzania,Sudan,0,1,CECAFA Cup,in Tanzania,-18,18,1262,1434,-3,2,140,102,1280,1416,T2
1958,December 11,2011,Cuba,Costa Rica,1,1,Friendly,in Cuba,4,-4,1396,1641,0,0,110,51,1392,1645,draw
1959,December 11,2011,India,Afghanistan,4,0,South Asian Cup,in India,8,-8,1214,918,3,0,151,196,1206,926,T1
1960,December 11,2011,Palestine,Jordan,1,4,Pan Arab Games,in Qatar,-8,8,1181,1563,-1,1,161,70,1189,1555,T1
1961,December 13,2011,Bahrain,Iraq,3,0,Pan Arab Games,in Qatar,48,-48,1544,1586,14,-9,76,63,1496,1634,T1
1962,December 14,2011,Libya,Palestine,1,1,Pan Arab Games,in Qatar,-15,15,1496,1196,-6,3,90,158,1511,1181,draw
1963,December 16,2011,Iraq,Qatar,0,0,Pan Arab Games,in Qatar,1,-1,1587,1502,1,0,62,87,1586,1503,draw
1964,December 17,2011,Libya,Jordan,0,0,Pan Arab Games,in Qatar,4,-4,1500,1559,0,0,90,70,1496,1563,draw
1965,December 18,2011,Angola,Zambia,1,0,Friendly,in Angola,8,-8,1492,1523,1,-2,92,80,1484,1531,T1
1966,December 20,2011,Palestine,Bahrain,1,3,Pan Arab Games,in Qatar,-7,7,1189,1551,-2,3,160,73,1196,1544,T1
1967,December 20,2011,Jordan,Kuwait,2,0,Pan Arab Games,in Qatar,29,-29,1588,1521,8,-7,62,80,1559,1550,T1
1968,December 21,2011,Lesotho,Botswana,0,3,Friendly,in South Africa,-8,8,1180,1418,0,1,161,104,1188,1410,T1
1969,December 21,2011,Paraguay,Chile,2,3,Friendly,in Chile,-5,5,1783,1886,-1,1,22,10,1788,1881,T1
1970,December 22,2011,Namibia,Angola,0,0,Friendly,in Angola,7,-7,1304,1485,1,-1,132,93,1297,1492,draw
1971,December 22,2011,Palestine,Kuwait,0,3,Pan Arab Games,in Qatar,-9,9,1180,1530,0,2,160,78,1189,1521,T1
1972,December 22,2011,Costa Rica,Venezuela,2,0,Friendly,in Venezuela,23,-23,1664,1714,4,-3,47,37,1641,1737,T2
1973,January 6,2012,South Africa,Equatorial Guinea,0,0,Friendly,in Equatorial Guinea,-7,7,1593,1234,-1,1,60,147,1600,1227,draw
1974,January 7,2012,Zimbabwe,Botswana,0,0,Friendly,in Botswana,4,-4,1371,1414,0,-1,118,105,1367,1418,draw
1975,January 9,2012,Burkina Faso,Gabon,0,0,Friendly,in Gabon,4,-4,1522,1551,1,0,81,73,1518,1555,draw
1976,January 9,2012,Tunisia,Sudan,3,0,Friendly,in the United Arab Emirates,11,-11,1591,1423,3,-1,61,103,1580,1434,T1
1977,January 11,2012,Angola,Nigeria,0,0,Friendly,in Nigeria,7,-7,1492,1658,1,-1,92,47,1485,1665,draw
1978,January 11,2012,South Africa,Zambia,1,1,Friendly,in South Africa,-5,5,1588,1528,-2,1,62,79,1593,1523,draw
1979,January 12,2012,Senegal,Sudan,1,0,Friendly,in Senegal,3,-3,1624,1420,0,0,55,103,1621,1423,T1
1980,January 13,2012,Ivory Coast,Tunisia,2,0,Friendly,in the United Arab Emirates,8,-8,1772,1583,4,-4,25,64,1764,1591,T1
1981,January 14,2012,Angola,Sierra Leone,3,1,Friendly,in Angola,6,-6,1498,1336,1,-1,91,124,1492,1342,T1
1982,January 14,2012,Zambia,Namibia,0,0,Friendly,in South Africa,-6,6,1522,1310,-1,1,80,131,1528,1304,draw
1983,January 15,2012,Oman,Democratic Republic of Congo,2,2,Friendly,in Oman,-6,6,1543,1433,-1,0,75,102,1549,1427,draw
1984,January 15,2012,Lesotho,São Tomé and Príncipe,0,1,African Nations Cup qualifier,in São Tomé and Príncipe,-21,21,1159,1075,-5,2,165,178,1180,1054,T1
1985,January 15,2012,South Africa,Ghana,1,1,Friendly,in South Africa,2,-2,1590,1773,0,0,61,24,1588,1775,draw
1986,January 16,2012,Sudan,Gabon,0,0,Friendly,in Gabon,6,-6,1426,1545,0,-1,103,74,1420,1551,draw
1987,January 16,2012,Ivory Coast,Libya,1,0,Friendly,in the United Arab Emirates,3,-3,1775,1497,1,-1,24,91,1772,1500,T1
1988,January 17,2012,Uzbekistan,Kuwait,0,1,Friendly,in Kuwait,-10,10,1611,1540,0,2,56,76,1621,1530,T1
1989,January 18,2012,Sweden,Bahrain,2,0,Friendly,in Qatar,5,-5,1867,1568,1,0,12,68,1862,1573,T1
1990,January 18,2012,Thailand,Norway,0,1,King's Cup,in Thailand,-5,5,1384,1760,-1,0,112,30,1389,1755,T2
1991,January 21,2012,Equatorial Guinea,Libya,1,0,African Nations Cup,in Equatorial Guinea,36,-36,1270,1461,8,-6,139,97,1234,1497,T1
1992,January 21,2012,Venezuela,United States,0,1,Friendly,in the United States,-7,7,1707,1723,0,2,37,34,1714,1716,T1
1993,January 21,2012,Senegal,Zambia,1,2,African Nations Cup,in Equatorial Guinea,-32,32,1592,1554,-4,7,59,73,1624,1522,T1
1994,January 22,2012,Angola,Burkina Faso,2,1,African Nations Cup,in Equatorial Guinea,27,-27,1525,1495,10,-9,80,90,1498,1522,T1
1995,January 22,2012,Sudan,Ivory Coast,0,1,African Nations Cup,in Equatorial Guinea,-6,6,1420,1781,0,1,103,23,1426,1775,T1
1996,January 22,2012,Lebanon,Iraq,1,0,Friendly,in Lebanon,14,-14,1334,1573,4,-5,125,67,1320,1587,T1
1997,January 22,2012,Lesotho,São Tomé and Príncipe,0,0,African Nations Cup qualifier,in Lesotho,-10,10,1149,1085,-2,1,167,177,1159,1075,draw
1998,January 22,2012,Finland,Trinidad and Tobago,3,2,Friendly,in Trinidad and Tobago,10,-10,1613,1476,2,-2,55,94,1603,1486,T2
1999,January 23,2012,Gabon,Niger,2,0,African Nations Cup,in Gabon,11,-11,1556,1320,3,-3,72,129,1545,1331,T1
2000,January 23,2012,Tunisia,Morocco,2,1,African Nations Cup,in Gabon,24,-24,1607,1542,5,-6,58,76,1583,1566,T1
2001,January 24,2012,Ghana,Botswana,1,0,African Nations Cup,in Gabon,6,-6,1779,1408,1,0,24,105,1773,1414,T1
2002,January 24,2012,Guinea,Mali,0,1,African Nations Cup,in Gabon,-26,26,1485,1527,-7,9,91,80,1511,1501,T1
2003,January 25,2012,Equatorial Guinea,Senegal,2,1,African Nations Cup,in Equatorial Guinea,39,-39,1309,1553,7,-12,132,72,1270,1592,T1
2004,January 25,2012,Zambia,Libya,2,2,African Nations Cup,in Equatorial Guinea,-7,7,1547,1468,0,2,73,95,1554,1461,draw
2005,January 25,2012,Mexico,Venezuela,3,1,Friendly,in the United States,9,-9,1875,1698,1,-3,12,40,1866,1707,T1
2006,January 25,2012,United States,Panama,1,0,Friendly,in Panama,11,-11,1734,1658,0,-2,34,46,1723,1669,T2
2007,January 26,2012,Angola,Sudan,2,2,African Nations Cup,in Equatorial Guinea,-7,7,1518,1427,-2,0,83,103,1525,1420,draw
2008,January 26,2012,Ivory Coast,Burkina Faso,2,0,African Nations Cup,in Equatorial Guinea,12,-12,1793,1483,2,-2,21,91,1781,1495,T1
2009,January 27,2012,Gabon,Morocco,3,2,African Nations Cup,in Gabon,17,-17,1573,1525,5,-4,66,80,1556,1542,T1
2010,January 27,2012,Turkmenistan,Romania,0,4,Friendly,in Turkey,-4,4,1340,1711,-2,0,123,37,1344,1707,T1
2011,January 27,2012,Tunisia,Niger,2,1,African Nations Cup,in Gabon,8,-8,1615,1312,3,-1,55,130,1607,1320,T1
2012,January 28,2012,Mali,Ghana,0,2,African Nations Cup,in Gabon,-14,14,1513,1793,-5,3,84,21,1527,1779,T1
2013,January 28,2012,Guinea,Botswana,6,1,African Nations Cup,in Gabon,39,-39,1524,1369,10,-13,80,118,1485,1408,T1
2014,January 29,2012,Equatorial Guinea,Zambia,0,1,African Nations Cup,in Equatorial Guinea,-16,16,1293,1563,-3,2,135,71,1309,1547,T2
2015,January 29,2012,Senegal,Libya,1,2,African Nations Cup,in Equatorial Guinea,-31,31,1522,1499,-9,5,81,90,1553,1468,T1
2016,January 29,2012,United Arab Emirates,Uzbekistan,1,0,Friendly,in the United Arab Emirates,13,-13,1400,1598,2,-1,108,58,1387,1611,T1
2017,January 30,2012,Angola,Ivory Coast,0,2,African Nations Cup,in Equatorial Guinea,-13,13,1505,1806,-2,3,85,18,1518,1793,T1
2018,January 30,2012,Burkina Faso,Sudan,1,2,African Nations Cup,in Equatorial Guinea,-29,29,1454,1456,-8,4,100,99,1483,1427,T1
2019,January 31,2012,Gabon,Tunisia,1,0,African Nations Cup,in Gabon,21,-21,1594,1594,7,-4,59,59,1573,1615,T1
2020,January 31,2012,Morocco,Niger,1,0,African Nations Cup,in Gabon,11,-11,1536,1301,2,-3,76,133,1525,1312,T1
2021,February 1,2012,Ghana,Guinea,1,1,African Nations Cup,in Gabon,-16,16,1777,1540,-3,4,25,75,1793,1524,draw
2022,February 1,2012,Mali,Botswana,2,1,African Nations Cup,in Gabon,15,-15,1528,1354,3,-1,80,119,1513,1369,T1
2023,February 4,2012,Equatorial Guinea,Ivory Coast,0,3,African Nations Cup,in Equatorial Guinea,-7,7,1286,1813,-1,0,136,18,1293,1806,T2
2024,February 4,2012,Zambia,Sudan,3,0,African Nations Cup,in Equatorial Guinea,31,-31,1594,1425,12,-4,59,103,1563,1456,T1
2025,February 5,2012,Mali,Gabon,1,1,African Nations Cup,in Gabon,11,-11,1539,1583,3,-4,77,63,1528,1594,draw
2026,February 5,2012,Ghana,Tunisia,2,1,African Nations Cup,in Gabon,13,-13,1790,1581,3,-5,22,64,1777,1594,T1
2027,February 8,2012,Mali,Ivory Coast,0,1,African Nations Cup,in Gabon,-9,9,1530,1822,-3,2,80,16,1539,1813,T1
2028,February 8,2012,Ghana,Zambia,0,1,African Nations Cup,in Equatorial Guinea,-38,38,1752,1632,-9,5,31,54,1790,1594,T1
2029,February 11,2012,Ghana,Mali,0,2,African Nations Cup,in Equatorial Guinea,-59,59,1693,1589,-10,18,41,62,1752,1530,T1
2030,February 12,2012,Zambia,Ivory Coast,0,0,African Nations Cup,in Gabon,12,-12,1644,1810,2,-2,52,18,1632,1822,draw
2031,February 15,2012,Liberia,Nigeria,0,2,Friendly,in Liberia,-4,4,1247,1662,-2,0,144,46,1251,1658,T2
2032,February 15,2012,Paraguay,Chile,2,0,Friendly,in Paraguay,15,-15,1798,1871,2,-2,21,12,1783,1886,T1
2033,February 17,2012,Kuwait,North Korea,1,1,Friendly,in China,-1,1,1539,1505,-1,1,77,85,1540,1504,draw
2034,February 19,2012,Saint Vincent and the Grenadines,Guyana,1,0,Friendly,in Saint Vincent and the Grenadines,14,-14,1156,1361,5,-1,165,117,1142,1375,T1
2035,February 22,2012,China,Kuwait,2,0,Friendly,in China,8,-8,1619,1531,1,-2,56,79,1611,1539,T1
2036,February 22,2012,Guyana,Grenada,2,1,Friendly,in Grenada,8,-8,1369,1167,0,-1,117,162,1361,1175,T2
2037,February 22,2012,Jamaica,Cuba,1,0,Friendly,in Jamaica,2,-2,1642,1394,0,0,53,110,1640,1396,T1
2038,February 22,2012,Mozambique,Namibia,0,3,Friendly,in Namibia,-15,15,1335,1325,-4,2,124,128,1350,1310,T1
2039,February 22,2012,Guatemala,Paraguay,1,2,Friendly,in Paraguay,-2,2,1511,1800,0,0,84,21,1513,1798,T1
2040,February 23,2012,Jordan,Iran,2,2,Friendly,in the United Arab Emirates,5,-5,1571,1739,2,0,70,32,1566,1744,draw
2041,February 23,2012,India,Oman,1,5,Friendly,in Oman,-3,3,1211,1546,-1,1,152,74,1214,1543,T1
2042,February 23,2012,Democratic Republic of Congo,Tanzania,0,0,Friendly,in Tanzania,-2,2,1431,1264,0,0,102,141,1433,1262,draw
2043,February 24,2012,Azerbaijan,Singapore,2,2,Friendly,in the United Arab Emirates,-4,4,1403,1278,-2,1,108,138,1407,1274,draw
2044,February 24,2012,Cuba,Jamaica,0,3,Friendly,in Jamaica,-4,4,1390,1646,0,1,110,52,1394,1642,T1
2045,February 24,2012,Japan,Iceland,3,1,Friendly,in Japan,2,-2,1804,1440,1,0,19,101,1802,1442,T1
2046,February 24,2012,Nicaragua,Puerto Rico,1,0,Friendly,in Nicaragua,6,-6,1123,1074,0,0,174,178,1117,1080,T1
2047,February 24,2012,Maldives,Thailand,0,3,Friendly,in Thailand,-3,3,1089,1387,0,0,176,111,1092,1384,T1
2048,February 24,2012,Palestine,United Arab Emirates,0,3,Friendly,in the United Arab Emirates,-5,5,1175,1405,0,2,160,106,1180,1400,T1
2049,February 25,2012,South Korea,Uzbekistan,4,2,Friendly,in South Korea,5,-5,1775,1593,0,-1,25,59,1770,1598,T1
2050,February 26,2012,Nicaragua,Puerto Rico,4,1,Friendly,in Nicaragua,10,-10,1133,1064,3,-1,171,179,1123,1074,T1
2051,February 27,2012,Azerbaijan,India,3,0,Friendly,in the United Arab Emirates,9,-9,1412,1202,3,-2,105,154,1403,1211,T1
2052,February 28,2012,Bosnia and Herzegovina,Brazil,1,2,Friendly,in Switzerland,-2,2,1692,2066,-1,0,41,4,1694,2064,T1
2053,February 28,2012,Armenia,Serbia,0,2,Friendly,in Cyprus,-8,8,1523,1729,-2,0,81,34,1531,1721,T1
2054,February 29,2012,Antigua and Barbuda,Trinidad and Tobago,0,4,Friendly,in Antigua and Barbuda,-15,15,1298,1491,-3,2,133,92,1313,1476,T2
2055,February 29,2012,Armenia,Canada,3,1,Friendly,in Cyprus,18,-18,1541,1577,3,-10,78,68,1523,1595,T1
2056,February 29,2012,Australia,Saudi Arabia,4,2,World Cup qualifier,in Australia,7,-7,1825,1550,0,-1,16,74,1818,1557,T1
2057,February 29,2012,Finland,Austria,1,3,Friendly,in Austria,-12,12,1601,1591,-1,7,58,60,1613,1579,T1
2058,February 29,2012,Bahrain,Indonesia,10,0,World Cup qualifier,in Bahrain,10,-10,1578,1258,4,-3,67,143,1568,1268,T1
2059,February 29,2012,Moldova,Belarus,0,0,Friendly,in Turkey,5,-5,1413,1586,-1,-2,107,62,1408,1591,draw
2060,February 29,2012,Bolivia,Cuba,1,0,Friendly,in Bolivia,4,-4,1540,1386,-2,0,79,110,1536,1390,T1
2061,February 29,2012,Burundi,Zimbabwe,2,1,African Nations Cup qualifier,in Burundi,21,-21,1270,1350,4,-3,139,119,1249,1371,T1
2062,February 29,2012,Malawi,Chad,2,3,African Nations Cup qualifier,in Chad,-25,25,1380,1246,-5,4,112,146,1405,1221,T1
2063,February 29,2012,Chile,Ghana,1,1,Friendly,in the United States,-5,5,1866,1698,0,1,12,39,1871,1693,draw
2064,February 29,2012,Jordan,China,1,3,World Cup qualifier,in China,-18,18,1553,1637,-3,2,73,54,1571,1619,T1
2065,February 29,2012,Mexico,Colombia,0,2,Friendly,in the United States,-19,19,1856,1788,-3,4,14,22,1875,1769,T1
2066,February 29,2012,Congo,Uganda,3,1,African Nations Cup qualifier,in Congo,37,-37,1395,1509,10,-11,108,85,1358,1546,T1
2067,February 29,2012,Croatia,Sweden,1,3,Friendly,in Croatia,-20,20,1871,1887,-1,4,10,9,1891,1867,T2
2068,February 29,2012,Serbia,Cyprus,0,0,Friendly,in Cyprus,-4,4,1725,1468,1,1,33,95,1729,1464,draw
2069,February 29,2012,Russia,Denmark,2,0,Friendly,in Denmark,20,-20,1837,1811,2,-2,15,17,1817,1831,T2
2070,February 29,2012,Honduras,Ecuador,0,2,Friendly,in Ecuador,-6,6,1647,1784,-2,1,51,23,1653,1778,T1
2071,February 29,2012,Egypt,Niger,1,0,Friendly,in Qatar,2,-2,1722,1299,0,1,35,132,1720,1301,T1
2072,February 29,2012,Netherlands,England,3,2,Friendly,in England,10,-10,2078,1945,1,0,2,6,2068,1955,T2
2073,February 29,2012,El Salvador,Estonia,0,2,Friendly,in the United States,-18,18,1569,1542,-7,3,70,77,1587,1524,T1
2074,February 29,2012,Benin,Ethiopia,0,0,African Nations Cup qualifier,in Ethiopia,1,-1,1382,1289,1,0,111,135,1381,1290,draw
2075,February 29,2012,Algeria,Gambia,2,1,African Nations Cup qualifier,in The Gambia,20,-20,1501,1357,4,-1,89,116,1481,1377,T2
2076,February 29,2012,Georgia,Albania,2,1,Friendly,in Georgia,7,-7,1502,1476,3,-2,88,94,1495,1483,T1
2077,February 29,2012,Germany,France,1,2,Friendly,in Germany,-18,18,2064,1857,-2,1,4,13,2082,1839,T2
2078,February 29,2012,Belgium,Greece,1,1,Friendly,in Greece,5,-5,1688,1780,0,-2,42,25,1683,1785,draw
2079,February 29,2012,Guinea-Bissau,Cameroon,0,1,African Nations Cup qualifier,in Guinea-Bissau,-5,5,1224,1661,-1,3,149,45,1229,1656,T2
2080,February 29,2012,Guatemala,Guyana,2,0,Friendly,in Guyana,13,-13,1524,1356,3,0,81,117,1511,1369,T2
2081,February 29,2012,Taiwan,Hong Kong,1,5,Friendly,in Hong Kong,-4,4,901,1202,0,3,198,154,905,1198,T1
2082,February 29,2012,Hungary,Bulgaria,1,1,Friendly,in Hungary,-4,4,1673,1633,-1,-1,44,56,1677,1629,draw
2083,February 29,2012,Iran,Qatar,2,2,World Cup qualifier,in Iran,-15,15,1724,1517,-2,5,34,83,1739,1502,draw
2084,February 29,2012,Singapore,Iraq,1,7,World Cup qualifier,in Qatar,-13,13,1265,1586,-3,7,141,62,1278,1573,T1
2085,February 29,2012,Ireland,Czechia,1,1,Friendly,in Ireland,-3,3,1800,1798,0,1,20,21,1803,1795,draw
2086,February 29,2012,Israel,Ukraine,2,3,Friendly,in Israel,-10,10,1659,1777,-2,2,46,26,1669,1767,T2
2087,February 29,2012,Italy,United States,0,1,Friendly,in Italy,-16,16,1870,1750,-1,2,11,31,1886,1734,T2
2088,February 29,2012,Ivory Coast,Guinea,0,0,Friendly,in Ivory Coast,-8,8,1802,1548,-1,1,19,75,1810,1540,draw
2089,February 29,2012,Japan,Uzbekistan,0,1,World Cup qualifier,in Japan,-34,34,1770,1627,-8,2,27,57,1804,1593,T2
2090,February 29,2012,Latvia,Kazakhstan,0,0,Friendly,in Turkey,-5,5,1516,1346,-1,1,84,120,1521,1341,draw
2091,February 29,2012,Togo,Kenya,1,2,African Nations Cup qualifier,in Kenya,-18,18,1363,1339,-3,6,115,123,1381,1321,T1
2092,February 29,2012,Namibia,Liberia,0,1,African Nations Cup qualifier,in Liberia,-19,19,1306,1266,-2,4,130,140,1325,1247,T1
2093,February 29,2012,Luxembourg,Macedonia,2,1,Friendly,in Luxembourg,16,-16,1167,1486,5,-5,162,93,1151,1502,T1
2094,February 29,2012,Madagascar,Cape Verde,0,4,African Nations Cup qualifier,in Madagascar,-27,27,1172,1425,-5,6,161,103,1199,1398,T2
2095,February 29,2012,Malta,Liechtenstein,2,1,Friendly,in Malta,8,-8,1221,1227,0,-1,151,148,1213,1235,T1
2096,February 29,2012,Iceland,Montenegro,1,2,Friendly,in Montenegro,-3,3,1437,1642,-1,1,102,53,1440,1639,T1
2097,February 29,2012,Morocco,Burkina Faso,2,0,Friendly,in Morocco,8,-8,1544,1446,1,-1,76,100,1536,1454,T1
2098,February 29,2012,New Zealand,Jamaica,2,3,Friendly,in New Zealand,-11,11,1556,1657,0,5,72,47,1567,1646,T2
2099,February 29,2012,Northern Ireland,Norway,0,3,Friendly,in Northern Ireland,-8,8,1450,1768,-1,1,99,28,1458,1760,T2
2100,February 29,2012,Oman,Thailand,2,0,World Cup qualifier,in Oman,11,-11,1557,1376,3,-3,71,114,1546,1387,T1
2101,February 29,2012,Palestine,Azerbaijan,2,0,Friendly,in the United Arab Emirates,24,-24,1199,1388,3,-4,157,109,1175,1412,T1
2102,February 29,2012,Panama,Paraguay,0,1,Friendly,in Paraguay,-4,4,1654,1804,-2,3,49,18,1658,1800,T1
2103,February 29,2012,Malaysia,Philippines,1,1,Friendly,in the Philippines,-2,2,1207,1032,-1,0,153,181,1209,1030,draw
2104,February 29,2012,Portugal,Poland,0,0,Friendly,in Poland,-3,3,1898,1710,0,0,8,37,1901,1707,draw
2105,February 29,2012,Romania,Uruguay,1,1,Friendly,in Romania,5,-5,1716,1987,0,0,36,5,1711,1992,draw
2106,February 29,2012,Nigeria,Rwanda,0,0,African Nations Cup qualifier,in Rwanda,-6,6,1656,1465,-2,1,48,96,1662,1459,draw
2107,February 29,2012,São Tomé and Príncipe,Sierra Leone,2,1,African Nations Cup qualifier,in São Tomé and Príncipe,28,-28,1113,1308,2,-6,175,129,1085,1336,T1
2108,February 29,2012,Seychelles,Democratic Republic of Congo,0,4,African Nations Cup qualifier,in the Seychelles,-11,11,1013,1442,-2,1,184,101,1024,1431,T2
2109,February 29,2012,Scotland,Slovenia,1,1,Friendly,in Slovenia,1,-1,1705,1652,0,-1,38,50,1704,1653,draw
2110,February 29,2012,South Africa,Senegal,0,0,Friendly,in South Africa,-4,4,1586,1526,-1,2,62,80,1590,1522,draw
2111,February 29,2012,South Korea,Kuwait,2,0,World Cup qualifier,in South Korea,7,-7,1782,1524,1,-2,24,81,1775,1531,T1
2112,February 29,2012,Spain,Venezuela,5,0,Friendly,in Spain,2,-2,2119,1696,0,-1,1,40,2117,1698,T1
2113,February 29,2012,Switzerland,Argentina,1,3,Friendly,in Switzerland,-13,13,1755,1928,-2,0,29,7,1768,1915,T2
2114,February 29,2012,Tajikistan,North Korea,1,1,World Cup qualifier,in Tajikistan,9,-9,1247,1496,0,-6,145,91,1238,1505,draw
2115,February 29,2012,Tanzania,Mozambique,1,1,African Nations Cup qualifier,in Tanzania,-2,2,1262,1337,-1,0,142,124,1264,1335,draw
2116,February 29,2012,Peru,Tunisia,1,1,Friendly,in Tunisia,-2,2,1751,1583,0,0,30,65,1753,1581,draw
2117,February 29,2012,Slovakia,Turkey,2,1,Friendly,in Turkey,16,-16,1596,1729,7,-1,59,32,1580,1745,T2
2118,February 29,2012,United Arab Emirates,Lebanon,4,2,World Cup qualifier,in the United Arab Emirates,16,-16,1421,1318,2,-2,105,127,1405,1334,T1
2119,February 29,2012,Costa Rica,Wales,1,0,Friendly,in Wales,12,-12,1676,1637,2,-3,43,54,1664,1649,T2
2120,March 2,2012,Democratic Republic of Congo,Egypt,0,0,Friendly,in Qatar,7,-7,1449,1715,1,-1,100,36,1442,1722,draw
2121,March 3,2012,Guadeloupe,Martinique,2,1,Friendly,in Martinique,9,-9,1474,1334,1,-3,95,124,1465,1343,T2
2122,March 3,2012,Antigua and Barbuda,Saint Kitts and Nevis,0,1,Friendly,in Saint Kitts and Nevis,-10,10,1288,1205,-2,4,135,154,1298,1195,T1
2123,March 8,2012,Nepal,Palestine,0,2,Asian Cup qual &amp; Asian Challenge Cup,in Nepal,-19,19,948,1218,-2,6,191,152,967,1199,T2
2124,March 8,2012,Turkmenistan,Maldives,3,1,Asian Cup qual &amp; Asian Challenge Cup,in Nepal,11,-11,1351,1078,2,0,119,177,1340,1089,T1
2125,March 9,2012,North Korea,Philippines,2,0,Asian Cup qual &amp; Asian Challenge Cup,in Nepal,4,-4,1500,1028,1,0,90,181,1496,1032,T1
2126,March 9,2012,India,Tajikistan,0,2,Asian Cup qual &amp; Asian Challenge Cup,in Nepal,-26,26,1176,1273,-3,6,159,139,1202,1247,T1
2127,March 10,2012,Maldives,Nepal,1,0,Asian Cup qual &amp; Asian Challenge Cup,in Nepal,18,-18,1096,930,0,-3,177,194,1078,948,T2
2128,March 10,2012,Palestine,Turkmenistan,0,0,Asian Cup qual &amp; Asian Challenge Cup,in Nepal,7,-7,1225,1344,3,-2,149,121,1218,1351,draw
2129,March 11,2012,Tajikistan,North Korea,0,2,Asian Cup qual &amp; Asian Challenge Cup,in Nepal,-13,13,1260,1513,-4,5,143,85,1273,1500,T1
2130,March 11,2012,India,Philippines,0,2,Asian Cup qual &amp; Asian Challenge Cup,in Nepal,-42,42,1134,1070,-11,3,170,178,1176,1028,T1
2131,March 12,2012,Nepal,Turkmenistan,0,3,Asian Cup qual &amp; Asian Challenge Cup,in Nepal,-10,10,920,1354,-1,3,195,118,930,1344,T2
2132,March 12,2012,Palestine,Maldives,2,0,Asian Cup qual &amp; Asian Challenge Cup,in Nepal,19,-19,1244,1077,2,0,147,177,1225,1096,T1
2133,March 13,2012,India,North Korea,0,4,Asian Cup qual &amp; Asian Challenge Cup,in Nepal,-8,8,1126,1521,-4,2,174,83,1134,1513,T1
2134,March 13,2012,Tajikistan,Philippines,1,2,Asian Cup qual &amp; Asian Challenge Cup,in Nepal,-30,30,1230,1100,-5,1,148,177,1260,1070,T1
2135,March 16,2012,Palestine,North Korea,0,2,Asian Cup qual &amp; Asian Challenge Cup,in Nepal,-10,10,1234,1531,-1,3,147,80,1244,1521,T1
2136,March 16,2012,Philippines,Turkmenistan,1,2,Asian Cup qual &amp; Asian Challenge Cup,in Nepal,-8,8,1092,1362,0,2,177,116,1100,1354,T1
2137,March 19,2012,North Korea,Turkmenistan,2,1,Asian Cup qual &amp; Asian Challenge Cup,in Nepal,11,-11,1542,1351,3,-3,77,119,1531,1362,T1
2138,March 19,2012,Philippines,Palestine,4,3,Asian Cup qual &amp; Asian Challenge Cup,in Nepal,28,-28,1120,1206,2,-7,175,154,1092,1234,T1
2139,March 21,2012,Chile,Peru,3,1,Pacific Cup,in Chile,10,-10,1876,1741,2,-1,10,31,1866,1751,T1
2140,March 21,2012,French Guiana,Guyana,1,0,Friendly,in French Guiana,12,-12,1205,1344,3,-4,155,121,1193,1356,T1
2141,March 21,2012,Jamaica,Costa Rica,0,0,Friendly,in Jamaica,-2,2,1655,1678,-1,0,48,43,1657,1676,draw
2142,March 22,2012,Guyana,French Guiana,2,0,Friendly,in French Guiana,13,-13,1357,1192,5,-3,116,158,1344,1205,T2
2143,March 29,2012,Egypt,Uganda,2,1,Friendly,in Sudan,5,-5,1720,1504,1,-1,35,87,1715,1509,T1
2144,March 30,2012,Saint Vincent and the Grenadines,Antigua and Barbuda,1,0,Friendly,in Saint Vincent and the Grenadines,11,-11,1167,1277,4,-2,161,137,1156,1288,T1
2145,March 31,2012,Egypt,Chad,4,0,Friendly,in Sudan,2,-2,1722,1244,0,0,35,145,1720,1246,T1
2146,April 1,2012,Saint Vincent and the Grenadines,Antigua and Barbuda,1,2,Friendly,in Saint Vincent and the Grenadines,-10,10,1157,1287,-4,2,165,135,1167,1277,T2
2147,April 7,2012,Guadeloupe,Martinique,0,1,Friendly,in Guadeloupe,-16,16,1458,1350,-2,4,97,120,1474,1334,T2
2148,April 11,2012,Costa Rica,Honduras,1,1,Friendly,in Costa Rica,-4,4,1674,1651,0,0,43,51,1678,1647,draw
2149,April 11,2012,Chile,Peru,3,0,Pacific Cup,in Peru,24,-24,1900,1717,2,-4,8,35,1876,1741,T2
2150,April 12,2012,Egypt,Nigeria,3,2,Friendly,in the United Arab Emirates,8,-8,1730,1648,3,-4,31,51,1722,1656,T1
2151,April 15,2012,Mauritania,Egypt,0,3,Friendly,in the United Arab Emirates,-1,1,1142,1731,-1,0,169,31,1143,1730,T1
2152,April 17,2012,Egypt,Iraq,0,0,Friendly,in the United Arab Emirates,-4,4,1727,1590,-1,1,32,61,1731,1586,draw
2153,April 18,2012,Mauritania,Iran,0,2,Friendly,in Iran,-1,1,1141,1725,0,1,169,33,1142,1724,T1
2154,April 25,2012,Paraguay,Guatemala,1,0,Friendly,in Guatemala,5,-5,1809,1519,0,-1,18,83,1804,1524,T2
2155,April 28,2012,Sri Lanka,Malaysia,0,6,Friendly,in Malaysia,-3,3,856,1210,0,1,204,152,859,1207,T1
2156,May 2,2012,Mozambique,Iran,0,3,Friendly,in Iran,-2,2,1335,1727,0,1,124,32,1337,1725,T1
2157,May 2,2012,Martinique,Guyana,2,2,Friendly,in Martinique,-3,3,1347,1360,-1,0,121,116,1350,1357,draw
2158,May 4,2012,Guyana,Guadeloupe,2,1,Friendly,in Guadeloupe,15,-15,1375,1443,1,-4,115,101,1360,1458,T2
2159,May 7,2012,Libya,Egypt,0,4,Friendly,in Egypt,-5,5,1494,1732,0,1,91,31,1499,1727,T1
2160,May 11,2012,Lebanon,Egypt,1,4,Friendly,in Lebanon,-5,5,1313,1737,0,0,127,31,1318,1732,T2
2161,May 15,2012,Mauritania,Kurdistan,1,3,Friendly tournament,in Palestine,-8,8,1133,1408,-1,0,170,108,1141,1400,T1
2162,May 16,2012,Angola,Zambia,0,0,Friendly,in Angola,1,-1,1506,1643,0,0,86,52,1505,1644,draw
2163,May 17,2012,Mauritania,Indonesia,0,2,Friendly tournament,in Palestine,-15,15,1118,1273,-6,4,176,140,1133,1258,T1
2164,May 18,2012,Guyana,Jamaica,0,1,Friendly,in Jamaica,-2,2,1373,1657,0,0,116,47,1375,1655,T1
2165,May 18,2012,Lebanon,Jordan,1,2,Friendly,in Lebanon,-6,6,1307,1559,-2,2,130,71,1313,1553,T2
2166,May 19,2012,Kurdistan,Indonesia,1,1,Friendly tournament,in Palestine,-6,6,1402,1279,0,1,108,139,1408,1273,draw
2167,May 20,2012,Cameroon,Egypt,1,2,Friendly,in Sudan,-8,8,1653,1745,-3,0,48,31,1661,1737,T1
2168,May 20,2012,Panama,Guyana,2,0,Friendly,in Panama,3,-3,1657,1370,2,0,46,116,1654,1373,T1
2169,May 22,2012,Qatar,Albania,1,2,Friendly,in Spain,-11,11,1506,1487,-1,1,85,93,1517,1476,T1
2170,May 22,2012,Togo,Egypt,0,3,Friendly,in Sudan,-3,3,1360,1748,0,0,117,31,1363,1745,T1
2171,May 22,2012,Palestine,Indonesia,2,1,Friendly tournament,in Palestine,14,-14,1220,1265,2,-3,153,142,1206,1279,T1
2172,May 22,2012,Poland,Latvia,1,0,Friendly,in Austria,5,-5,1715,1511,0,1,37,84,1710,1516,T1
2173,May 23,2012,Lesotho,Botswana,0,3,Friendly,in Botswana,-5,5,1144,1359,0,1,168,118,1149,1354,T1
2174,May 23,2012,New Zealand,El Salvador,2,2,Friendly,in the United States,0,0,1556,1569,0,0,73,70,1556,1569,draw
2175,May 23,2012,Iraq,Sierra Leone,1,0,Friendly,in Turkey,3,-3,1593,1305,1,-2,60,131,1590,1308,T1
2176,May 23,2012,Japan,Azerbaijan,2,0,Friendly,in Japan,2,-2,1772,1386,0,0,27,110,1770,1388,T1
2177,May 23,2012,Rwanda,Libya,0,2,Friendly,in Tunisia,-14,14,1451,1508,-1,6,97,85,1465,1494,T1
2178,May 23,2012,Nigeria,Peru,0,1,Friendly,in Peru,-5,5,1643,1722,0,0,51,35,1648,1717,T1
2179,May 23,2012,Venezuela,Moldova,4,0,Friendly,in Venezuela,4,-4,1700,1409,1,0,39,107,1696,1413,T1
2180,May 24,2012,Turkey,Georgia,3,1,Friendly,in Austria,6,-6,1735,1496,0,-1,32,91,1729,1502,T1
2181,May 25,2012,Montenegro,Belgium,2,2,Friendly,in Belgium,4,-4,1646,1684,2,0,51,42,1642,1688,draw
2182,May 25,2012,Costa Rica,Guatemala,3,2,Friendly,in Costa Rica,4,-4,1678,1515,0,0,43,83,1674,1519,T1
2183,May 25,2012,Estonia,Croatia,1,3,Friendly,in Croatia,-2,2,1540,1873,-1,0,78,11,1542,1871,T1
2184,May 25,2012,Senegal,Morocco,1,0,Friendly,in Morocco,13,-13,1539,1531,1,-5,80,81,1526,1544,T2
2185,May 25,2012,Uruguay,Russia,1,1,Friendly,in Russia,-1,1,1986,1838,0,0,5,15,1987,1837,draw
2186,May 26,2012,Niger,Algeria,0,3,Friendly,in Algeria,-5,5,1294,1506,-1,4,134,86,1299,1501,T1
2187,May 26,2012,Denmark,Brazil,1,3,Friendly,in Germany,-6,6,1805,2072,-1,1,18,2,1811,2066,T1
2188,May 26,2012,Benin,Burkina Faso,2,2,Friendly,in Burkina Faso,4,-4,1386,1442,2,-1,110,101,1382,1446,draw
2189,May 26,2012,Guinea,Cameroon,1,2,Friendly,in France,-7,7,1541,1660,-1,3,76,45,1548,1653,T1
2190,May 26,2012,Israel,Czechia,1,2,Friendly,in Austria,-6,6,1653,1804,-4,1,49,20,1659,1798,T1
2191,May 26,2012,El Salvador,Moldova,2,0,Friendly,in the United States,9,-9,1578,1400,3,-1,67,108,1569,1409,T1
2192,May 26,2012,Turkey,Finland,2,3,Friendly,in Austria,-14,14,1721,1615,-4,0,36,58,1735,1601,T1
2193,May 26,2012,Slovenia,Greece,1,1,Friendly,in Austria,4,-4,1656,1776,1,-2,48,27,1652,1780,draw
2194,May 26,2012,Ireland,Bosnia and Herzegovina,1,0,Friendly,in Ireland,5,-5,1805,1687,2,0,18,41,1800,1692,T1
2195,May 26,2012,Jordan,Sierra Leone,4,0,Friendly,in Jordan,4,-4,1563,1301,-1,-1,72,132,1559,1305,T1
2196,May 26,2012,Mozambique,Namibia,0,0,Friendly,in Germany,-1,1,1334,1307,0,1,125,129,1335,1306,draw
2197,May 26,2012,Netherlands,Bulgaria,1,2,Friendly,in the Netherlands,-19,19,2059,1652,-1,6,3,50,2078,1633,T2
2198,May 26,2012,Honduras,New Zealand,0,1,Friendly,in the United States,-13,13,1638,1569,-4,2,54,71,1651,1556,T1
2199,May 26,2012,Norway,England,0,1,Friendly,in Norway,-8,8,1760,1953,-2,0,30,6,1768,1945,T2
2200,May 26,2012,Poland,Slovakia,1,0,Friendly,in Austria,7,-7,1722,1589,4,-2,33,61,1715,1596,T1
2201,May 26,2012,Macedonia,Portugal,0,0,Friendly,in Portugal,9,-9,1495,1889,2,0,92,9,1486,1898,draw
2202,May 26,2012,Spain,Serbia,2,0,Friendly,in Switzerland,3,-3,2122,1722,0,1,1,33,2119,1725,T1
2203,May 26,2012,Germany,Switzerland,3,5,Friendly,in Switzerland,-23,23,2041,1778,0,4,4,25,2064,1755,T1
2204,May 26,2012,Malawi,Tanzania,0,0,Friendly,in Tanzania,-1,1,1379,1263,0,0,113,144,1380,1262,draw
2205,May 26,2012,United States,Scotland,5,1,Friendly,in the United States,11,-11,1761,1694,1,-2,29,40,1750,1705,T1
2206,May 27,2012,Albania,Iran,1,0,Friendly,in Turkey,16,-16,1503,1711,3,-5,91,37,1487,1727,T1
2207,May 27,2012,Iceland,France,2,3,Friendly,in France,-1,1,1436,1858,0,-1,102,14,1437,1857,T1
2208,May 27,2012,Mali,Ivory Coast,1,2,Friendly,in France,-5,5,1584,1807,-4,3,65,18,1589,1802,T1
2209,May 27,2012,Jamaica,Panama,0,1,Friendly,in Jamaica,-13,13,1644,1670,-5,1,51,45,1657,1657,T2
2210,May 27,2012,Chad,Libya,0,1,Friendly,in Tunisia,-4,4,1240,1512,0,1,146,84,1244,1508,T1
2211,May 27,2012,Mexico,Wales,2,0,Friendly,in the United States,7,-7,1863,1630,1,-1,13,56,1856,1637,T1
2212,May 27,2012,Lebanon,Oman,1,1,Friendly,in Oman,8,-8,1315,1549,1,-1,128,74,1307,1557,draw
2213,May 27,2012,Rwanda,Tunisia,1,5,Friendly,in Tunisia,-8,8,1443,1591,-2,5,99,60,1451,1583,T1
2214,May 28,2012,Botswana,Iraq,1,1,Friendly,in Turkey,6,-6,1365,1587,1,-3,117,62,1359,1593,draw
2215,May 28,2012,Guyana,Colombia,1,7,Friendly,in Colombia,-2,2,1368,1790,0,0,116,22,1370,1788,T1
2216,May 28,2012,Qatar,Palestine,0,0,Friendly,in Qatar,-8,8,1498,1228,-5,4,91,149,1506,1220,draw
2217,May 28,2012,Ukraine,Estonia,4,0,Friendly,in Austria,8,-8,1785,1532,3,-2,23,80,1777,1540,T1
2218,May 28,2012,Malawi,Zanzibar,1,1,Friendly,in Zanzibar,1,-1,1380,1325,0,0,113,127,1379,1326,draw
2219,May 29,2012,Macedonia,Angola,0,0,Friendly,in Portugal,0,0,1495,1506,0,-1,93,87,1495,1506,draw
2220,May 29,2012,Russia,Lithuania,0,0,Friendly,in Switzerland,-7,7,1831,1511,0,3,15,85,1838,1504,draw
2221,May 29,2012,Bulgaria,Turkey,0,2,Friendly,in Austria,-12,12,1640,1733,-4,3,53,32,1652,1721,T1
2222,May 30,2012,Andorra,Azerbaijan,0,0,Friendly,in Germany,8,-8,1006,1378,0,-4,188,114,998,1386,draw
2223,May 30,2012,Chad,Rwanda,1,1,Friendly,in Tunisia,5,-5,1245,1438,0,-2,146,101,1240,1443,draw
2224,May 30,2012,Netherlands,Slovakia,2,0,Friendly,in the Netherlands,1,-1,2060,1588,0,0,3,61,2059,1589,T1
2225,May 30,2012,South Korea,Spain,1,4,Friendly,in Switzerland,-4,4,1778,2126,0,0,25,1,1782,2122,T1
2226,May 30,2012,Sweden,Iceland,3,2,Friendly,in Sweden,1,-1,1888,1435,0,0,10,102,1887,1436,T1
2227,May 30,2012,Switzerland,Romania,0,1,Friendly,in Switzerland,-14,14,1764,1730,-2,3,28,33,1778,1716,T2
2228,May 30,2012,United States,Brazil,1,4,Friendly,in the United States,-8,8,1753,2080,-1,0,30,2,1761,2072,T2
2229,May 31,2012,France,Serbia,2,0,Friendly,in France,6,-6,1864,1716,0,-2,14,36,1858,1722,T1
2230,May 31,2012,Germany,Israel,2,0,Friendly,in Germany,2,-2,2043,1651,0,0,4,48,2041,1653,T1
2231,May 31,2012,Greece,Armenia,1,0,Friendly,in Austria,4,-4,1780,1537,1,-3,25,79,1776,1541,T1
2232,May 31,2012,Bosnia and Herzegovina,Mexico,1,2,Friendly,in the United States,-5,5,1682,1868,-1,0,42,13,1687,1863,T1
2233,June 1,2012,Ukraine,Austria,2,3,Friendly,in Austria,-13,13,1772,1604,-3,0,26,59,1785,1591,T1
2234,June 1,2012,Czechia,Hungary,1,2,Friendly,in Czechia,-16,16,1788,1689,-1,3,22,41,1804,1673,T2
2235,June 1,2012,Mozambique,Egypt,0,2,World Cup qualifier,in Egypt,-3,3,1331,1751,-1,0,126,31,1334,1748,T1
2236,June 1,2012,Finland,Estonia,2,1,Baltic Cup,in Estonia,16,-16,1631,1516,2,-4,56,84,1615,1532,T2
2237,June 1,2012,Ghana,Lesotho,7,0,World Cup qualifier,in Ghana,2,-2,1700,1142,1,-1,38,169,1698,1144,T1
2238,June 1,2012,Costa Rica,Guatemala,0,1,Friendly,in Guatemala,-12,12,1666,1527,-2,1,45,82,1678,1515,T1
2239,June 1,2012,Hong Kong,Singapore,1,0,Friendly,in Hong Kong,9,-9,1211,1256,3,-2,154,144,1202,1265,T1
2240,June 1,2012,Kazakhstan,Kyrgyzstan,5,2,Friendly,in Kazakhstan,5,-5,1351,1123,3,-1,120,174,1346,1128,T1
2241,June 1,2012,Latvia,Lithuania,5,0,Baltic Cup,in Estonia,30,-30,1541,1481,9,-9,76,94,1511,1511,T1
2242,June 1,2012,Malaysia,Philippines,0,0,Friendly,in Malaysia,-5,5,1205,1125,-2,2,156,173,1210,1120,draw
2243,June 1,2012,Vanuatu,New Caledonia,2,5,World Cup qualifier and Oceania Cup,in the Solomon Islands,-37,37,1213,1339,-8,7,153,124,1250,1302,T1
2244,June 1,2012,Jamaica,Panama,1,2,Friendly,in Panama,-7,7,1637,1677,-4,1,54,44,1644,1670,T1
2245,June 1,2012,Nicaragua,Puerto Rico,1,3,Friendly,in Puerto Rico,-14,14,1119,1078,-5,2,175,179,1133,1064,T1
2246,June 1,2012,Italy,Russia,0,3,Friendly,in Switzerland,-19,19,1851,1850,-2,0,14,15,1870,1831,T1
2247,June 1,2012,Tahiti,Samoa,10,1,World Cup qualifier and Oceania Cup,in the Solomon Islands,7,-7,1182,690,0,-1,160,217,1175,697,T1
2248,June 2,2012,Algeria,Rwanda,4,0,World Cup qualifier,in Algeria,21,-21,1527,1417,5,-3,81,104,1506,1438,T1
2249,June 2,2012,Argentina,Ecuador,4,0,World Cup qualifier,in Argentina,15,-15,1943,1769,0,-4,7,27,1928,1784,T1
2250,June 2,2012,Bolivia,Chile,0,2,World Cup qualifier,in Bolivia,-11,11,1529,1911,-2,0,80,8,1540,1900,T2
2251,June 2,2012,Congo,Burkina Faso,0,0,World Cup qualifier,in Burkina Faso,8,-8,1403,1434,2,-2,107,102,1395,1442,draw
2252,June 2,2012,Cameroon,Democratic Republic of Congo,1,0,World Cup qualifier,in Cameroon,6,-6,1666,1443,1,-1,45,99,1660,1449,T1
2253,June 2,2012,Central African Republic,Botswana,2,0,World Cup qualifier,in Central African Republic,32,-32,1269,1333,5,-8,141,125,1237,1365,T1
2254,June 2,2012,Australia,Denmark,0,2,Friendly,in Denmark,-12,12,1813,1817,-1,3,17,16,1825,1805,T1
2255,June 2,2012,Belgium,England,0,1,Friendly,in England,-2,2,1682,1955,0,0,42,6,1684,1953,T1
2256,June 2,2012,Gambia,Morocco,1,1,World Cup qualifier,in The Gambia,4,-4,1361,1527,2,0,117,81,1357,1531,draw
2257,June 2,2012,Honduras,El Salvador,3,0,Friendly,in the United States,15,-15,1653,1563,5,-4,48,71,1638,1578,T1
2258,June 2,2012,Ivory Coast,Tanzania,2,0,World Cup qualifier,in Ivory Coast,1,-1,1808,1262,-1,0,19,143,1807,1263,T1
2259,June 2,2012,Kenya,Malawi,0,0,World Cup qualifier,in Kenya,-3,3,1336,1383,0,0,124,112,1339,1380,draw
2260,June 2,2012,Luxembourg,Malta,0,2,Friendly,in Luxembourg,-17,17,1150,1238,-5,5,167,147,1167,1221,T2
2261,June 2,2012,Northern Ireland,Netherlands,0,6,Friendly,in the Netherlands,-1,1,1449,2061,-1,0,98,3,1450,2060,T1
2262,June 2,2012,Fiji,New Zealand,0,1,World Cup qualifier and Oceania Cup,in the Solomon Islands,-9,9,1288,1578,-3,4,136,67,1297,1569,T1
2263,June 2,2012,Norway,Croatia,1,1,Friendly,in Norway,0,0,1760,1873,0,1,29,10,1760,1873,draw
2264,June 2,2012,Poland,Andorra,4,0,Friendly,in Poland,0,0,1722,1006,0,0,34,188,1722,1006,T1
2265,June 2,2012,Turkey,Portugal,3,1,Friendly,in Portugal,24,-24,1757,1865,2,-3,30,12,1733,1889,T2
2266,June 2,2012,Liberia,Senegal,1,3,World Cup qualifier,in Senegal,-6,6,1260,1545,-3,4,144,75,1266,1539,T1
2267,June 2,2012,Cape Verde,Sierra Leone,1,2,World Cup qualifier,in Sierra Leone,-21,21,1404,1322,-3,3,106,129,1425,1301,T1
2268,June 2,2012,Papua New Guinea,Solomon Islands,0,1,World Cup qualifier and Oceania Cup,in the Solomon Islands,-7,7,1052,1293,0,3,182,134,1059,1286,T1
2269,June 2,2012,Zambia,Sudan,0,2,World Cup qualifier,in Sudan,-40,40,1603,1465,-9,7,59,96,1643,1425,T1
2270,June 2,2012,Tunisia,Equatorial Guinea,3,1,World Cup qualifier,in Tunisia,5,-5,1596,1281,0,-1,60,138,1591,1286,T1
2271,June 2,2012,Venezuela,Uruguay,1,1,World Cup qualifier,in Uruguay,16,-16,1716,1970,2,0,36,5,1700,1986,draw
2272,June 3,2012,Angola,Uganda,1,1,World Cup qualifier,in Angola,-6,6,1500,1510,-3,1,90,87,1506,1504,draw
2273,June 3,2012,Mali,Benin,0,1,World Cup qualifier,in Benin,-25,25,1559,1411,-6,4,71,106,1584,1386,T1
2274,June 3,2012,United States,Canada,0,0,Friendly,in Canada,-2,2,1751,1579,0,5,31,64,1753,1577,draw
2275,June 3,2012,Lithuania,Estonia,0,1,Baltic Cup,in Estonia,-9,9,1472,1525,0,1,94,84,1481,1516,T1
2276,June 3,2012,Finland,Latvia,1,1,Baltic Cup,in Estonia,-4,4,1627,1545,-1,2,56,75,1631,1541,draw
2277,June 3,2012,Oman,Japan,0,3,World Cup qualifier,in Japan,-9,9,1540,1781,-4,2,78,23,1549,1772,T1
2278,June 3,2012,Jordan,Iraq,1,1,World Cup qualifier,in Jordan,-4,4,1559,1591,0,1,71,61,1563,1587,draw
2279,June 3,2012,Qatar,Lebanon,1,0,World Cup qualifier,in Lebanon,15,-15,1513,1300,4,-4,86,134,1498,1315,T2
2280,June 3,2012,Mexico,Brazil,2,0,Friendly,in the United States,23,-23,1891,2057,2,-1,9,3,1868,2080,T1
2281,June 3,2012,Niger,Gabon,0,0,World Cup qualifier,in Niger,10,-10,1304,1573,2,-2,131,68,1294,1583,draw
2282,June 3,2012,Nigeria,Namibia,1,0,World Cup qualifier,in Nigeria,3,-3,1646,1304,1,1,50,131,1643,1307,T1
2283,June 3,2012,Peru,Colombia,0,1,World Cup qualifier,in Peru,-22,22,1700,1812,-4,3,38,18,1722,1790,T2
2284,June 3,2012,Nicaragua,Puerto Rico,1,1,Friendly,in Puerto Rico,2,-2,1121,1076,0,-1,175,180,1119,1078,draw
2285,June 3,2012,Ethiopia,South Africa,1,1,World Cup qualifier,in South Africa,16,-16,1305,1570,5,-6,130,69,1289,1586,draw
2286,June 3,2012,China,Spain,0,1,Friendly,in Spain,-1,1,1636,2127,-1,0,54,1,1637,2126,T1
2287,June 3,2012,Tahiti,New Caledonia,4,3,World Cup qualifier and Oceania Cup,in the Solomon Islands,36,-36,1218,1303,7,-10,153,133,1182,1339,T1
2288,June 3,2012,Togo,Libya,1,1,World Cup qualifier,in Togo,3,-3,1363,1509,1,-2,117,88,1360,1512,draw
2289,June 3,2012,Uzbekistan,Iran,0,1,World Cup qualifier,in Uzbekistan,-21,21,1606,1732,0,5,57,33,1627,1711,T2
2290,June 3,2012,Samoa,Vanuatu,0,5,World Cup qualifier and Oceania Cup,in the Solomon Islands,-5,5,685,1218,-1,0,218,153,690,1213,T1
2291,June 3,2012,Guinea,Zimbabwe,1,0,World Cup qualifier,in Zimbabwe,15,-15,1556,1335,4,-2,73,123,1541,1350,T2
2292,June 4,2012,Ireland,Hungary,0,0,Friendly,in Hungary,0,0,1805,1689,0,0,21,41,1805,1689,draw
2293,June 4,2012,Kurdistan,Western Sahara,6,0,VIVA World Cup,in Kurdistan,4,-4,1406,996,2,0,107,189,1402,1000,T1
2294,June 4,2012,New Zealand,Papua New Guinea,2,1,World Cup qualifier and Oceania Cup,in the Solomon Islands,2,-2,1580,1050,1,0,64,182,1578,1052,T1
2295,June 4,2012,Solomon Islands,Fiji,0,0,World Cup qualifier and Oceania Cup,in the Solomon Islands,-7,7,1286,1295,-2,1,137,135,1293,1288,draw
2296,June 5,2012,Armenia,Kazakhstan,3,0,Friendly,in Armenia,6,-6,1543,1345,2,-2,77,121,1537,1351,T1
2297,June 5,2012,Romania,Austria,0,0,Friendly,in Austria,-1,1,1729,1605,0,0,34,58,1730,1604,draw
2298,June 5,2012,France,Estonia,4,0,Friendly,in France,3,-3,1867,1522,1,-1,12,85,1864,1525,T1
2299,June 5,2012,New Caledonia,Samoa,9,0,World Cup qualifier and Oceania Cup,in the Solomon Islands,3,-3,1306,682,3,-1,130,220,1303,685,T1
2300,June 5,2012,Indonesia,Philippines,2,2,Friendly,in the Philippines,-1,1,1264,1126,0,1,142,172,1265,1125,draw
2301,June 5,2012,Serbia,Sweden,1,2,Friendly,in Sweden,-3,3,1713,1891,-1,1,37,9,1716,1888,T1
2302,June 5,2012,Vanuatu,Tahiti,1,4,World Cup qualifier and Oceania Cup,in the Solomon Islands,-44,44,1174,1262,-7,10,160,143,1218,1218,T1
2303,June 5,2012,Turkey,Ukraine,2,0,Friendly,in Germany,16,-16,1773,1756,4,-4,26,30,1757,1772,T1
2304,June 6,2012,Papua New Guinea,Fiji,1,1,World Cup qualifier and Oceania Cup,in the Solomon Islands,15,-15,1065,1280,1,-3,181,138,1050,1295,draw
2305,June 6,2012,Solomon Islands,New Zealand,1,1,World Cup qualifier and Oceania Cup,in the Solomon Islands,13,-13,1299,1567,2,-5,135,69,1286,1580,draw
2306,June 7,2012,Belarus,Lithuania,1,1,Friendly,in Belarus,-5,5,1581,1477,0,0,63,94,1586,1472,draw
2307,June 8,2012,Bahrain,Kuwait,1,1,Friendly,in Egypt,-2,2,1576,1526,0,2,65,82,1578,1524,draw
2308,June 8,2012,China,Vietnam,3,0,Friendly,in China,2,-2,1638,1273,1,0,53,139,1636,1275,T1
2309,June 8,2012,Costa Rica,El Salvador,2,2,World Cup qualifier,in Costa Rica,-11,11,1655,1574,-2,4,47,66,1666,1563,draw
2310,June 8,2012,Canada,Cuba,1,0,World Cup qualifier,in Cuba,15,-15,1594,1371,3,-4,61,115,1579,1386,T2
2311,June 8,2012,Honduras,Panama,0,2,World Cup qualifier,in Honduras,-36,36,1617,1713,-8,7,56,37,1653,1677,T2
2312,June 8,2012,Guatemala,Jamaica,1,2,World Cup qualifier,in Jamaica,-9,9,1518,1646,-3,4,84,49,1527,1637,T1
2313,June 8,2012,Japan,Jordan,6,0,World Cup qualifier,in Japan,12,-12,1793,1547,0,-3,23,74,1781,1559,T1
2314,June 8,2012,Lebanon,Uzbekistan,1,1,World Cup qualifier,in Lebanon,11,-11,1311,1595,5,-3,129,60,1300,1606,draw
2315,June 8,2012,Guyana,Mexico,1,3,World Cup qualifier,in Mexico,-2,2,1366,1893,-1,0,117,9,1368,1891,T1
2316,June 8,2012,New Caledonia,New Zealand,2,0,Oceania Nations Cup,in the Solomon Islands,61,-61,1367,1506,14,-18,116,87,1306,1567,T1
2317,June 8,2012,Northern Cyprus,Zanzibar,2,0,VIVA World Cup,in Kurdistan,19,-19,1473,1306,2,-4,95,131,1454,1325,T1
2318,June 8,2012,Oman,Australia,0,0,World Cup qualifier,in Oman,9,-9,1549,1804,6,-4,73,21,1540,1813,draw
2319,June 8,2012,Poland,Greece,1,1,European Championship,in Poland,-3,3,1719,1783,0,0,35,24,1722,1780,draw
2320,June 8,2012,South Korea,Qatar,4,1,World Cup qualifier,in Qatar,20,-20,1798,1493,3,-6,22,92,1778,1513,T2
2321,June 8,2012,Czechia,Russia,1,4,European Championship,in Poland,-36,36,1752,1886,-9,4,31,11,1788,1850,T1
2322,June 8,2012,Malaysia,Singapore,2,2,Friendly,in Singapore,4,-4,1209,1252,1,0,155,146,1205,1256,draw
2323,June 8,2012,Tahiti,Solomon Islands,1,0,Oceania Nations Cup,in the Solomon Islands,34,-34,1296,1265,8,-7,135,142,1262,1299,T2
2324,June 8,2012,Antigua and Barbuda,United States,1,3,World Cup qualifier,in the United States,-2,2,1285,1753,0,1,136,30,1287,1751,T1
2325,June 9,2012,Brazil,Argentina,3,4,Friendly,in the United States,-13,13,2044,1956,0,1,3,6,2057,1943,T1
2326,June 9,2012,Bolivia,Paraguay,3,1,World Cup qualifier,in Bolivia,44,-44,1573,1765,10,-8,69,26,1529,1809,T1
2327,June 9,2012,South Africa,Botswana,1,1,World Cup qualifier,in Botswana,-8,8,1562,1341,-1,2,70,123,1570,1333,draw
2328,June 9,2012,Cape Verde,Tunisia,1,2,World Cup qualifier,in Cape Verde,-15,15,1389,1611,-3,1,111,58,1404,1596,T2
2329,June 9,2012,Niger,Congo,0,1,World Cup qualifier,in Congo,-10,10,1294,1413,-2,2,135,107,1304,1403,T1
2330,June 9,2012,Denmark,Netherlands,1,0,European Championship,in Ukraine,40,-40,1857,2021,2,-2,14,4,1817,2061,T1
2331,June 9,2012,Equatorial Guinea,Sierra Leone,2,2,World Cup qualifier,in Equatorial Guinea,-3,3,1278,1325,-1,1,138,127,1281,1322,draw
2332,June 9,2012,French Guiana,Suriname,2,1,Friendly,in French Guiana,7,-7,1199,1194,1,-1,158,159,1192,1201,T1
2333,June 9,2012,Gabon,Burkina Faso,1,0,World Cup qualifier,in Gabon,8,-8,1581,1426,4,0,64,102,1573,1434,T1
2334,June 9,2012,Portugal,Germany,0,1,European Championship,in Ukraine,-13,13,1852,2056,-1,2,15,2,1865,2043,T1
2335,June 9,2012,Kurdistan,Northern Cyprus,2,1,VIVA World Cup,in Kurdistan,18,-18,1424,1455,4,-2,103,97,1406,1473,T1
2336,June 9,2012,Nigeria,Malawi,1,1,World Cup qualifier,in Malawi,-9,9,1637,1392,-4,1,53,110,1646,1383,draw
2337,June 9,2012,Ivory Coast,Morocco,2,2,World Cup qualifier,in Morocco,-10,10,1798,1537,-1,0,20,80,1808,1527,draw
2338,June 9,2012,Namibia,Kenya,1,0,World Cup qualifier,in Namibia,16,-16,1320,1320,5,-5,128,128,1304,1336,T1
2339,June 9,2012,Uganda,Senegal,1,1,World Cup qualifier,in Uganda,-4,4,1506,1549,-1,1,86,74,1510,1545,draw
2340,June 9,2012,Chile,Venezuela,2,0,World Cup qualifier,in Venezuela,22,-22,1933,1694,0,-3,8,39,1911,1716,T2
2341,June 9,2012,Zambia,Ghana,1,0,World Cup qualifier,in Zambia,20,-20,1623,1680,2,-5,56,44,1603,1700,T1
2342,June 10,2012,Croatia,Ireland,3,1,European Championship,in Poland,30,-30,1903,1775,3,-6,9,24,1873,1805,T1
2343,June 10,2012,Democratic Republic of Congo,Togo,2,0,World Cup qualifier,in the Democratic Republic of the Congo,16,-16,1459,1347,3,0,96,118,1443,1363,T1
2344,June 10,2012,Ecuador,Colombia,1,0,World Cup qualifier,in Ecuador,17,-17,1786,1795,3,-3,22,20,1769,1812,T1
2345,June 10,2012,Central African Republic,Ethiopia,0,2,World Cup qualifier,in Ethiopia,-19,19,1250,1324,-4,4,145,129,1269,1305,T1
2346,June 10,2012,Guinea,Egypt,2,3,World Cup qualifier,in Guinea,-15,15,1541,1766,-7,6,79,26,1556,1751,T2
2347,June 10,2012,Hong Kong,Vietnam,1,2,Friendly,in Hong Kong,-11,11,1200,1284,-3,2,157,137,1211,1273,T2
2348,June 10,2012,Spain,Italy,1,1,European Championship,in Poland,-17,17,2110,1868,0,3,1,13,2127,1851,draw
2349,June 10,2012,Sudan,Lesotho,0,0,World Cup qualifier,in Lesotho,-11,11,1454,1153,-2,3,98,166,1465,1142,draw
2350,June 10,2012,Liberia,Angola,0,0,World Cup qualifier,in Liberia,8,-8,1268,1492,3,-3,142,92,1260,1500,draw
2351,June 10,2012,Cameroon,Libya,1,2,World Cup qualifier,in Tunisia,-28,28,1638,1537,-6,5,51,80,1666,1509,T1
2352,June 10,2012,Algeria,Mali,1,2,World Cup qualifier,in Burkina Faso,-18,18,1509,1577,-5,5,86,66,1527,1559,T1
2353,June 10,2012,Zimbabwe,Mozambique,0,0,World Cup qualifier,in Mozambique,5,-5,1340,1326,1,-1,123,126,1335,1331,draw
2354,June 10,2012,Rwanda,Benin,1,1,World Cup qualifier,in Rwanda,-6,6,1411,1417,-3,3,108,105,1417,1411,draw
2355,June 10,2012,New Zealand,Solomon Islands,4,3,Oceania Nations Cup,in the Solomon Islands,15,-15,1521,1250,2,-3,84,145,1506,1265,T2
2356,June 10,2012,Tahiti,New Caledonia,1,0,Oceania Nations Cup,in the Solomon Islands,30,-30,1326,1337,8,-8,126,124,1296,1367,T1
2357,June 10,2012,Gambia,Tanzania,1,2,World Cup qualifier,in Tanzania,-20,20,1341,1282,-2,6,121,138,1361,1262,T1
2358,June 10,2012,Peru,Uruguay,2,4,World Cup qualifier,in Uruguay,-6,6,1694,1976,0,0,38,5,1700,1970,T1
2359,June 11,2012,France,England,1,1,European Championship,in Ukraine,6,-6,1873,1949,2,0,12,7,1867,1955,draw
2360,June 11,2012,Sweden,Ukraine,1,2,European Championship,in Ukraine,-28,28,1863,1784,-3,7,14,23,1891,1756,T1
2361,June 12,2012,Jamaica,Antigua and Barbuda,0,0,World Cup qualifier,in Antigua and Barbuda,-13,13,1633,1298,-5,1,53,135,1646,1285,draw
2362,June 12,2012,Australia,Japan,1,1,World Cup qualifier,in Australia,-6,6,1798,1799,-2,3,19,18,1804,1793,draw
2363,June 12,2012,Honduras,Canada,0,0,World Cup qualifier,in Canada,4,-4,1621,1590,0,0,57,61,1617,1594,draw
2364,June 12,2012,Greece,Czechia,1,2,European Championship,in Poland,-27,27,1756,1779,-7,8,31,24,1783,1752,T1
2365,June 12,2012,Mexico,El Salvador,2,1,World Cup qualifier,in El Salvador,9,-9,1902,1565,0,-1,10,69,1893,1574,T2
2366,June 12,2012,United States,Guatemala,1,1,World Cup qualifier,in Guatemala,-7,7,1746,1525,-1,2,32,83,1753,1518,draw
2367,June 12,2012,Guyana,Costa Rica,0,4,World Cup qualifier,in Guyana,-19,19,1347,1674,-1,1,117,45,1366,1655,T2
2368,June 12,2012,Iran,Qatar,0,0,World Cup qualifier,in Iran,-15,15,1717,1508,-2,4,35,87,1732,1493,draw
2369,June 12,2012,Oman,Iraq,1,1,World Cup qualifier,in Qatar,2,-2,1551,1589,1,0,72,62,1549,1591,draw
2370,June 12,2012,Bahrain,Kuwait,0,1,Friendly,in Egypt,-11,11,1565,1537,-2,2,69,80,1576,1526,T1
2371,June 12,2012,Singapore,Malaysia,0,2,Friendly,in Malaysia,-13,13,1239,1222,-3,0,147,154,1252,1209,T1
2372,June 12,2012,Cuba,Panama,0,1,World Cup qualifier,in Panama,-3,3,1368,1716,0,0,115,36,1371,1713,T1
2373,June 12,2012,Philippines,Guam,3,0,Friendly,in the Philippines,1,-1,1127,613,0,0,172,225,1126,614,T1
2374,June 12,2012,Poland,Russia,1,1,European Championship,in Poland,5,-5,1724,1881,1,0,34,11,1719,1886,draw
2375,June 12,2012,South Korea,Lebanon,3,0,World Cup qualifier,in South Korea,2,-2,1800,1309,1,0,17,132,1798,1311,T1
2376,June 13,2012,Netherlands,Germany,1,2,European Championship,in Ukraine,-22,22,1999,2078,0,0,4,2,2021,2056,T1
2377,June 13,2012,Denmark,Portugal,2,3,European Championship,in Ukraine,-25,25,1832,1877,-1,4,16,12,1857,1852,T1
2378,June 14,2012,Italy,Croatia,1,1,European Championship,in Poland,3,-3,1871,1900,0,-1,14,10,1868,1903,draw
2379,June 14,2012,Spain,Ireland,4,0,European Championship,in Poland,12,-12,2122,1763,0,-4,1,29,2110,1775,T1
2380,June 15,2012,Algeria,Gambia,4,1,African Nations Cup qualifier,in Algeria,12,-12,1521,1329,1,-4,85,125,1509,1341,T1
2381,June 15,2012,Egypt,Central African Republic,2,3,African Nations Cup qualifier,in Egypt,-39,39,1727,1289,-7,7,33,137,1766,1250,T2
2382,June 15,2012,England,Sweden,3,2,European Championship,in Ukraine,19,-19,1968,1844,1,0,6,15,1949,1863,T1
2383,June 15,2012,South Africa,Gabon,3,0,Friendly,in South Africa,13,-13,1575,1568,5,-5,66,69,1562,1581,T1
2384,June 15,2012,France,Ukraine,2,0,European Championship,in Ukraine,39,-39,1912,1745,4,-8,9,31,1873,1784,T2
2385,June 16,2012,Cameroon,Guinea-Bissau,1,0,African Nations Cup qualifier,in Cameroon,2,-2,1640,1222,0,-1,50,153,1638,1224,T1
2386,June 16,2012,Cape Verde,Madagascar,3,1,African Nations Cup qualifier,in Cape Verde,8,-8,1397,1164,1,-2,110,163,1389,1172,T1
2387,June 16,2012,Greece,Russia,1,0,European Championship,in Poland,34,-34,1790,1847,6,-2,23,14,1756,1881,T1
2388,June 16,2012,Chad,Malawi,0,2,African Nations Cup qualifier,in Malawi,-12,12,1233,1404,-2,3,148,107,1245,1392,T1
2389,June 16,2012,Namibia,Liberia,0,0,African Nations Cup qualifier,in Namibia,-8,8,1312,1276,-1,1,131,142,1320,1268,draw
2390,June 16,2012,Rwanda,Nigeria,0,2,African Nations Cup qualifier,in Nigeria,-8,8,1403,1645,0,3,108,49,1411,1637,T1
2391,June 16,2012,Poland,Czechia,0,1,European Championship,in Poland,-28,28,1696,1807,-3,6,37,17,1724,1779,T2
2392,June 16,2012,São Tomé and Príncipe,Sierra Leone,2,4,African Nations Cup qualifier,in Sierra Leone,-9,9,1104,1334,0,4,177,124,1113,1325,T1
2393,June 16,2012,Congo,Uganda,0,4,African Nations Cup qualifier,in Uganda,-19,19,1394,1525,-4,5,111,83,1413,1506,T1
2394,June 17,2012,Benin,Ethiopia,1,1,African Nations Cup qualifier,in Benin,-10,10,1407,1334,-1,5,106,124,1417,1324,draw
2395,June 17,2012,Seychelles,Democratic Republic of Congo,0,3,African Nations Cup qualifier,in the Democratic Republic of the Congo,-3,3,1010,1462,-1,0,186,96,1013,1459,T1
2396,June 17,2012,Germany,Denmark,2,1,European Championship,in Ukraine,10,-10,2088,1822,0,0,2,16,2078,1832,T1
2397,June 17,2012,Mozambique,Tanzania,1,1,African Nations Cup qualifier,in Mozambique,-8,8,1318,1290,-2,2,129,137,1326,1282,draw
2398,June 17,2012,Netherlands,Portugal,1,2,European Championship,in Ukraine,-33,33,1966,1910,-2,2,6,10,1999,1877,T1
2399,June 17,2012,Kenya,Togo,0,1,African Nations Cup qualifier,in Togo,-13,13,1307,1360,-3,1,133,116,1320,1347,T1
2400,June 17,2012,Burundi,Zimbabwe,0,1,African Nations Cup qualifier,in Zimbabwe,-11,11,1259,1351,-1,5,144,117,1270,1340,T1
2401,June 18,2012,Italy,Ireland,2,0,European Championship,in Poland,26,-26,1897,1737,1,-3,12,31,1871,1763,T1
2402,June 18,2012,Spain,Croatia,1,0,European Championship,in Poland,11,-11,2133,1889,0,-1,1,13,2122,1900,T1
2403,June 18,2012,Palestine,Yemen,2,1,Friendly,in Yemen,15,-15,1243,1294,4,-4,146,135,1228,1309,T2
2404,June 19,2012,Sweden,France,2,0,European Championship,in Ukraine,45,-45,1889,1867,3,-5,12,14,1844,1912,T1
2405,June 19,2012,Ukraine,England,0,1,European Championship,in Ukraine,-17,17,1728,1985,-2,1,32,4,1745,1968,T2
2406,June 21,2012,Czechia,Portugal,0,1,European Championship,in Poland,-18,18,1789,1928,-6,0,23,9,1807,1910,T1
2407,June 22,2012,Greece,Germany,2,4,European Championship,in Poland,-11,11,1779,2099,-2,0,24,2,1790,2088,T1
2408,June 22,2012,Saudi Arabia,Kuwait,4,0,Arab Nations Cup,in Saudi Arabia,26,-26,1576,1511,7,-7,66,87,1550,1537,T1
2409,June 23,2012,Libya,Yemen,3,1,Arab Nations Cup,in Saudi Arabia,12,-12,1549,1282,6,-4,74,139,1537,1294,T1
2410,June 23,2012,Bahrain,Morocco,0,4,Arab Nations Cup,in Saudi Arabia,-41,41,1524,1578,-12,15,83,65,1565,1537,T1
2411,June 23,2012,Spain,France,2,0,European Championship,in Ukraine,13,-13,2146,1854,0,0,1,14,2133,1867,T1
2412,June 23,2012,Mozambique,Vietnam,0,1,Friendly,in Vietnam,-8,8,1310,1292,-1,3,130,136,1318,1284,T1
2413,June 24,2012,Italy,England,0,0,European Championship,in Ukraine,6,-6,1903,1979,1,0,10,4,1897,1985,draw
2414,June 24,2012,Lebanon,Iraq,0,1,Arab Nations Cup,in Saudi Arabia,-7,7,1302,1596,-2,2,133,60,1309,1589,T1
2415,June 25,2012,Kuwait,Palestine,2,0,Arab Nations Cup,in Saudi Arabia,11,-11,1522,1232,3,-3,84,149,1511,1243,T1
2416,June 26,2012,Libya,Morocco,0,0,Arab Nations Cup,in Saudi Arabia,2,-2,1551,1576,1,-1,73,66,1549,1578,draw
2417,June 26,2012,Yemen,Bahrain,2,0,Arab Nations Cup,in Saudi Arabia,48,-48,1330,1476,12,-11,127,94,1282,1524,T1
2418,June 27,2012,Spain,Portugal,0,0,European Championship,in Ukraine,-14,14,2132,1942,0,1,1,8,2146,1928,draw
2419,June 27,2012,Sudan,Lebanon,2,0,Arab Nations Cup,in Saudi Arabia,18,-18,1472,1284,3,-5,95,139,1454,1302,T1
2420,June 28,2012,Germany,Italy,1,2,European Championship,in Poland,-38,38,2061,1941,0,1,2,9,2099,1903,T1
2421,June 28,2012,Palestine,Saudi Arabia,2,2,Arab Nations Cup,in Saudi Arabia,17,-17,1249,1559,3,-6,146,72,1232,1576,draw
2422,June 29,2012,Bahrain,Libya,1,2,Arab Nations Cup,in Saudi Arabia,-16,16,1460,1567,-3,2,97,71,1476,1551,T1
2423,June 29,2012,Yemen,Morocco,0,4,Arab Nations Cup,in Saudi Arabia,-15,15,1315,1591,-2,4,129,62,1330,1576,T1
2424,June 30,2012,Egypt,Central African Republic,1,1,African Nations Cup qualifier,in Central African Republic,-15,15,1712,1304,-3,4,36,134,1727,1289,draw
2425,June 30,2012,Iraq,Sudan,1,1,Arab Nations Cup,in Saudi Arabia,-7,7,1589,1479,-3,1,63,93,1596,1472,draw
2426,July 1,2012,Italy,Spain,0,4,European Championship,in Ukraine,-23,23,1918,2155,-1,0,10,1,1941,2132,T1
2427,July 3,2012,Iraq,Morocco,1,2,Arab Nations Cup,in Saudi Arabia,-20,20,1569,1611,-7,3,70,58,1589,1591,T1
2428,July 3,2012,Libya,Saudi Arabia,2,0,Arab Nations Cup,in Saudi Arabia,38,-38,1605,1521,11,-11,60,84,1567,1559,T2
2429,July 5,2012,Saudi Arabia,Iraq,0,1,Arab Nations Cup,in Saudi Arabia,-23,23,1498,1592,-4,7,88,63,1521,1569,T2
2430,July 6,2012,Zambia,Malawi,0,1,Friendly,in Malawi,-13,13,1610,1417,-3,2,59,105,1623,1404,T1
2431,July 6,2012,Morocco,Libya,1,1,Arab Nations Cup,in Saudi Arabia,0,0,1611,1605,1,0,57,60,1611,1605,draw
2432,July 7,2012,British Virgin Islands,Anguilla,1,0,Friendly,in the British Virgin Islands,3,-3,767,566,1,0,211,227,764,569,T1
2433,July 10,2012,South Sudan,Uganda,2,2,Friendly,in South Sudan,7,-7,1107,1518,0,-5,177,85,1100,1525,draw
2434,July 12,2012,Botswana,Kenya,1,3,Friendly,in Kenya,-12,12,1329,1319,-4,3,126,129,1341,1307,T1
2435,July 13,2012,Curaçao,Aruba,2,3,Friendly tournament,in Aruba,-15,15,1050,979,-1,0,183,192,1065,964,T1
2436,July 13,2012,Bonaire,Suriname,0,8,Friendly tournament,in Aruba,-18,18,991,1212,-2,4,190,155,1009,1194,T1
2437,July 15,2012,Aruba,Suriname,1,0,Friendly tournament,in Aruba,20,-20,999,1192,3,-4,189,159,979,1212,T1
2438,July 15,2012,Curaçao,Bonaire,9,2,Friendly tournament,in Aruba,28,-28,1078,963,3,-2,180,192,1050,991,T1
2439,July 16,2012,Zimbabwe,Botswana,0,1,Friendly tournament,in Botswana,-12,12,1339,1341,-5,5,122,121,1351,1329,T1
2440,July 17,2012,Zimbabwe,Lesotho,5,3,Friendly tournament,in Botswana,11,-11,1350,1142,4,-3,118,169,1339,1153,T1
2441,July 18,2012,Lesotho,Botswana,0,0,Friendly tournament,in Botswana,10,-10,1152,1331,2,-3,167,125,1142,1341,draw
2442,July 18,2012,Northern Mariana Islands,Guam,1,3,East Asian Cup qualifier,in Guam,-14,14,485,627,0,0,234,226,499,613,T1
2443,July 20,2012,Northern Mariana Islands,Macao,1,5,East Asian Cup qualifier,in Guam,-20,20,465,680,0,1,234,222,485,660,T1
2444,July 22,2012,Guam,Macao,3,0,East Asian Cup qualifier,in Guam,30,-30,657,650,3,-2,223,224,627,680,T1
2445,August 8,2012,Zambia,Zimbabwe,2,1,Friendly,in Zambia,2,-2,1612,1348,2,0,57,118,1610,1350,T1
2446,August 11,2012,El Salvador,Guatemala,1,0,Friendly,in the United States,9,-9,1574,1516,3,-5,69,85,1565,1525,T1
2447,August 13,2012,Uzbekistan,Jordan,1,0,Friendly,in Jordan,11,-11,1606,1536,2,-4,60,79,1595,1547,T2
2448,August 14,2012,Burkina Faso,Togo,3,0,Friendly,in France,14,-14,1440,1346,1,-4,101,120,1426,1360,T1
2449,August 14,2012,Liechtenstein,Andorra,1,0,Friendly,in Liechtenstein,3,-3,1230,1003,1,0,150,188,1227,1006,T1
2450,August 14,2012,Malta,San Marino,3,2,Friendly,in San Marino,4,-4,1242,891,1,-2,147,204,1238,895,T2
2451,August 15,2012,Moldova,Albania,0,0,Friendly,in Albania,5,-5,1405,1498,1,-2,108,89,1400,1503,draw
2452,August 15,2012,Angola,Mozambique,2,0,Friendly,in Angola,5,-5,1497,1305,0,-1,91,133,1492,1310,T1
2453,August 15,2012,Armenia,Belarus,1,2,Friendly,in Armenia,-12,12,1531,1593,-4,2,80,64,1543,1581,T2
2454,August 15,2012,Austria,Turkey,2,0,Friendly,in Austria,18,-18,1623,1755,6,-3,55,28,1605,1773,T1
2455,August 15,2012,Bahrain,Azerbaijan,0,3,Friendly,in Azerbaijan,-17,17,1443,1395,-2,2,99,111,1460,1378,T1
2456,August 15,2012,Netherlands,Belgium,2,4,Friendly,in Belgium,-22,22,1944,1704,-2,3,8,39,1966,1682,T1
2457,August 15,2012,Guyana,Bolivia,0,2,Friendly,in Bolivia,-4,4,1343,1577,-3,4,121,67,1347,1573,T1
2458,August 15,2012,Tanzania,Botswana,3,3,Friendly,in Botswana,4,-4,1294,1327,1,-2,137,127,1290,1331,draw
2459,August 15,2012,Bulgaria,Cyprus,1,0,Friendly,in Bulgaria,3,-3,1643,1465,0,0,50,95,1640,1468,T1
2460,August 15,2012,Canada,Trinidad and Tobago,2,0,Friendly,in the United States,11,-11,1601,1480,2,0,62,92,1590,1491,T1
2461,August 15,2012,China,Ghana,1,1,Friendly,in China,-2,2,1636,1682,-1,0,53,44,1638,1680,draw
2462,August 15,2012,Costa Rica,Peru,0,1,Friendly,in Costa Rica,-12,12,1662,1706,-1,0,46,38,1674,1694,T2
2463,August 15,2012,Switzerland,Croatia,4,2,Friendly,in Croatia,24,-24,1788,1865,3,-1,24,13,1764,1889,T2
2464,August 15,2012,Denmark,Slovakia,1,3,Friendly,in Denmark,-26,26,1796,1614,-3,8,19,57,1822,1588,T2
2465,August 15,2012,Chile,Ecuador,0,3,Friendly,in the United States,-24,24,1909,1810,-1,7,10,16,1933,1786,T1
2466,August 15,2012,England,Italy,2,1,Friendly,in Switzerland,8,-8,1987,1910,0,1,4,9,1979,1918,T1
2467,August 15,2012,Equatorial Guinea,Liberia,1,0,Friendly,in Equatorial Guinea,7,-7,1285,1269,2,0,139,142,1278,1276,T1
2468,August 15,2012,Estonia,Poland,1,0,Friendly,in Estonia,12,-12,1534,1684,1,-6,79,43,1522,1696,T1
2469,August 15,2012,Uruguay,France,0,0,Friendly,in France,-1,1,1975,1855,-1,0,6,14,1976,1854,draw
2470,August 15,2012,Argentina,Germany,3,1,Friendly,in Germany,23,-23,1979,2038,2,-1,5,3,1956,2061,T2
2471,August 15,2012,Guatemala,Paraguay,3,3,Friendly,in the United States,6,-6,1522,1759,4,-1,81,27,1516,1765,draw
2472,August 15,2012,Hungary,Israel,1,1,Friendly,in Hungary,-4,4,1685,1655,-1,0,42,47,1689,1651,draw
2473,August 15,2012,Faroe Islands,Iceland,0,2,Friendly,in Iceland,-4,4,1219,1439,-2,0,154,102,1223,1435,T1
2474,August 15,2012,Tunisia,Iran,2,2,Friendly,in Hungary,3,-3,1614,1714,1,0,57,33,1611,1717,draw
2475,August 15,2012,El Salvador,Jamaica,0,2,Friendly,in the United States,-12,12,1562,1645,-3,4,72,49,1574,1633,T1
2476,August 15,2012,Venezuela,Japan,1,1,Friendly,in Japan,5,-5,1699,1794,-2,-3,40,21,1694,1799,draw
2477,August 15,2012,Uzbekistan,Jordan,0,2,Friendly,in Jordan,-14,14,1592,1550,-5,4,65,75,1606,1536,T1
2478,August 15,2012,Ethiopia,Libya,1,2,Friendly,in Libya,-2,2,1332,1607,-1,0,124,61,1334,1605,T1
2479,August 15,2012,Luxembourg,Georgia,1,2,Friendly,in Luxembourg,-4,4,1146,1500,0,1,168,88,1150,1496,T2
2480,August 15,2012,Lithuania,Macedonia,0,1,Friendly,in Macedonia,-7,7,1470,1502,0,3,94,87,1477,1495,T1
2481,August 15,2012,Mexico,United States,0,1,Friendly,in Mexico,-16,16,1886,1762,0,3,11,26,1902,1746,T2
2482,August 15,2012,Montenegro,Latvia,2,0,Friendly,in Montenegro,7,-7,1653,1538,0,-3,48,78,1646,1545,T1
2483,August 15,2012,Morocco,Guinea,1,2,Friendly,in Morocco,-15,15,1596,1556,-5,5,63,73,1611,1541,T2
2484,August 15,2012,Niger,Nigeria,0,0,Friendly,in Niger,6,-6,1300,1639,1,-3,135,52,1294,1645,draw
2485,August 15,2012,Greece,Norway,3,2,Friendly,in Norway,12,-12,1791,1748,2,-1,22,29,1779,1760,T2
2486,August 15,2012,Finland,Northern Ireland,3,3,Friendly,in Northern Ireland,-2,2,1625,1451,1,1,54,98,1627,1449,draw
2487,August 15,2012,Oman,Egypt,1,1,Friendly,in Oman,2,-2,1553,1710,-1,0,74,36,1551,1712,draw
2488,August 15,2012,Panama,Portugal,0,2,Friendly,in Portugal,-4,4,1712,1946,0,1,34,7,1716,1942,T1
2489,August 15,2012,Puerto Rico,Spain,1,2,Friendly,in Puerto Rico,0,0,1076,2155,0,0,182,1,1076,2155,T2
2490,August 15,2012,Ivory Coast,Russia,1,1,Friendly,in Russia,4,-4,1802,1843,1,0,18,15,1798,1847,draw
2491,August 15,2012,Australia,Scotland,1,3,Friendly,in Scotland,-15,15,1783,1709,-6,1,25,37,1798,1694,T1
2492,August 15,2012,Ireland,Serbia,0,0,Friendly,in Serbia,2,-2,1739,1711,0,0,30,35,1737,1713,draw
2493,August 15,2012,Hong Kong,Singapore,0,2,Friendly,in Singapore,-9,9,1191,1248,-2,1,159,147,1200,1239,T1
2494,August 15,2012,Romania,Slovenia,3,4,Friendly,in Slovenia,-9,9,1720,1665,-1,1,32,45,1729,1656,T1
2495,August 15,2012,South Korea,Zambia,2,1,Friendly,in South Korea,3,-3,1803,1609,0,-3,17,60,1800,1612,T1
2496,August 15,2012,Brazil,Sweden,3,0,Friendly,in Sweden,15,-15,2059,1874,1,0,2,12,2044,1889,T2
2497,August 15,2012,Czechia,Ukraine,0,0,Friendly,in Ukraine,1,-1,1790,1727,-1,1,23,31,1789,1728,draw
2498,August 15,2012,Bosnia and Herzegovina,Wales,2,0,Friendly,in Wales,17,-17,1699,1613,2,-5,40,59,1682,1630,T2
2499,August 22,2012,India,Syria,2,1,Nehru Gold Cup,in India,35,-35,1161,1539,9,-7,164,77,1126,1574,T1
2500,August 23,2012,Nepal,Maldives,1,2,Nehru Gold Cup,in India,-12,12,908,1089,-1,1,199,180,920,1077,T1
2501,August 25,2012,Maldives,India,0,3,Nehru Gold Cup,in India,-19,19,1070,1180,-2,4,182,160,1089,1161,T1
2502,August 26,2012,Uganda,Botswana,0,0,Friendly,in Botswana,-3,3,1515,1330,0,1,85,126,1518,1327,draw
2503,August 26,2012,Sudan,Libya,0,3,Friendly,in Tunisia,-11,11,1468,1618,-1,4,94,57,1479,1607,T1
2504,August 27,2012,Maldives,Syria,2,1,Nehru Gold Cup,in India,37,-37,1107,1502,5,-9,177,86,1070,1539,T1
2505,August 28,2012,Nepal,India,0,0,Nehru Gold Cup,in India,16,-16,924,1164,1,-3,198,163,908,1180,draw
2506,August 30,2012,Syria,Nepal,2,0,Nehru Gold Cup,in India,2,-2,1504,922,0,0,86,198,1502,924,T1
2507,September 1,2012,Saint Vincent and the Grenadines,Barbados,2,0,Friendly,in Saint Vincent and the Grenadines,11,-11,1168,1142,5,-3,161,170,1157,1153,T1
2508,September 2,2012,Saint Vincent and the Grenadines,Barbados,1,1,Friendly,in Saint Vincent and the Grenadines,-3,3,1165,1145,-1,1,162,169,1168,1142,draw
2509,September 4,2012,Liberia,Malawi,1,0,Friendly,in Liberia,11,-11,1280,1406,1,-2,141,107,1269,1417,T1
2510,September 5,2012,Cambodia,Philippines,0,0,Friendly,in Cambodia,6,-6,783,1121,0,-1,211,174,777,1127,draw
2511,September 5,2012,Iran,Jordan,0,0,Friendly,in Jordan,-2,2,1712,1552,0,0,33,74,1714,1550,draw
2512,September 5,2012,British Virgin Islands,Martinique,0,16,CONCACAF Champ &amp; Carib Champ qual,in Martinique,-3,3,764,1350,-1,1,213,117,767,1347,T1
2513,September 5,2012,Suriname,Montserrat,7,1,CONCACAF Champ &amp; Carib Champ qual,in Martinique,2,-2,1194,511,0,0,158,233,1192,513,T1
2514,September 6,2012,United Arab Emirates,Japan,0,1,Friendly,in Japan,-1,1,1420,1795,0,1,104,20,1421,1794,T1
2515,September 6,2012,Lebanon,Australia,0,3,Friendly,in Lebanon,-3,3,1281,1786,0,0,140,25,1284,1783,T2
2516,September 6,2012,China,Sweden,0,1,Friendly,in Sweden,-3,3,1633,1877,0,0,53,12,1636,1874,T1
2517,September 6,2012,Tajikistan,Qatar,2,1,Friendly,in Germany,17,-17,1247,1491,2,-6,148,91,1230,1508,T1
2518,September 7,2012,Albania,Cyprus,3,1,World Cup qualifier,in Albania,19,-19,1517,1446,5,-4,83,99,1498,1465,T1
2519,September 7,2012,Hungary,Andorra,5,0,World Cup qualifier,in Andorra,3,-3,1688,1000,1,0,41,188,1685,1003,T2
2520,September 7,2012,Paraguay,Argentina,1,3,World Cup qualifier,in Argentina,-8,8,1751,1987,1,0,26,5,1759,1979,T1
2521,September 7,2012,Israel,Azerbaijan,1,1,World Cup qualifier,in Azerbaijan,-9,9,1646,1404,-1,3,48,108,1655,1395,draw
2522,September 7,2012,Brazil,South Africa,1,0,Friendly,in Brazil,1,-1,2060,1574,0,2,2,67,2059,1575,T1
2523,September 7,2012,Bulgaria,Italy,2,2,World Cup qualifier,in Bulgaria,9,-9,1652,1901,4,-2,46,11,1643,1910,draw
2524,September 7,2012,Panama,Canada,0,1,World Cup qualifier,in Canada,-21,21,1691,1622,-7,6,40,56,1712,1601,T1
2525,September 7,2012,Colombia,Uruguay,4,0,World Cup qualifier,in Colombia,46,-46,1841,1929,4,-2,16,8,1795,1975,T1
2526,September 7,2012,Mexico,Costa Rica,2,0,World Cup qualifier,in Costa Rica,20,-20,1906,1642,1,-3,10,49,1886,1662,T2
2527,September 7,2012,Macedonia,Croatia,0,1,World Cup qualifier,in Croatia,-3,3,1499,1868,-2,0,88,13,1502,1865,T1
2528,September 7,2012,Cuba,Honduras,0,3,World Cup qualifier,in Cuba,-21,21,1347,1642,-4,7,119,49,1368,1621,T2
2529,September 7,2012,Ecuador,Bolivia,1,0,World Cup qualifier,in Ecuador,5,-5,1815,1572,-2,-2,18,69,1810,1577,T1
2530,September 7,2012,El Salvador,Guyana,2,2,World Cup qualifier,in El Salvador,-15,15,1547,1358,-4,6,75,115,1562,1343,draw
2531,September 7,2012,Estonia,Romania,0,2,World Cup qualifier,in Estonia,-23,23,1511,1743,-8,3,86,29,1534,1720,T2
2532,September 7,2012,Finland,France,0,1,World Cup qualifier,in Finland,-13,13,1612,1868,-5,1,59,13,1625,1855,T2
2533,September 7,2012,Belarus,Georgia,0,1,World Cup qualifier,in Georgia,-20,20,1573,1520,-4,5,68,82,1593,1500,T1
2534,September 7,2012,Germany,Faroe Islands,3,0,World Cup qualifier,in Germany,0,0,2038,1219,0,0,3,154,2038,1219,T1
2535,September 7,2012,Guatemala,Antigua and Barbuda,3,1,World Cup qualifier,in Guatemala,8,-8,1530,1290,1,-2,79,138,1522,1298,T1
2536,September 7,2012,Saint Martin,Haiti,0,7,CONCACAF Champ &amp; Carib Champ qual,in Haiti,-2,2,885,1419,0,0,205,105,887,1417,T1
2537,September 7,2012,Iceland,Norway,2,0,World Cup qualifier,in Iceland,46,-46,1485,1702,10,-10,92,39,1439,1748,T1
2538,September 7,2012,United States,Jamaica,1,2,World Cup qualifier,in Jamaica,-21,21,1741,1666,-4,4,30,45,1762,1645,T1
2539,September 7,2012,Kazakhstan,Ireland,1,2,World Cup qualifier,in Kazakhstan,-6,6,1339,1745,-1,3,121,27,1345,1739,T2
2540,September 7,2012,Greece,Latvia,2,1,World Cup qualifier,in Latvia,12,-12,1803,1526,3,-3,19,80,1791,1538,T2
2541,September 7,2012,Bosnia and Herzegovina,Liechtenstein,8,1,World Cup qualifier,in Liechtenstein,10,-10,1709,1220,3,-2,37,153,1699,1230,T2
2542,September 7,2012,Slovakia,Lithuania,1,1,World Cup qualifier,in Lithuania,-3,3,1611,1473,-2,-1,60,94,1614,1470,draw
2543,September 7,2012,Luxembourg,Portugal,1,2,World Cup qualifier,in Luxembourg,-1,1,1145,1947,0,0,168,7,1146,1946,T2
2544,September 7,2012,Armenia,Malta,1,0,World Cup qualifier,in Malta,10,-10,1541,1232,1,0,78,149,1531,1242,T2
2545,September 7,2012,Martinique,Montserrat,5,0,CONCACAF Champ &amp; Carib Champ qual,in Martinique,0,0,1350,511,0,0,117,233,1350,511,T1
2546,September 7,2012,England,Moldova,5,0,World Cup qualifier,in Moldova,5,-5,1992,1400,0,-2,4,110,1987,1405,T2
2547,September 7,2012,Montenegro,Poland,2,2,World Cup qualifier,in Montenegro,-4,4,1649,1688,1,2,47,41,1653,1684,draw
2548,September 7,2012,Netherlands,Turkey,2,0,World Cup qualifier,in the Netherlands,10,-10,1954,1745,2,1,6,27,1944,1755,T1
2549,September 7,2012,New Zealand,New Caledonia,2,0,World Cup qualifier,in New Caledonia,23,-23,1544,1314,6,-7,76,129,1521,1337,T2
2550,September 7,2012,Peru,Venezuela,2,1,World Cup qualifier,in Peru,14,-14,1720,1685,5,-3,33,43,1706,1699,T1
2551,September 7,2012,Bermuda,Puerto Rico,1,2,CONCACAF Champ &amp; Carib Champ qual,in Haiti,-27,27,1182,1103,-4,1,159,181,1209,1076,T1
2552,September 7,2012,Northern Ireland,Russia,0,2,World Cup qualifier,in Russia,-3,3,1448,1846,0,0,98,15,1451,1843,T1
2553,September 7,2012,Singapore,Philippines,0,2,Friendly,in Singapore,-24,24,1224,1145,-3,6,150,168,1248,1121,T2
2554,September 7,2012,Slovenia,Switzerland,0,2,World Cup qualifier,in Slovenia,-28,28,1637,1816,-8,7,53,17,1665,1788,T2
2555,September 7,2012,Tahiti,Solomon Islands,0,2,World Cup qualifier,in the Solomon Islands,-28,28,1298,1278,-7,2,135,143,1326,1250,T1
2556,September 7,2012,Saudi Arabia,Spain,0,5,Friendly,in Spain,-1,1,1497,2156,-1,0,89,1,1498,2155,T1
2557,September 7,2012,British Virgin Islands,Suriname,0,4,CONCACAF Champ &amp; Carib Champ qual,in Martinique,-6,6,758,1200,0,2,213,156,764,1194,T1
2558,September 7,2012,Kuwait,Uzbekistan,0,3,Friendly,in Uzbekistan,-10,10,1512,1602,-5,3,85,62,1522,1592,T1
2559,September 7,2012,Belgium,Wales,2,0,World Cup qualifier,in Wales,31,-31,1735,1582,8,-5,31,65,1704,1613,T2
2560,September 8,2012,Cape Verde,Cameroon,2,0,African Nations Cup qualifier,in Cape Verde,42,-42,1439,1598,9,-11,102,62,1397,1640,T1
2561,September 8,2012,Burkina Faso,Central African Republic,0,1,African Nations Cup qualifier,in Central African Republic,-22,22,1418,1326,-4,8,106,125,1440,1304,T1
2562,September 8,2012,Czechia,Denmark,0,0,World Cup qualifier,in Denmark,6,-6,1796,1790,2,-2,22,24,1790,1796,draw
2563,September 8,2012,Gabon,Togo,1,1,African Nations Cup qualifier,in Gabon,-15,15,1553,1361,-1,5,71,115,1568,1346,draw
2564,September 8,2012,Ghana,Malawi,2,0,African Nations Cup qualifier,in Ghana,6,-6,1688,1400,3,-3,41,110,1682,1406,T1
2565,September 8,2012,Senegal,Ivory Coast,2,4,African Nations Cup qualifier,in Ivory Coast,-7,7,1542,1809,-2,2,76,19,1549,1802,T1
2566,September 8,2012,Nigeria,Liberia,2,2,African Nations Cup qualifier,in Liberia,-13,13,1626,1293,-1,4,53,137,1639,1280,draw
2567,September 8,2012,Mali,Botswana,3,0,African Nations Cup qualifier,in Mali,8,-8,1585,1322,1,-1,65,126,1577,1330,T1
2568,September 8,2012,Serbia,Scotland,0,0,World Cup qualifier,in Scotland,5,-5,1716,1704,1,-1,34,38,1711,1709,draw
2569,September 8,2012,Sierra Leone,Tunisia,2,2,African Nations Cup qualifier,in Sierra Leone,10,-10,1344,1604,1,-2,121,60,1334,1614,draw
2570,September 8,2012,Guadeloupe,Saint Barthélemy,8,1,Friendly,in Saint Barthélemy,1,-1,1444,694,0,0,100,218,1443,695,T2
2571,September 8,2012,Sudan,Ethiopia,5,3,African Nations Cup qualifier,in Sudan,12,-12,1480,1320,2,-4,93,127,1468,1332,T1
2572,September 8,2012,Zambia,Uganda,1,0,African Nations Cup qualifier,in Zambia,10,-10,1619,1505,5,-2,56,86,1609,1515,T1
2573,September 9,2012,Libya,Algeria,0,1,African Nations Cup qualifier,in Morocco,-25,25,1593,1546,-5,6,62,75,1618,1521,T1
2574,September 9,2012,Democratic Republic of Congo,Equatorial Guinea,4,0,African Nations Cup qualifier,in the Democratic Republic of the Congo,13,-13,1475,1272,2,-3,94,143,1462,1285,T1
2575,September 9,2012,Niger,Guinea,0,1,African Nations Cup qualifier,in Guinea,-5,5,1295,1561,-1,1,135,69,1300,1556,T1
2576,September 9,2012,Bermuda,Haiti,1,3,CONCACAF Champ &amp; Carib Champ qual,in Haiti,-8,8,1174,1427,0,2,159,103,1182,1419,T1
2577,September 9,2012,Martinique,Suriname,2,2,CONCACAF Champ &amp; Carib Champ qual,in Martinique,-12,12,1338,1212,-5,1,123,155,1350,1200,draw
2578,September 9,2012,British Virgin Islands,Montserrat,0,7,CONCACAF Champ &amp; Carib Champ qual,in Martinique,-73,73,685,584,-6,5,219,228,758,511,T1
2579,September 9,2012,Morocco,Mozambique,0,2,African Nations Cup qualifier,in Mozambique,-45,45,1551,1350,-10,14,73,119,1596,1305,T1
2580,September 9,2012,Puerto Rico,Saint Martin,9,0,CONCACAF Champ &amp; Carib Champ qual,in Haiti,22,-22,1125,863,7,-1,174,206,1103,885,T1
2581,September 9,2012,Zimbabwe,Angola,3,1,African Nations Cup qualifier,in Zimbabwe,34,-34,1382,1463,6,-7,113,96,1348,1497,T1
2582,September 10,2012,China,Brazil,0,8,Friendly,in Brazil,-2,2,1631,2062,0,0,52,2,1633,2060,T1
2583,September 10,2012,Indonesia,North Korea,0,2,Friendly,in Indonesia,-8,8,1256,1550,-1,3,145,74,1264,1542,T2
2584,September 10,2012,Philippines,Laos,1,2,Friendly,in Laos,-15,15,1130,857,-3,1,171,207,1145,842,T1
2585,September 11,2012,Antigua and Barbuda,Guatemala,0,1,World Cup qualifier,in Antigua and Barbuda,-12,12,1278,1542,-1,2,140,78,1290,1530,T2
2586,September 11,2012,Germany,Austria,2,1,World Cup qualifier,in Austria,6,-6,2044,1617,0,-2,3,56,2038,1623,T2
2587,September 11,2012,Croatia,Belgium,1,1,World Cup qualifier,in Belgium,-2,2,1866,1737,-2,0,15,31,1868,1735,draw
2588,September 11,2012,Bermuda,Saint Martin,8,0,CONCACAF Champ &amp; Carib Champ qual,in Haiti,14,-14,1188,849,0,-2,159,208,1174,863,T1
2589,September 11,2012,Bosnia and Herzegovina,Latvia,4,1,World Cup qualifier,in Bosnia and Herzegovina,11,-11,1720,1515,2,-1,35,82,1709,1526,T1
2590,September 11,2012,Bulgaria,Armenia,1,0,World Cup qualifier,in Bulgaria,9,-9,1661,1532,1,-1,45,80,1652,1541,T1
2591,September 11,2012,Chile,Colombia,1,3,World Cup qualifier,in Chile,-43,43,1866,1884,-6,5,15,11,1909,1841,T2
2592,September 11,2012,Iceland,Cyprus,0,1,World Cup qualifier,in Cyprus,-17,17,1468,1463,-3,3,94,96,1485,1446,T1
2593,September 11,2012,Finland,Czechia,1,0,Friendly,in Czechia,17,-17,1629,1779,6,-2,51,24,1612,1796,T2
2594,September 11,2012,England,Ukraine,1,1,World Cup qualifier,in England,-16,16,1976,1743,-1,2,5,30,1992,1727,draw
2595,September 11,2012,France,Belarus,3,1,World Cup qualifier,in France,6,-6,1874,1567,0,-1,13,68,1868,1573,T1
2596,September 11,2012,Saudi Arabia,Gabon,0,1,Friendly,in France,-8,8,1489,1561,-1,-1,90,71,1497,1553,T1
2597,September 11,2012,Spain,Georgia,1,0,World Cup qualifier,in Georgia,2,-2,2158,1518,0,1,1,81,2156,1520,T2
2598,September 11,2012,Greece,Lithuania,2,0,World Cup qualifier,in Greece,5,-5,1808,1468,0,1,20,94,1803,1473,T1
2599,September 11,2012,El Salvador,Guyana,3,2,World Cup qualifier,in Guyana,15,-15,1562,1343,5,-4,70,121,1547,1358,T2
2600,September 11,2012,Puerto Rico,Haiti,1,2,CONCACAF Champ &amp; Carib Champ qual,in Haiti,-4,4,1121,1431,-1,-1,175,104,1125,1427,T1
2601,September 11,2012,Honduras,Cuba,1,0,World Cup qualifier,in Honduras,4,-4,1646,1343,1,-1,48,121,1642,1347,T1
2602,September 11,2012,Netherlands,Hungary,4,1,World Cup qualifier,in Hungary,19,-19,1973,1669,0,-2,6,43,1954,1688,T2
2603,September 11,2012,Ireland,Oman,4,1,Friendly,in England,9,-9,1754,1544,1,-7,26,77,1745,1553,T1
2604,September 11,2012,Russia,Israel,4,0,World Cup qualifier,in Israel,27,-27,1873,1619,1,-6,14,54,1846,1646,T2
2605,September 11,2012,Italy,Malta,2,0,World Cup qualifier,in Italy,1,-1,1902,1231,1,0,10,149,1901,1232,T1
2606,September 11,2012,Iraq,Japan,0,1,World Cup qualifier,in Japan,-6,6,1586,1801,0,2,63,21,1592,1795,T1
2607,September 11,2012,Australia,Jordan,1,2,World Cup qualifier,in Jordan,-27,27,1759,1579,0,7,25,65,1786,1552,T1
2608,September 11,2012,Lebanon,Iran,1,0,World Cup qualifier,in Lebanon,35,-35,1316,1677,8,-7,132,42,1281,1712,T1
2609,September 11,2012,Liberia,Ghana,2,0,Friendly,in Liberia,25,-25,1318,1663,6,-3,131,44,1293,1688,T1
2610,September 11,2012,Malaysia,Vietnam,0,2,Friendly,in Malaysia,-16,16,1206,1308,-4,3,155,135,1222,1292,T2
2611,September 11,2012,Costa Rica,Mexico,0,1,World Cup qualifier,in Mexico,-4,4,1638,1910,0,1,49,9,1642,1906,T1
2612,September 11,2012,Myanmar,Singapore,1,1,Friendly,in Myanmar,3,-3,1016,1221,0,-1,186,151,1013,1224,draw
2613,September 11,2012,New Zealand,Solomon Islands,6,1,World Cup qualifier,in New Zealand,9,-9,1553,1269,4,0,73,142,1544,1278,T1
2614,September 11,2012,Slovenia,Norway,1,2,World Cup qualifier,in Norway,-11,11,1626,1713,-1,3,52,36,1637,1702,T1
2615,September 11,2012,Luxembourg,Northern Ireland,1,1,World Cup qualifier,in Northern Ireland,16,-16,1161,1432,2,-5,166,103,1145,1448,draw
2616,September 11,2012,Panama,Canada,2,0,World Cup qualifier,in Panama,16,-16,1707,1606,1,-4,39,59,1691,1622,T1
2617,September 11,2012,Paraguay,Venezuela,0,2,World Cup qualifier,in Paraguay,-43,43,1708,1728,-12,10,38,34,1751,1685,T2
2618,September 11,2012,Peru,Argentina,1,1,World Cup qualifier,in Peru,9,-9,1729,1978,0,1,33,4,1720,1987,draw
2619,September 11,2012,Poland,Moldova,2,0,World Cup qualifier,in Poland,6,-6,1694,1394,1,-1,40,111,1688,1400,T1
2620,September 11,2012,Portugal,Azerbaijan,3,0,World Cup qualifier,in Portugal,2,-2,1949,1402,0,-1,7,109,1947,1404,T1
2621,September 11,2012,Romania,Andorra,4,0,World Cup qualifier,in Romania,1,-1,1744,999,0,0,29,188,1743,1000,T1
2622,September 11,2012,San Marino,Montenegro,0,6,World Cup qualifier,in San Marino,-2,2,889,1651,0,0,204,47,891,1649,T2
2623,September 11,2012,Scotland,Macedonia,1,1,World Cup qualifier,in Scotland,-14,14,1690,1513,-3,5,41,83,1704,1499,draw
2624,September 11,2012,Serbia,Wales,6,1,World Cup qualifier,in Serbia,17,-17,1733,1565,2,-4,32,69,1716,1582,T1
2625,September 11,2012,Slovakia,Liechtenstein,2,0,World Cup qualifier,in Slovakia,3,-3,1614,1217,1,0,57,153,1611,1220,T1
2626,September 11,2012,Mozambique,South Africa,0,2,Friendly,in South Africa,-4,4,1346,1578,0,0,119,66,1350,1574,T1
2627,September 11,2012,Sweden,Kazakhstan,2,0,World Cup qualifier,in Sweden,1,-1,1878,1338,0,-1,12,123,1877,1339,T1
2628,September 11,2012,Albania,Switzerland,0,2,World Cup qualifier,in Switzerland,-5,5,1512,1821,-1,-1,84,18,1517,1816,T1
2629,September 11,2012,Tahiti,New Caledonia,0,4,World Cup qualifier,in Tahiti,-46,46,1252,1360,-11,14,145,117,1298,1314,T2
2630,September 11,2012,Turkey,Estonia,3,0,World Cup qualifier,in Turkey,9,-9,1754,1502,1,-2,26,87,1745,1511,T1
2631,September 11,2012,United Arab Emirates,Kuwait,3,0,Friendly,in the United Arab Emirates,17,-17,1437,1495,3,-4,102,88,1420,1512,T1
2632,September 11,2012,Uruguay,Ecuador,1,1,World Cup qualifier,in Uruguay,-11,11,1918,1826,0,1,8,17,1929,1815,draw
2633,September 11,2012,United States,Jamaica,1,0,World Cup qualifier,in the United States,11,-11,1752,1655,2,-1,28,46,1741,1666,T1
2634,September 11,2012,Uzbekistan,South Korea,2,2,World Cup qualifier,in Uzbekistan,6,-6,1608,1797,2,-2,58,22,1602,1803,draw
2635,September 12,2012,Thailand,Laos,2,1,Friendly,in Thailand,1,-1,1377,856,0,0,115,206,1376,857,T1
2636,September 15,2012,Vietnam,Indonesia,0,0,Friendly,in Indonesia,1,-1,1309,1255,0,0,135,144,1308,1256,draw
2637,September 15,2012,Réunion,Mauritius,1,1,Friendly,in Mauritius,-5,5,1326,1027,-1,0,126,184,1331,1022,draw
2638,September 16,2012,Haiti,French Guiana,2,1,Friendly,in French Guiana,6,-6,1437,1193,2,0,102,157,1431,1199,T2
2639,September 19,2012,Argentina,Brazil,1,2,Friendly tournament,in Brazil,-8,8,1970,2070,-2,0,6,2,1978,2062,T1
2640,September 20,2012,Malaysia,Cambodia,3,0,Friendly,in Malaysia,2,-2,1208,781,0,0,155,211,1206,783,T1
2641,September 20,2012,Nepal,Bangladesh,1,1,Friendly,in Nepal,-2,2,920,950,0,0,198,194,922,948,draw
2642,September 22,2012,Saint Pierre and Miquelon,Guadeloupe,0,13,French Territory Cup,in France,-1,1,687,1445,0,0,218,99,688,1444,T1
2643,September 22,2012,Martinique,New Caledonia,2,0,French Territory Cup,in France,24,-24,1362,1336,7,-8,116,125,1338,1360,T1
2644,September 22,2012,Tahiti,Mayotte,1,3,French Territory Cup,in France,-28,28,1224,1193,-4,5,149,157,1252,1165,T1
2645,September 22,2012,French Guiana,Réunion,0,2,French Territory Cup,in France,-14,14,1179,1340,-3,3,160,123,1193,1326,T1
2646,September 23,2012,Dominican Republic,Aruba,2,2,CONCACAF Champ &amp; Carib Champ qual,in Barbados,-7,7,1122,1006,-1,0,174,188,1129,999,draw
2647,September 23,2012,Dominica,Barbados,0,1,CONCACAF Champ &amp; Carib Champ qual,in Barbados,-9,9,1012,1154,-1,1,186,168,1021,1145,T1
2648,September 24,2012,French Guiana,Guadeloupe,2,4,French Territory Cup,in France,-8,8,1171,1453,-1,0,161,99,1179,1445,T1
2649,September 24,2012,Mayotte,New Caledonia,2,0,French Territory Cup,in France,31,-31,1224,1305,7,-11,150,136,1193,1336,T1
2650,September 24,2012,Réunion,Saint Pierre and Miquelon,10,0,French Territory Cup,in France,2,-2,1342,685,1,0,122,218,1340,687,T1
2651,September 24,2012,Martinique,Tahiti,2,3,French Territory Cup,in France,-21,21,1341,1245,-7,2,123,147,1362,1224,T1
2652,September 25,2012,Barbados,Dominican Republic,0,1,CONCACAF Champ &amp; Carib Champ qual,in Barbados,-27,27,1127,1149,-5,5,173,169,1154,1122,T2
2653,September 25,2012,Dominica,Aruba,3,2,CONCACAF Champ &amp; Carib Champ qual,in Barbados,20,-20,1032,986,2,-2,184,190,1012,1006,T1
2654,September 25,2012,Macao,Taiwan,2,2,Friendly tournament,in the Philippines,9,-9,659,892,1,-2,223,203,650,901,draw
2655,September 25,2012,Philippines,Guam,1,0,Friendly tournament,in the Philippines,1,-1,1131,656,0,-1,171,224,1130,657,T1
2656,September 26,2012,Indonesia,Brunei,5,0,Friendly,in Brunei,2,-2,1257,648,-1,0,145,225,1255,650,T2
2657,September 26,2012,Saint Pierre and Miquelon,French Guiana,1,11,French Territory Cup,in France,-5,5,680,1176,-3,1,221,160,685,1171,T1
2658,September 26,2012,Mayotte,Martinique,0,3,French Territory Cup,in France,-18,18,1206,1359,-6,5,156,118,1224,1341,T1
2659,September 26,2012,Guadeloupe,Réunion,1,2,French Territory Cup,in France,-20,20,1433,1362,-4,6,103,116,1453,1342,T1
2660,September 26,2012,Tahiti,New Caledonia,1,0,French Territory Cup,in France,18,-18,1263,1287,4,-2,143,138,1245,1305,T1
2661,September 27,2012,Aruba,Barbados,1,2,CONCACAF Champ &amp; Carib Champ qual,in Barbados,-8,8,978,1135,-1,2,191,171,986,1127,T1
2662,September 27,2012,Dominica,Dominican Republic,1,2,CONCACAF Champ &amp; Carib Champ qual,in Barbados,-14,14,1018,1163,-1,3,185,166,1032,1149,T1
2663,September 27,2012,Philippines,Macao,5,0,Friendly tournament,in the Philippines,2,-2,1133,657,-1,0,172,223,1131,659,T1
2664,September 27,2012,Taiwan,Guam,2,0,Friendly tournament,in the Philippines,9,-9,901,647,2,-1,201,225,892,656,T1
2665,September 28,2012,Tahiti,French Guiana,1,2,French Territory Cup,in France,-19,19,1244,1195,-4,2,147,158,1263,1176,T1
2666,September 28,2012,Saint Pierre and Miquelon,New Caledonia,1,16,French Territory Cup,in France,-3,3,677,1290,0,0,221,138,680,1287,T1
2667,September 28,2012,Oman,Yemen,2,1,Friendly,in Oman,3,-3,1547,1312,1,0,76,132,1544,1315,T1
2668,September 29,2012,Mayotte,Guadeloupe,0,1,French Territory Cup,in France,-6,6,1200,1439,-1,3,157,100,1206,1433,T1
2669,September 29,2012,Macao,Guam,0,3,Friendly tournament,in the Philippines,-27,27,630,674,-3,2,226,223,657,647,T1
2670,September 29,2012,Martinique,Réunion,2,2,French Territory Cup,in France,0,0,1359,1362,0,0,118,116,1359,1362,draw
2671,September 29,2012,Taiwan,Philippines,1,3,Friendly tournament,in the Philippines,-6,6,895,1139,0,1,201,171,901,1133,T1
2672,October 5,2012,East Timor,Cambodia,5,1,Southeast Asian Championship qualifier,in Myanmar,61,-61,586,720,5,-2,228,213,525,781,T1
2673,October 5,2012,Myanmar,Brunei,1,0,Southeast Asian Championship qualifier,in Myanmar,3,-3,1019,645,1,0,185,224,1016,648,T1
2674,October 7,2012,Cambodia,Laos,0,1,Southeast Asian Championship qualifier,in Myanmar,-13,13,707,869,0,1,213,205,720,856,T1
2675,October 7,2012,East Timor,Myanmar,1,2,Southeast Asian Championship qualifier,in Myanmar,-2,2,584,1021,0,0,228,185,586,1019,T1
2676,October 8,2012,Jordan,Qatar,1,1,Friendly,in Qatar,0,0,1579,1491,0,0,65,89,1579,1491,draw
2677,October 9,2012,Cambodia,Brunei,2,3,Southeast Asian Championship qualifier,in Myanmar,-24,24,683,669,-6,0,219,224,707,645,T1
2678,October 9,2012,East Timor,Laos,3,1,Southeast Asian Championship qualifier,in Myanmar,50,-50,634,819,3,-4,225,209,584,869,T1
2679,October 9,2012,Liberia,Niger,3,4,Friendly,in Niger,-8,8,1310,1303,-3,0,133,136,1318,1295,T1
2680,October 9,2012,Oman,Qatar,1,1,Friendly,in Qatar,1,-1,1548,1490,0,0,76,89,1547,1491,draw
2681,October 10,2012,Saint Kitts and Nevis,Anguilla,2,0,CONCACAF Champ &amp; Carib Champ qual,in Saint Kitts and Nevis,1,-1,1206,565,0,0,156,230,1205,566,T1
2682,October 10,2012,French Guiana,Trinidad and Tobago,1,4,CONCACAF Champ &amp; Carib Champ qual,in Saint Kitts and Nevis,-11,11,1184,1491,-2,2,160,89,1195,1480,T1
2683,October 11,2012,Iraq,Brazil,0,6,Friendly,in Sweden,-2,2,1584,2072,-1,0,64,2,1586,2070,T1
2684,October 11,2012,Kuwait,Syria,1,1,Friendly,in Kuwait,-3,3,1492,1507,0,1,88,85,1495,1504,draw
2685,October 11,2012,Laos,Brunei,3,1,Southeast Asian Championship qualifier,in Myanmar,18,-18,837,651,1,0,208,224,819,669,T1
2686,October 11,2012,Cambodia,Myanmar,0,3,Southeast Asian Championship qualifier,in Myanmar,-5,5,678,1026,-1,0,220,185,683,1021,T1
2687,October 12,2012,Iceland,Albania,2,1,World Cup qualifier,in Albania,28,-28,1496,1484,7,-9,87,93,1468,1512,T2
2688,October 12,2012,Antigua and Barbuda,United States,1,2,World Cup qualifier,in Antigua and Barbuda,-4,4,1274,1756,0,0,140,28,1278,1752,T2
2689,October 12,2012,Argentina,Uruguay,3,0,World Cup qualifier,in Argentina,21,-21,1991,1897,2,-2,4,10,1970,1918,T1
2690,October 12,2012,Italy,Armenia,3,1,World Cup qualifier,in Armenia,10,-10,1912,1522,1,-1,9,81,1902,1532,T2
2691,October 12,2012,Bahrain,Philippines,0,0,Friendly,in Bahrain,-8,8,1435,1147,-4,1,103,170,1443,1139,draw
2692,October 12,2012,Spain,Belarus,4,0,World Cup qualifier,in Belarus,4,-4,2162,1563,0,-2,1,70,2158,1567,T2
2693,October 12,2012,Bolivia,Peru,1,1,World Cup qualifier,in Bolivia,3,-3,1575,1726,0,-1,67,34,1572,1729,draw
2694,October 12,2012,Denmark,Bulgaria,1,1,World Cup qualifier,in Bulgaria,-2,2,1788,1663,0,1,23,44,1790,1661,draw
2695,October 12,2012,Cuba,Canada,0,3,World Cup qualifier,in Canada,-8,8,1335,1614,-3,2,125,57,1343,1606,T1
2696,October 12,2012,Paraguay,Colombia,0,2,World Cup qualifier,in Colombia,-10,10,1698,1894,1,0,37,11,1708,1884,T1
2697,October 12,2012,Czechia,Malta,3,1,World Cup qualifier,in Czechia,1,-1,1780,1230,-1,2,25,147,1779,1231,T1
2698,October 12,2012,Chile,Ecuador,1,3,World Cup qualifier,in Ecuador,-25,25,1841,1851,-2,1,17,16,1866,1826,T1
2699,October 12,2012,Congo,Egypt,0,3,Friendly,in the United Arab Emirates,-5,5,1389,1715,-1,1,112,36,1394,1710,T1
2700,October 12,2012,El Salvador,Costa Rica,0,1,World Cup qualifier,in El Salvador,-21,21,1541,1659,-9,3,79,46,1562,1638,T2
2701,October 12,2012,San Marino,England,0,5,World Cup qualifier,in England,0,0,889,1976,0,-1,204,5,889,1976,T1
2702,October 12,2012,Hungary,Estonia,1,0,World Cup qualifier,in Estonia,16,-16,1685,1486,2,-4,41,91,1669,1502,T2
2703,October 12,2012,Sweden,Faroe Islands,2,1,World Cup qualifier,in the Faroe Islands,2,-2,1880,1217,-1,0,13,152,1878,1219,T2
2704,October 12,2012,Georgia,Finland,1,1,World Cup qualifier,in Finland,11,-11,1529,1618,1,-5,80,56,1518,1629,draw
2705,October 12,2012,France,Japan,0,1,Friendly,in France,-15,15,1859,1816,-2,3,15,18,1874,1801,T2
2706,October 12,2012,French Guiana,Anguilla,4,1,CONCACAF Champ &amp; Carib Champ qual,in Saint Kitts and Nevis,2,-2,1186,563,0,-1,160,231,1184,565,T1
2707,October 12,2012,Bosnia and Herzegovina,Greece,0,0,World Cup qualifier,in Greece,10,-10,1730,1798,4,-1,31,21,1720,1808,draw
2708,October 12,2012,Jamaica,Guatemala,1,2,World Cup qualifier,in Guatemala,-21,21,1634,1563,-3,8,49,70,1655,1542,T1
2709,October 12,2012,Germany,Ireland,6,1,World Cup qualifier,in Ireland,20,-20,2064,1734,0,-3,3,29,2044,1754,T2
2710,October 12,2012,Austria,Kazakhstan,0,0,World Cup qualifier,in Kazakhstan,-9,9,1608,1347,-2,4,58,120,1617,1338,draw
2711,October 12,2012,Swaziland,Lesotho,1,2,Friendly,in Lesotho,-6,6,1098,1158,-1,1,181,168,1104,1152,T1
2712,October 12,2012,Liechtenstein,Lithuania,0,2,World Cup qualifier,in Liechtenstein,-18,18,1199,1486,-3,3,156,91,1217,1468,T2
2713,October 12,2012,Israel,Luxembourg,6,0,World Cup qualifier,in Luxembourg,10,-10,1629,1151,2,-2,52,169,1619,1161,T2
2714,October 12,2012,Croatia,Macedonia,2,1,World Cup qualifier,in Macedonia,8,-8,1874,1505,1,0,14,83,1866,1513,T2
2715,October 12,2012,Mexico,Guyana,5,0,World Cup qualifier,in the United States,3,-3,1913,1340,1,-1,8,123,1910,1343,T1
2716,October 12,2012,Moldova,Ukraine,0,0,World Cup qualifier,in Moldova,12,-12,1406,1731,3,0,108,30,1394,1743,draw
2717,October 12,2012,Netherlands,Andorra,3,0,World Cup qualifier,in the Netherlands,0,0,1973,999,-1,0,6,188,1973,999,T1
2718,October 12,2012,Honduras,Panama,0,0,World Cup qualifier,in Panama,9,-9,1655,1698,1,2,47,37,1646,1707,draw
2719,October 12,2012,South Africa,Poland,0,1,Friendly,in Poland,-4,4,1574,1698,-2,3,68,37,1578,1694,T1
2720,October 12,2012,Portugal,Russia,0,1,World Cup qualifier,in Russia,-19,19,1930,1892,0,2,7,12,1949,1873,T1
2721,October 12,2012,Belgium,Serbia,3,0,World Cup qualifier,in Serbia,44,-44,1781,1689,7,-8,24,40,1737,1733,T2
2722,October 12,2012,Latvia,Slovakia,1,2,World Cup qualifier,in Slovakia,-10,10,1505,1624,-1,3,83,54,1515,1614,T1
2723,October 12,2012,Slovenia,Cyprus,2,1,World Cup qualifier,in Slovenia,7,-7,1633,1456,2,-1,50,97,1626,1463,T1
2724,October 12,2012,New Caledonia,Solomon Islands,6,2,World Cup qualifier,in the Solomon Islands,46,-46,1336,1223,14,-7,124,149,1290,1269,T2
2725,October 12,2012,Trinidad and Tobago,Saint Kitts and Nevis,1,0,CONCACAF Champ &amp; Carib Champ qual,in Saint Kitts and Nevis,10,-10,1501,1196,3,-1,86,157,1491,1206,T2
2726,October 12,2012,Norway,Switzerland,1,1,World Cup qualifier,in Switzerland,11,-11,1724,1810,1,-1,35,19,1713,1821,draw
2727,October 12,2012,New Zealand,Tahiti,2,0,World Cup qualifier,in Tahiti,14,-14,1567,1230,4,0,69,147,1553,1244,T2
2728,October 12,2012,Romania,Turkey,1,0,World Cup qualifier,in Turkey,26,-26,1770,1728,3,-6,26,32,1744,1754,T2
2729,October 12,2012,Uzbekistan,United Arab Emirates,2,2,Friendly,in the United Arab Emirates,-2,2,1606,1439,-1,3,59,99,1608,1437,draw
2730,October 12,2012,Scotland,Wales,1,2,World Cup qualifier,in Wales,-21,21,1669,1586,-2,6,43,63,1690,1565,T1
2731,October 13,2012,Botswana,Mali,1,4,African Nations Cup qualifier,in Botswana,-20,20,1302,1605,-9,5,137,59,1322,1585,T2
2732,October 13,2012,East Timor,Brunei,1,2,Southeast Asian Championship qualifier,in Myanmar,-19,19,615,670,-2,0,227,224,634,651,T1
2733,October 13,2012,Malawi,Ghana,0,1,African Nations Cup qualifier,in Malawi,-11,11,1389,1674,0,1,111,43,1400,1663,T2
2734,October 13,2012,Mozambique,Morocco,0,4,African Nations Cup qualifier,in Morocco,-11,11,1335,1562,-3,2,124,72,1346,1551,T1
2735,October 13,2012,Laos,Myanmar,0,0,Southeast Asian Championship qualifier,in Myanmar,14,-14,851,1012,1,-1,207,186,837,1026,draw
2736,October 13,2012,Namibia,Rwanda,0,0,Friendly,in Namibia,0,0,1312,1403,1,0,131,109,1312,1403,draw
2737,October 13,2012,Nigeria,Liberia,6,1,African Nations Cup qualifier,in Nigeria,7,-7,1633,1303,3,-1,50,135,1626,1310,T1
2738,October 13,2012,Ivory Coast,Senegal,2,0,African Nations Cup qualifier,in Senegal,17,-17,1826,1525,2,-3,18,81,1809,1542,T2
2739,October 13,2012,Tunisia,Sierra Leone,0,0,African Nations Cup qualifier,in Tunisia,-16,16,1588,1360,-3,4,63,118,1604,1344,draw
2740,October 13,2012,Uganda,Zambia,1,0,African Nations Cup qualifier,in Uganda,21,-21,1526,1598,3,-5,80,60,1505,1619,T1
2741,October 14,2012,Libya,Algeria,0,2,African Nations Cup qualifier,in Algeria,-25,25,1568,1571,-7,9,69,68,1593,1546,T1
2742,October 14,2012,Angola,Zimbabwe,2,0,African Nations Cup qualifier,in Angola,16,-16,1479,1366,2,-3,94,116,1463,1382,T1
2743,October 14,2012,Burkina Faso,Central African Republic,3,1,African Nations Cup qualifier,in Burkina Faso,15,-15,1433,1311,3,-6,103,133,1418,1326,T1
2744,October 14,2012,Cameroon,Cape Verde,2,1,African Nations Cup qualifier,in Cameroon,7,-7,1605,1432,1,-5,59,104,1598,1439,T1
2745,October 14,2012,Democratic Republic of Congo,Equatorial Guinea,1,2,African Nations Cup qualifier,in Equatorial Guinea,-26,26,1449,1298,-2,3,97,138,1475,1272,T1
2746,October 14,2012,Sudan,Ethiopia,0,2,African Nations Cup qualifier,in Ethiopia,-35,35,1445,1355,-4,8,98,120,1480,1320,T1
2747,October 14,2012,Swaziland,Lesotho,1,0,Friendly,in Lesotho,14,-14,1112,1144,3,-2,178,170,1098,1158,T2
2748,October 14,2012,Guinea,Niger,0,2,African Nations Cup qualifier,in Niger,-43,43,1518,1346,-9,12,82,123,1561,1303,T1
2749,October 14,2012,Congo,Saudi Arabia,2,3,Friendly,in Saudi Arabia,-5,5,1384,1494,-2,2,113,88,1389,1489,T1
2750,October 14,2012,French Guiana,Saint Kitts and Nevis,3,0,CONCACAF Champ &amp; Carib Champ qual,in Saint Kitts and Nevis,46,-46,1232,1150,13,-11,147,168,1186,1196,T2
2751,October 14,2012,Togo,Gabon,2,1,African Nations Cup qualifier,in Togo,26,-26,1387,1535,5,-4,112,77,1361,1561,T1
2752,October 14,2012,Trinidad and Tobago,Anguilla,10,0,CONCACAF Champ &amp; Carib Champ qual,in Saint Kitts and Nevis,0,0,1501,563,0,0,86,231,1501,563,T1
2753,October 16,2012,Slovenia,Albania,0,1,World Cup qualifier,in Albania,-23,23,1610,1507,-7,8,57,85,1633,1484,T1
2754,October 16,2012,Estonia,Andorra,1,0,World Cup qualifier,in Andorra,4,-4,1490,995,1,-1,90,189,1486,999,T2
2755,October 16,2012,Iraq,Australia,1,2,World Cup qualifier,in Qatar,-11,11,1573,1770,-3,2,67,25,1584,1759,T1
2756,October 16,2012,Austria,Kazakhstan,4,0,World Cup qualifier,in Austria,8,-8,1616,1339,1,-3,56,125,1608,1347,T1
2757,October 16,2012,Georgia,Belarus,0,2,World Cup qualifier,in Belarus,-19,19,1510,1582,-5,7,83,64,1529,1563,T1
2758,October 16,2012,Scotland,Belgium,0,2,World Cup qualifier,in Belgium,-14,14,1655,1795,-4,2,48,22,1669,1781,T1
2759,October 16,2012,Bolivia,Uruguay,4,1,World Cup qualifier,in Bolivia,55,-55,1630,1842,13,-6,53,16,1575,1897,T1
2760,October 16,2012,Bosnia and Herzegovina,Lithuania,3,0,World Cup qualifier,in Bosnia and Herzegovina,8,-8,1738,1478,0,-2,31,93,1730,1486,T1
2761,October 16,2012,Brazil,Japan,4,0,Friendly,in Poland,7,-7,2079,1809,0,-2,2,21,2072,1816,T1
2762,October 16,2012,Chile,Argentina,1,2,World Cup qualifier,in Chile,-17,17,1824,2008,-1,0,18,4,1841,1991,T2
2763,October 16,2012,Cameroon,Colombia,0,3,Friendly,in Colombia,-3,3,1602,1897,-1,1,60,10,1605,1894,T1
2764,October 16,2012,Guyana,Costa Rica,0,7,World Cup qualifier,in Costa Rica,-7,7,1333,1666,-3,0,127,46,1340,1659,T1
2765,October 16,2012,Wales,Croatia,0,2,World Cup qualifier,in Croatia,-6,6,1580,1880,-2,1,65,13,1586,1874,T1
2766,October 16,2012,Panama,Cuba,1,1,World Cup qualifier,in Cuba,-13,13,1685,1348,-4,3,41,123,1698,1335,draw
2767,October 16,2012,Norway,Cyprus,3,1,World Cup qualifier,in Cyprus,17,-17,1741,1439,6,-5,29,100,1724,1456,T2
2768,October 16,2012,Czechia,Bulgaria,0,0,World Cup qualifier,in Czechia,-11,11,1769,1674,-1,1,26,44,1780,1663,draw
2769,October 16,2012,Ireland,Faroe Islands,4,1,World Cup qualifier,in the Faroe Islands,6,-6,1740,1211,-1,-1,30,154,1734,1217,T2
2770,October 16,2012,Germany,Sweden,4,4,World Cup qualifier,in Germany,-13,13,2051,1893,0,2,3,11,2064,1880,draw
2771,October 16,2012,Honduras,Canada,8,1,World Cup qualifier,in Honduras,28,-28,1683,1586,5,-7,42,63,1655,1614,T1
2772,October 16,2012,Hong Kong,Malaysia,0,3,Friendly,in Hong Kong,-22,22,1169,1230,-2,7,160,148,1191,1208,T2
2773,October 16,2012,Turkey,Hungary,1,3,World Cup qualifier,in Hungary,-25,25,1703,1710,-4,7,36,34,1728,1685,T1
2774,October 16,2012,Iceland,Switzerland,0,2,World Cup qualifier,in Iceland,-14,14,1482,1824,-4,2,91,18,1496,1810,T2
2775,October 16,2012,South Korea,Iran,0,1,World Cup qualifier,in Iran,-21,21,1776,1698,-1,3,23,39,1797,1677,T1
2776,October 16,2012,Israel,Luxembourg,3,0,World Cup qualifier,in Israel,2,-2,1631,1149,2,-1,51,168,1629,1151,T1
2777,October 16,2012,Italy,Denmark,3,1,World Cup qualifier,in Italy,13,-13,1925,1775,2,-1,7,24,1912,1788,T1
2778,October 16,2012,Antigua and Barbuda,Jamaica,1,4,World Cup qualifier,in Jamaica,-5,5,1269,1639,0,0,141,49,1274,1634,T1
2779,October 16,2012,Kenya,South Africa,1,2,Friendly,in Kenya,-6,6,1313,1580,-1,2,130,65,1319,1574,T2
2780,October 16,2012,Kuwait,Philippines,2,1,Friendly,in Kuwait,1,-1,1493,1146,0,0,89,169,1492,1147,T1
2781,October 16,2012,Liechtenstein,Latvia,0,2,World Cup qualifier,in Latvia,-5,5,1194,1510,0,1,157,83,1199,1505,T1
2782,October 16,2012,Yemen,Lebanon,1,2,Friendly,in Lebanon,-7,7,1305,1323,-3,1,134,129,1312,1316,T1
2783,October 16,2012,Serbia,Macedonia,0,1,World Cup qualifier,in Macedonia,-25,25,1664,1530,-7,6,47,78,1689,1505,T1
2784,October 16,2012,Mexico,El Salvador,2,0,World Cup qualifier,in Mexico,4,-4,1917,1537,0,0,8,76,1913,1541,T1
2785,October 16,2012,New Caledonia,Solomon Islands,5,0,World Cup qualifier,in New Caledonia,18,-18,1354,1205,4,-5,121,155,1336,1223,T1
2786,October 16,2012,Tahiti,New Zealand,0,3,World Cup qualifier,in New Zealand,-5,5,1225,1572,-3,2,151,68,1230,1567,T1
2787,October 16,2012,Oman,Jordan,2,1,World Cup qualifier,in Oman,16,-16,1564,1563,4,-7,71,72,1548,1579,T1
2788,October 16,2012,Paraguay,Peru,1,0,World Cup qualifier,in Paraguay,16,-16,1714,1710,4,0,33,34,1698,1726,T1
2789,October 16,2012,Northern Ireland,Portugal,1,1,World Cup qualifier,in Portugal,19,-19,1451,1911,7,-2,97,9,1432,1930,draw
2790,October 16,2012,Qatar,Uzbekistan,0,1,World Cup qualifier,in Qatar,-19,19,1471,1625,-4,4,94,54,1490,1606,T2
2791,October 16,2012,Romania,Netherlands,1,4,World Cup qualifier,in Romania,-25,25,1745,1998,-2,1,28,5,1770,1973,T2
2792,October 16,2012,Azerbaijan,Russia,0,1,World Cup qualifier,in Russia,-1,1,1401,1893,0,1,110,11,1402,1892,T1
2793,October 16,2012,Moldova,San Marino,2,0,World Cup qualifier,in San Marino,5,-5,1411,884,1,0,107,204,1406,889,T2
2794,October 16,2012,Singapore,India,2,0,Friendly,in Singapore,9,-9,1230,1155,4,-3,148,166,1221,1164,T1
2795,October 16,2012,Slovakia,Greece,0,1,World Cup qualifier,in Slovakia,-16,16,1608,1814,-4,1,58,20,1624,1798,T2
2796,October 16,2012,France,Spain,1,1,World Cup qualifier,in Spain,16,-16,1875,2146,1,0,14,1,1859,2162,draw
2797,October 16,2012,Tunisia,Egypt,1,0,Friendly,in the United Arab Emirates,14,-14,1602,1701,2,-1,60,37,1588,1715,T1
2798,October 16,2012,United Arab Emirates,Bahrain,6,2,Friendly,in the United Arab Emirates,13,-13,1452,1422,3,-4,96,106,1439,1435,T1
2799,October 16,2012,Ukraine,Montenegro,0,1,World Cup qualifier,in Ukraine,-30,30,1701,1681,-7,5,37,43,1731,1651,T2
2800,October 16,2012,United States,Guatemala,3,1,World Cup qualifier,in the United States,9,-9,1765,1554,1,-3,27,74,1756,1563,T1
2801,October 16,2012,Venezuela,Ecuador,1,1,World Cup qualifier,in Venezuela,1,-1,1729,1850,0,1,32,15,1728,1851,draw
2802,October 16,2012,Vietnam,Indonesia,0,0,Friendly,in Vietnam,-4,4,1305,1261,0,1,134,142,1309,1257,draw
2803,October 17,2012,Poland,England,1,1,World Cup qualifier,in Poland,9,-9,1707,1967,3,0,36,6,1698,1976,draw
2804,October 21,2012,Saint Lucia,Curaçao,5,1,CONCACAF Champ &amp; Carib Champ qual,in Saint Lucia,37,-37,1020,1041,5,-1,185,183,983,1078,T1
2805,October 21,2012,Saint Vincent and the Grenadines,Guyana,2,1,CONCACAF Champ &amp; Carib Champ qual,in Saint Lucia,29,-29,1194,1304,5,-8,157,135,1165,1333,T1
2806,October 23,2012,Dominican Republic,Guadeloupe,2,0,CONCACAF Champ &amp; Carib Champ qual,in Guadeloupe,54,-54,1217,1385,11,-12,153,112,1163,1439,T2
2807,October 23,2012,Curaçao,Guyana,1,2,CONCACAF Champ &amp; Carib Champ qual,in Saint Lucia,-7,7,1034,1311,-1,4,184,131,1041,1304,T1
2808,October 23,2012,Puerto Rico,Martinique,1,2,CONCACAF Champ &amp; Carib Champ qual,in Guadeloupe,-8,8,1113,1367,-2,3,177,116,1121,1359,T1
2809,October 23,2012,Saint Vincent and the Grenadines,Saint Lucia,0,1,CONCACAF Champ &amp; Carib Champ qual,in Saint Lucia,-24,24,1170,1044,-4,2,161,183,1194,1020,T1
2810,October 24,2012,Turkmenistan,Vietnam,1,0,Friendly tournament,in Vietnam,17,-17,1368,1288,6,-5,116,139,1351,1305,T2
2811,October 25,2012,Martinique,Dominican Republic,1,1,CONCACAF Champ &amp; Carib Champ qual,in Guadeloupe,-8,8,1359,1225,-3,2,120,151,1367,1217,draw
2812,October 25,2012,Guadeloupe,Puerto Rico,4,1,CONCACAF Champ &amp; Carib Champ qual,in Guadeloupe,7,-7,1392,1106,2,-3,110,180,1385,1113,T1
2813,October 25,2012,Guyana,Saint Lucia,3,0,CONCACAF Champ &amp; Carib Champ qual,in Saint Lucia,19,-19,1330,1025,4,-1,127,184,1311,1044,T2
2814,October 25,2012,Curaçao,Saint Vincent and the Grenadines,0,4,CONCACAF Champ &amp; Carib Champ qual,in Saint Lucia,-24,24,1010,1194,-3,3,187,158,1034,1170,T1
2815,October 26,2012,Vietnam,Laos,4,0,Friendly tournament,in Vietnam,2,-2,1290,849,0,0,139,207,1288,851,T1
2816,October 27,2012,Puerto Rico,Dominican Republic,1,3,CONCACAF Champ &amp; Carib Champ qual,in Guadeloupe,-20,20,1086,1245,-1,5,181,146,1106,1225,T1
2817,October 27,2012,Guadeloupe,Martinique,3,3,CONCACAF Champ &amp; Carib Champ qual,in Guadeloupe,-7,7,1385,1366,-2,3,112,117,1392,1359,draw
2818,October 28,2012,Laos,Turkmenistan,2,4,Friendly tournament,in Vietnam,-2,2,847,1370,-1,0,208,116,849,1368,T1
2819,November 3,2012,Vietnam,Malaysia,1,0,Friendly,in Vietnam,6,-6,1296,1224,1,-3,138,152,1290,1230,T1
2820,November 6,2012,Iran,Tajikistan,6,1,Friendly,in Iran,2,-2,1700,1245,0,0,40,145,1698,1247,T1
2821,November 7,2012,Qatar,Iraq,2,1,Friendly,in Qatar,10,-10,1481,1563,2,-4,92,71,1471,1573,T1
2822,November 7,2012,Thailand,Malaysia,2,0,Friendly,in Thailand,6,-6,1383,1218,1,-1,114,153,1377,1224,T1
2823,November 8,2012,Jordan,Bahrain,0,3,Friendly,in Bahrain,-20,20,1543,1442,-4,5,75,100,1563,1422,T1
2824,November 8,2012,Estonia,Oman,2,1,Friendly,in Oman,15,-15,1505,1549,3,-4,87,74,1490,1564,T2
2825,November 11,2012,Lesotho,Swaziland,0,0,Friendly,in Swaziland,2,-2,1146,1110,1,0,169,177,1144,1112,draw
2826,November 14,2012,Cameroon,Albania,0,0,Friendly,in Switzerland,-3,3,1599,1510,-1,1,61,84,1602,1507,draw
2827,November 14,2012,Algeria,Bosnia and Herzegovina,0,1,Friendly,in Algeria,-8,8,1563,1746,-2,1,70,30,1571,1738,T2
2828,November 14,2012,Andorra,Iceland,0,2,Friendly,in Andorra,-3,3,992,1485,0,0,190,91,995,1482,T2
2829,November 14,2012,Congo,Angola,1,1,Friendly,in Portugal,3,-3,1387,1476,1,0,112,93,1384,1479,draw
2830,November 14,2012,Lithuania,Armenia,2,4,Friendly,in Armenia,-9,9,1469,1531,0,3,94,78,1478,1522,T1
2831,November 14,2012,Austria,Ivory Coast,0,3,Friendly,in Austria,-12,12,1604,1838,-2,0,58,17,1616,1826,T2
2832,November 14,2012,Costa Rica,Bolivia,1,1,Friendly,in Bolivia,2,-2,1668,1628,0,0,46,53,1666,1630,draw
2833,November 14,2012,Colombia,Brazil,1,1,Friendly,in the United States,5,-5,1902,2074,-1,0,11,2,1897,2079,draw
2834,November 14,2012,Ukraine,Bulgaria,1,0,Friendly,in Bulgaria,12,-12,1713,1662,5,-3,33,47,1701,1674,T2
2835,November 14,2012,Democratic Republic of Congo,Burkina Faso,0,1,Friendly,in Morocco,-10,10,1439,1443,-4,3,102,100,1449,1433,T1
2836,November 14,2012,New Zealand,China,1,1,Friendly,in China,4,-4,1576,1627,0,-3,67,54,1572,1631,draw
2837,November 14,2012,Cuba,Suriname,5,0,CONCACAF Champ &amp; Carib Champ qual,in Trinidad and Tobago,25,-25,1373,1187,7,-5,116,159,1348,1212,T1
2838,November 14,2012,Finland,Cyprus,3,0,Friendly,in Cyprus,14,-14,1632,1425,3,-3,52,104,1618,1439,T2
2839,November 14,2012,Czechia,Slovakia,3,0,Friendly,in Czechia,6,-6,1775,1602,1,-1,25,59,1769,1608,T1
2840,November 14,2012,Gabon,Portugal,2,2,Friendly,in Gabon,7,-7,1542,1904,3,-1,74,10,1535,1911,draw
2841,November 14,2012,Egypt,Georgia,0,0,Friendly,in Georgia,-3,3,1698,1513,1,0,37,83,1701,1510,draw
2842,November 14,2012,Cape Verde,Ghana,0,1,Friendly,in Portugal,-4,4,1428,1678,1,0,103,44,1432,1674,T1
2843,November 14,2012,French Guiana,Grenada,1,1,CONCACAF Champ &amp; Carib Champ qual,in Grenada,2,-2,1234,1165,0,0,148,163,1232,1167,draw
2844,November 14,2012,Haiti,Guyana,1,0,CONCACAF Champ &amp; Carib Champ qual,in Grenada,14,-14,1451,1316,5,-2,97,129,1437,1330,T1
2845,November 14,2012,Peru,Honduras,0,0,Friendly,in the United States,-1,1,1709,1684,-1,1,35,41,1710,1683,draw
2846,November 14,2012,Hungary,Norway,0,2,Friendly,in Hungary,-18,18,1692,1759,-5,1,39,28,1710,1741,T2
2847,November 14,2012,Indonesia,East Timor,1,0,Friendly,in Indonesia,0,0,1261,615,0,0,142,227,1261,615,T1
2848,November 14,2012,Uzbekistan,Iran,1,0,World Cup qualifier,in Iran,29,-29,1654,1671,5,-5,49,45,1625,1700,T2
2849,November 14,2012,Jordan,Iraq,0,1,World Cup qualifier,in Qatar,-19,19,1524,1582,-5,5,80,65,1543,1563,T1
2850,November 14,2012,Ireland,Greece,0,1,Friendly,in Ireland,-11,11,1729,1825,-1,1,31,19,1740,1814,T2
2851,November 14,2012,Belarus,Israel,2,1,Friendly,in Israel,14,-14,1596,1617,2,-4,62,55,1582,1631,T2
2852,November 14,2012,France,Italy,2,1,Friendly,in Italy,14,-14,1889,1911,2,-1,12,8,1875,1925,T2
2853,November 14,2012,Kuwait,Bahrain,1,1,Friendly,in Kuwait,-4,4,1489,1446,1,2,89,98,1493,1442,draw
2854,November 14,2012,Liechtenstein,Malta,0,1,Friendly,in Liechtenstein,-12,12,1182,1242,-2,2,160,147,1194,1230,T2
2855,November 14,2012,Luxembourg,Scotland,1,2,Friendly,in Luxembourg,-2,2,1147,1657,0,0,168,48,1149,1655,T2
2856,November 14,2012,Slovenia,Macedonia,2,3,Friendly,in Macedonia,-9,9,1601,1539,-3,3,60,75,1610,1530,T1
2857,November 14,2012,Hong Kong,Malaysia,1,1,Friendly,in Malaysia,4,-4,1173,1214,0,0,162,153,1169,1218,draw
2858,November 14,2012,Montenegro,San Marino,3,0,World Cup qualifier,in Montenegro,0,0,1681,884,1,0,42,204,1681,884,T1
2859,November 14,2012,Morocco,Togo,0,1,Friendly,in Morocco,-17,17,1545,1404,-2,2,73,109,1562,1387,T2
2860,November 14,2012,Netherlands,Germany,0,0,Friendly,in the Netherlands,-1,1,1997,2052,0,0,5,3,1998,2051,draw
2861,November 14,2012,Senegal,Niger,1,1,Friendly,in Niger,-2,2,1523,1348,-1,0,81,124,1525,1346,draw
2862,November 14,2012,Venezuela,Nigeria,1,3,Friendly,in the United States,-19,19,1710,1652,-2,0,34,50,1729,1633,T1
2863,November 14,2012,Northern Ireland,Azerbaijan,1,1,World Cup qualifier,in Northern Ireland,-8,8,1443,1409,-3,2,100,107,1451,1401,draw
2864,November 14,2012,Japan,Oman,2,1,World Cup qualifier,in Oman,11,-11,1820,1538,1,-2,20,76,1809,1549,T2
2865,November 14,2012,Panama,Spain,1,5,Friendly,in Panama,-4,4,1681,2150,-1,0,42,1,1685,2146,T2
2866,November 14,2012,Paraguay,Guatemala,3,1,Friendly,in Paraguay,5,-5,1719,1549,1,0,32,72,1714,1554,T1
2867,November 14,2012,Uruguay,Poland,3,1,Friendly,in Poland,13,-13,1855,1694,1,-2,15,38,1842,1707,T2
2868,November 14,2012,Lebanon,Qatar,0,1,World Cup qualifier,in Qatar,-7,7,1316,1488,0,2,129,90,1323,1481,T1
2869,November 14,2012,Belgium,Romania,1,2,Friendly,in Romania,-9,9,1786,1754,0,-1,22,29,1795,1745,T1
2870,November 14,2012,United States,Russia,2,2,Friendly,in Russia,6,-6,1771,1887,1,-2,26,13,1765,1893,draw
2871,November 14,2012,Namibia,Rwanda,2,2,Friendly,in Rwanda,5,-5,1317,1398,3,-2,128,110,1312,1403,draw
2872,November 14,2012,Saudi Arabia,Argentina,0,0,Friendly,in Saudi Arabia,8,-8,1502,2000,2,0,87,4,1494,2008,draw
2873,November 14,2012,Chile,Serbia,1,3,Friendly,in Switzerland,-21,21,1803,1685,-3,7,21,40,1824,1664,T1
2874,November 14,2012,South Africa,Zambia,0,1,Friendly,in South Africa,-12,12,1568,1610,-3,6,68,56,1580,1598,T2
2875,November 14,2012,Australia,South Korea,2,1,Friendly,in South Korea,13,-13,1783,1763,2,-4,23,27,1770,1776,T2
2876,November 14,2012,Sweden,England,4,2,Friendly,in Sweden,14,-14,1907,1953,2,0,9,6,1893,1967,T1
2877,November 14,2012,Kenya,Tanzania,0,1,Friendly,in Tanzania,-8,8,1305,1302,-3,3,133,136,1313,1294,T1
2878,November 14,2012,Bhutan,Thailand,0,5,Friendly,in Thailand,0,0,544,1383,0,0,233,114,544,1383,T1
2879,November 14,2012,Trinidad and Tobago,Saint Vincent and the Grenadines,1,1,CONCACAF Champ &amp; Carib Champ qual,in Trinidad and Tobago,-16,16,1485,1210,-3,3,91,155,1501,1194,draw
2880,November 14,2012,Tunisia,Switzerland,1,2,Friendly,in Tunisia,-7,7,1595,1831,-3,0,63,18,1602,1824,T2
2881,November 14,2012,Turkey,Denmark,1,1,Friendly,in Turkey,-1,1,1702,1776,1,0,36,24,1703,1775,draw
2882,November 14,2012,United Arab Emirates,Estonia,2,1,Friendly,in the United Arab Emirates,9,-9,1461,1496,1,-1,95,88,1452,1505,T1
2883,November 15,2012,Singapore,Philippines,0,1,Friendly,in the Philippines,-10,10,1220,1156,-2,3,152,166,1230,1146,T1
2884,November 16,2012,Cuba,Saint Vincent and the Grenadines,1,1,CONCACAF Champ &amp; Carib Champ qual,in Trinidad and Tobago,-9,9,1364,1219,-3,2,119,153,1373,1210,draw
2885,November 16,2012,Haiti,French Guiana,0,1,CONCACAF Champ &amp; Carib Champ qual,in Grenada,-31,31,1420,1265,-8,6,105,142,1451,1234,T1
2886,November 16,2012,Grenada,Guyana,2,1,CONCACAF Champ &amp; Carib Champ qual,in Grenada,23,-23,1188,1293,5,-10,158,139,1165,1316,T1
2887,November 16,2012,Trinidad and Tobago,Suriname,3,0,CONCACAF Champ &amp; Carib Champ qual,in Trinidad and Tobago,6,-6,1491,1181,2,-2,89,161,1485,1187,T1
2888,November 17,2012,Syria,Palestine,1,1,Friendly,in Jordan,-6,6,1501,1255,-1,0,87,145,1507,1249,draw
2889,November 17,2012,Thailand,Bangladesh,5,0,Friendly,in Thailand,2,-2,1385,948,1,0,113,194,1383,950,T1
2890,November 18,2012,Grenada,Haiti,0,2,CONCACAF Champ &amp; Carib Champ qual,in Grenada,-19,19,1169,1439,-5,4,163,101,1188,1420,T2
2891,November 18,2012,French Guiana,Guyana,3,4,CONCACAF Champ &amp; Carib Champ qual,in Grenada,-18,18,1247,1311,-3,9,145,130,1265,1293,T1
2892,November 18,2012,Suriname,Saint Vincent and the Grenadines,1,0,CONCACAF Champ &amp; Carib Champ qual,in Trinidad and Tobago,22,-22,1203,1197,5,-5,156,158,1181,1219,T1
2893,November 18,2012,Cuba,Trinidad and Tobago,0,1,CONCACAF Champ &amp; Carib Champ qual,in Trinidad and Tobago,-9,9,1355,1500,-2,1,121,88,1364,1491,T1
2894,November 19,2012,Singapore,Pakistan,4,0,Friendly,in Singapore,3,-3,1223,905,1,0,151,200,1220,908,T1
2895,November 20,2012,Malaysia,Bangladesh,1,1,Friendly,in Malaysia,-8,8,1206,956,-1,0,154,194,1214,948,draw
2896,November 20,2012,Palestine,Syria,2,1,Friendly,in Jordan,16,-16,1271,1485,3,-4,141,91,1255,1501,T1
2897,November 21,2012,Argentina,Brazil,2,1,Friendly tournament,in Argentina,14,-14,2014,2060,0,0,4,2,2000,2074,T1
2898,November 24,2012,Ethiopia,South Sudan,1,0,CECAFA Cup,in Uganda,8,-8,1363,1099,2,-2,119,180,1355,1107,T1
2899,November 24,2012,Guam,Northern Mariana Islands,8,0,Friendly,in Guam,7,-7,681,458,3,0,220,234,674,465,T1
2900,November 24,2012,Myanmar,Vietnam,1,1,Southeast Asian Championship,in Thailand,13,-13,1025,1283,2,0,184,139,1012,1296,draw
2901,November 24,2012,Philippines,Thailand,1,2,Southeast Asian Championship,in Thailand,-5,5,1151,1390,-1,2,167,111,1156,1385,T1
2902,November 24,2012,Kenya,Uganda,0,1,CECAFA Cup,in Uganda,-5,5,1300,1531,-4,1,137,78,1305,1526,T1
2903,November 25,2012,Burundi,Somalia,5,1,CECAFA Cup,in Uganda,8,-8,1267,885,1,0,143,203,1259,893,T1
2904,November 25,2012,Indonesia,Laos,2,2,Southeast Asian Championship,in Malaysia,-17,17,1244,864,-5,2,148,206,1261,847,draw
2905,November 25,2012,Malaysia,Singapore,0,3,Southeast Asian Championship,in Malaysia,-43,43,1163,1266,-10,7,164,144,1206,1223,T2
2906,November 25,2012,Tanzania,Sudan,2,0,CECAFA Cup,in Uganda,42,-42,1344,1403,10,-11,125,109,1302,1445,T1
2907,November 26,2012,Zanzibar,Eritrea,0,0,CECAFA Cup,in Uganda,-8,8,1298,1168,-4,2,137,163,1306,1160,draw
2908,November 26,2012,Malawi,Rwanda,0,2,CECAFA Cup,in Uganda,-29,29,1360,1427,-8,7,120,103,1389,1398,T1
2909,November 27,2012,Kenya,South Sudan,2,0,CECAFA Cup,in Uganda,14,-14,1314,1085,5,-1,131,181,1300,1099,T1
2910,November 27,2012,Philippines,Vietnam,1,0,Southeast Asian Championship,in Thailand,27,-27,1178,1256,7,-5,160,144,1151,1283,T1
2911,November 27,2012,Thailand,Myanmar,4,0,Southeast Asian Championship,in Thailand,5,-5,1395,1020,0,-1,111,185,1390,1025,T1
2912,November 27,2012,Ethiopia,Uganda,0,1,CECAFA Cup,in Uganda,-7,7,1356,1538,-3,2,121,76,1363,1531,T1
2913,November 28,2012,Burundi,Tanzania,1,0,CECAFA Cup,in Uganda,24,-24,1291,1320,3,-3,139,128,1267,1344,T1
2914,November 28,2012,Singapore,Indonesia,0,1,Southeast Asian Championship,in Malaysia,-21,21,1245,1265,-3,5,146,143,1266,1244,T1
2915,November 28,2012,Malaysia,Laos,4,1,Southeast Asian Championship,in Malaysia,6,-6,1169,858,3,0,163,206,1163,864,T1
2916,November 28,2012,Sudan,Somalia,1,0,CECAFA Cup,in Uganda,2,-2,1405,883,1,-1,109,204,1403,885,T1
2917,November 29,2012,Bahrain,Palestine,2,0,Friendly,in Qatar,8,-8,1454,1263,0,-2,97,143,1446,1271,T1
2918,November 29,2012,Eritrea,Malawi,2,3,CECAFA Cup,in Uganda,-10,10,1158,1370,-1,4,166,115,1168,1360,T1
2919,November 29,2012,Zanzibar,Rwanda,2,1,CECAFA Cup,in Uganda,27,-27,1325,1400,9,-7,128,110,1298,1427,T1
2920,November 30,2012,Kenya,Ethiopia,3,1,CECAFA Cup,in Uganda,34,-34,1348,1322,9,-8,123,129,1314,1356,T1
2921,November 30,2012,Myanmar,Philippines,0,2,Southeast Asian Championship,in Thailand,-17,17,1003,1195,-3,2,188,158,1020,1178,T1
2922,November 30,2012,Vietnam,Thailand,1,3,Southeast Asian Championship,in Thailand,-12,12,1244,1407,-4,4,148,107,1256,1395,T1
2923,November 30,2012,Uganda,South Sudan,4,0,CECAFA Cup,in Uganda,3,-3,1541,1082,1,0,75,181,1538,1085,T1
2924,December 1,2012,Burundi,Sudan,1,0,CECAFA Cup,in Uganda,26,-26,1317,1379,9,-5,130,114,1291,1405,T1
2925,December 1,2012,Guam,Hong Kong,1,2,East Asian Cup qualifier,in Hong Kong,-1,1,680,1174,0,0,220,162,681,1173,T1
2926,December 1,2012,Zanzibar,Malawi,0,2,CECAFA Cup,in Uganda,-26,26,1299,1396,-10,4,138,111,1325,1370,T1
2927,December 1,2012,Malaysia,Indonesia,2,0,Southeast Asian Championship,in Malaysia,30,-30,1199,1235,6,-7,157,149,1169,1265,T1
2928,December 1,2012,Taiwan,North Korea,1,6,East Asian Cup qualifier,in Hong Kong,-2,2,893,1552,-1,0,202,71,895,1550,T1
2929,December 1,2012,Rwanda,Eritrea,2,0,CECAFA Cup,in Uganda,12,-12,1412,1146,6,-3,105,169,1400,1158,T1
2930,December 1,2012,Laos,Singapore,3,4,Southeast Asian Championship,in Malaysia,-4,4,854,1249,-1,2,207,143,858,1245,T1
2931,December 1,2012,Somalia,Tanzania,0,7,CECAFA Cup,in Uganda,-7,7,876,1327,0,2,204,128,883,1320,T1
2932,December 3,2012,Bahrain,Iraq,0,0,Friendly,in Qatar,4,-4,1458,1578,1,-1,96,66,1454,1582,draw
2933,December 3,2012,Burundi,Zanzibar,0,0,CECAFA Cup,in Uganda,-1,1,1316,1300,-1,0,131,138,1317,1299,draw
2934,December 3,2012,Australia,Hong Kong,1,0,East Asian Cup qualifier,in Hong Kong,2,-2,1785,1172,0,-1,23,163,1783,1174,T2
2935,December 3,2012,Guam,North Korea,0,5,East Asian Cup qualifier,in Hong Kong,-1,1,679,1553,0,0,220,71,680,1552,T1
2936,December 3,2012,Rwanda,Tanzania,0,2,CECAFA Cup,in Uganda,-37,37,1375,1364,-10,9,115,119,1412,1327,T1
2937,December 4,2012,Kenya,Malawi,1,0,CECAFA Cup,in Uganda,23,-23,1371,1373,8,-5,116,115,1348,1396,T1
2938,December 4,2012,Uganda,Ethiopia,2,0,CECAFA Cup,in Uganda,8,-8,1549,1314,3,-3,72,132,1541,1322,T1
2939,December 5,2012,Australia,North Korea,1,1,East Asian Cup qualifier,in Hong Kong,-12,12,1773,1565,-2,1,25,70,1785,1553,draw
2940,December 5,2012,Taiwan,Guam,1,1,East Asian Cup qualifier,in Hong Kong,-11,11,882,690,-1,3,203,217,893,679,draw
2941,December 5,2012,Zambia,Saudi Arabia,1,2,Friendly,in Saudi Arabia,-10,10,1600,1512,-4,2,60,84,1610,1502,T1
2942,December 6,2012,Zanzibar,Kenya,2,2,CECAFA Cup,in Uganda,4,-4,1304,1367,2,-1,136,117,1300,1371,draw
2943,December 6,2012,Tanzania,Uganda,0,3,CECAFA Cup,in Uganda,-11,11,1353,1560,-4,0,124,72,1364,1549,T1
2944,December 7,2012,Antigua and Barbuda,Dominican Republic,1,2,CONCACAF Champ qual &amp; Carib Champ,in Antigua and Barbuda,-27,27,1242,1272,-6,4,147,141,1269,1245,T2
2945,December 7,2012,Australia,Guam,9,0,East Asian Cup qualifier,in Hong Kong,0,0,1773,690,0,0,25,217,1773,690,T1
2946,December 7,2012,Haiti,Trinidad and Tobago,0,0,CONCACAF Champ qual &amp; Carib Champ,in Antigua and Barbuda,3,-3,1442,1497,0,0,100,87,1439,1500,draw
2947,December 7,2012,Hong Kong,Taiwan,2,0,East Asian Cup qualifier,in Hong Kong,6,-6,1178,876,1,0,162,203,1172,882,T1
2948,December 8,2012,French Guiana,Jamaica,2,1,CONCACAF Champ qual &amp; Carib Champ,in Antigua and Barbuda,36,-36,1283,1603,4,-6,140,57,1247,1639,T1
2949,December 8,2012,Palestine,Kuwait,1,2,West Asian Championship,in Kuwait,-5,5,1258,1494,-1,0,143,89,1263,1489,T1
2950,December 8,2012,Oman,Lebanon,0,1,West Asian Championship,in Kuwait,-31,31,1507,1347,-9,5,86,125,1538,1316,T1
2951,December 8,2012,Martinique,Cuba,1,0,CONCACAF Champ qual &amp; Carib Champ,in Antigua and Barbuda,19,-19,1385,1336,7,-5,111,127,1366,1355,T1
2952,December 8,2012,Philippines,Singapore,0,0,Southeast Asian Championship,in the Philippines,-3,3,1192,1252,0,-1,159,144,1195,1249,draw
2953,December 8,2012,Tanzania,Zanzibar,1,1,CECAFA Cup,in Uganda,-3,3,1350,1307,1,1,123,135,1353,1304,draw
2954,December 8,2012,Kenya,Uganda,1,2,CECAFA Cup,in Uganda,-6,6,1361,1566,-3,2,120,70,1367,1560,T1
2955,December 9,2012,Trinidad and Tobago,Antigua and Barbuda,0,2,CONCACAF Champ qual &amp; Carib Champ,in Antigua and Barbuda,-43,43,1454,1285,-10,7,97,140,1497,1242,T1
2956,December 9,2012,Australia,Taiwan,8,0,East Asian Cup qualifier,in Hong Kong,1,-1,1774,875,0,-1,25,204,1773,876,T1
2957,December 9,2012,Yemen,Bahrain,0,1,West Asian Championship,in Kuwait,-12,12,1293,1470,-3,3,139,93,1305,1458,T1
2958,December 9,2012,Dominican Republic,Haiti,1,2,CONCACAF Champ qual &amp; Carib Champ,in Antigua and Barbuda,-11,11,1261,1453,-1,2,143,98,1272,1442,T1
2959,December 9,2012,Hong Kong,North Korea,0,4,East Asian Cup qualifier,in Hong Kong,-12,12,1166,1577,-2,4,164,67,1178,1565,T2
2960,December 9,2012,Iran,Saudi Arabia,0,0,West Asian Championship,in Kuwait,-9,9,1662,1521,-1,2,46,81,1671,1512,draw
2961,December 9,2012,Thailand,Malaysia,1,1,Southeast Asian Championship,in Malaysia,-6,6,1401,1205,-2,3,109,154,1407,1199,draw
2962,December 10,2012,French Guiana,Cuba,1,2,CONCACAF Champ qual &amp; Carib Champ,in Antigua and Barbuda,-17,17,1266,1353,-1,4,142,123,1283,1336,T1
2963,December 10,2012,Jordan,Iraq,0,1,West Asian Championship,in Kuwait,-17,17,1507,1595,-6,4,85,62,1524,1578,T1
2964,December 10,2012,Jamaica,Martinique,0,0,CONCACAF Champ qual &amp; Carib Champ,in Antigua and Barbuda,-11,11,1592,1396,-7,1,64,110,1603,1385,draw
2965,December 11,2012,Antigua and Barbuda,Haiti,0,1,CONCACAF Champ qual &amp; Carib Champ,in Antigua and Barbuda,-16,16,1269,1469,-2,5,142,93,1285,1453,T2
2966,December 11,2012,Kuwait,Oman,0,2,West Asian Championship,in Kuwait,-37,37,1457,1544,-9,10,97,75,1494,1507,T2
2967,December 11,2012,Palestine,Lebanon,1,0,West Asian Championship,in Kuwait,25,-25,1283,1322,4,-3,140,129,1258,1347,T1
2968,December 11,2012,Trinidad and Tobago,Dominican Republic,2,1,CONCACAF Champ qual &amp; Carib Champ,in Antigua and Barbuda,10,-10,1464,1251,2,-2,95,145,1454,1261,T1
2969,December 12,2012,Bahrain,Iran,0,0,West Asian Championship,in Kuwait,10,-10,1480,1652,1,-3,91,49,1470,1662,draw
2970,December 12,2012,Cuba,Jamaica,1,0,CONCACAF Champ qual &amp; Carib Champ,in Antigua and Barbuda,32,-32,1385,1560,11,-8,112,72,1353,1592,T1
2971,December 12,2012,Martinique,French Guiana,3,1,CONCACAF Champ qual &amp; Carib Champ,in Antigua and Barbuda,19,-19,1415,1247,5,-2,105,145,1396,1266,T1
2972,December 12,2012,Saudi Arabia,Yemen,1,0,West Asian Championship,in Kuwait,8,-8,1529,1285,1,0,80,139,1521,1293,T1
2973,December 12,2012,Singapore,Philippines,1,0,Southeast Asian Championship,in Singapore,11,-11,1263,1181,1,-2,143,161,1252,1192,T1
2974,December 13,2012,Iraq,Syria,1,1,West Asian Championship,in Kuwait,-6,6,1589,1491,-1,1,63,88,1595,1485,draw
2975,December 13,2012,Thailand,Malaysia,2,0,Southeast Asian Championship,in Thailand,9,-9,1410,1196,3,-4,107,158,1401,1205,T1
2976,December 14,2012,Haiti,Cuba,0,1,Caribbean Championship,in Antigua and Barbuda,-25,25,1444,1410,-5,5,98,107,1469,1385,T1
2977,December 14,2012,Kuwait,Lebanon,2,1,West Asian Championship,in Kuwait,8,-8,1465,1314,3,-2,94,131,1457,1322,T1
2978,December 14,2012,Trinidad and Tobago,Martinique,1,1,Caribbean Championship,in Antigua and Barbuda,-3,3,1461,1418,0,0,95,105,1464,1415,draw
2979,December 14,2012,Palestine,Oman,1,2,West Asian Championship,in Kuwait,-7,7,1276,1551,-1,2,141,73,1283,1544,T1
2980,December 14,2012,Macedonia,Poland,1,4,Friendly,in Turkey,-10,10,1529,1704,-2,2,79,36,1539,1694,T1
2981,December 15,2012,Angola,Gambia,1,1,Friendly,in Angola,-6,6,1470,1335,0,1,92,127,1476,1329,draw
2982,December 15,2012,Bahrain,Saudi Arabia,1,0,West Asian Championship,in Kuwait,23,-23,1503,1506,4,-7,87,86,1480,1529,T1
2983,December 15,2012,Yemen,Iran,1,2,West Asian Championship,in Kuwait,-4,4,1281,1656,0,1,139,48,1285,1652,T1
2984,December 16,2012,Cuba,Trinidad and Tobago,1,0,Caribbean Championship,in Antigua and Barbuda,23,-23,1433,1438,5,-6,102,101,1410,1461,T1
2985,December 16,2012,Martinique,Haiti,0,1,Caribbean Championship,in Antigua and Barbuda,-19,19,1399,1463,-6,3,111,95,1418,1444,T1
2986,December 16,2012,Jordan,Syria,1,2,West Asian Championship,in Kuwait,-21,21,1486,1512,-5,6,90,83,1507,1491,T1
2987,December 18,2012,Bahrain,Syria,1,1,West Asian Championship,in Kuwait,1,-1,1504,1511,0,0,87,83,1503,1512,draw
2988,December 18,2012,Oman,Iraq,0,2,West Asian Championship,in Kuwait,-27,27,1524,1616,-6,8,79,55,1551,1589,T1
2989,December 19,2012,Benin,Oman,0,2,Friendly,in Oman,-7,7,1400,1531,0,2,109,77,1407,1524,T1
2990,December 19,2012,Thailand,Singapore,1,3,Southeast Asian Championship,in Singapore,-34,34,1376,1297,-8,4,115,139,1410,1263,T1
2991,December 20,2012,Bahrain,Oman,0,1,West Asian Championship,in Kuwait,-18,18,1486,1549,-2,4,89,73,1504,1531,T1
2992,December 20,2012,Syria,Iraq,1,0,West Asian Championship,in Kuwait,26,-26,1537,1590,6,-8,77,63,1511,1616,T1
2993,December 22,2012,Angola,Rwanda,1,0,Friendly,in Angola,5,-5,1475,1370,0,0,92,116,1470,1375,T1
2994,December 22,2012,South Africa,Malawi,3,1,Friendly,in South Africa,5,-5,1573,1368,0,-1,68,118,1568,1373,T1
2995,December 22,2012,Tanzania,Zambia,1,0,Friendly,in Tanzania,14,-14,1364,1586,4,-4,120,63,1350,1600,T1
2996,December 22,2012,Singapore,Thailand,0,1,Southeast Asian Championship,in Thailand,-11,11,1286,1387,0,4,139,111,1297,1376,T1
2997,December 25,2012,Yemen,United Arab Emirates,0,2,Friendly,in Qatar,-8,8,1273,1469,-2,3,142,93,1281,1461,T1
2998,December 26,2012,Bahrain,Burkina Faso,0,0,Friendly,in Bahrain,-4,4,1482,1447,-2,0,91,98,1486,1443,draw
2999,December 28,2012,Egypt,Qatar,2,0,Friendly,in Qatar,10,-10,1708,1478,2,-3,36,91,1698,1488,T2
3000,December 29,2012,Guinea,Bahrain,0,3,Friendly,in Bahrain,-14,14,1504,1496,-4,3,86,87,1518,1482,T1
3001,December 29,2012,Oman,Togo,0,1,Friendly,in Oman,-16,16,1533,1420,-5,2,78,106,1549,1404,T2
3002,December 29,2012,United Arab Emirates,Yemen,3,1,Friendly,in Qatar,7,-7,1476,1266,1,-1,92,143,1469,1273,T1
3003,December 30,2012,Ethiopia,Niger,1,0,Friendly,in Ethiopia,8,-8,1322,1340,2,0,129,125,1314,1348,T1
3004,January 5,2013,Angola,Zambia,2,0,Friendly,in South Africa,20,-20,1495,1566,4,-7,89,69,1475,1586,T1
3005,January 5,2013,Oman,Bahrain,0,0,Gulf Cup,in Bahrain,4,-4,1537,1492,2,-3,76,90,1533,1496,draw
3006,January 5,2013,Niger,Togo,3,1,Friendly,in Niger,14,-14,1354,1406,1,-2,124,108,1340,1420,T1
3007,January 5,2013,United Arab Emirates,Qatar,3,1,Gulf Cup,in Bahrain,30,-30,1506,1448,7,-6,85,97,1476,1478,T1
3008,January 6,2013,Iraq,Saudi Arabia,2,0,Gulf Cup,in Bahrain,24,-24,1604,1482,6,-7,57,92,1580,1506,T1
3009,January 6,2013,Yemen,Kuwait,0,2,Gulf Cup,in Bahrain,-14,14,1252,1479,0,1,143,93,1266,1465,T1
3010,January 7,2013,Ethiopia,Tunisia,1,1,Friendly,in Qatar,7,-7,1329,1598,0,-6,129,61,1322,1605,draw
3011,January 8,2013,Bahrain,United Arab Emirates,1,2,Gulf Cup,in Bahrain,-25,25,1467,1531,-6,7,95,78,1492,1506,T2
3012,January 8,2013,Zambia,Morocco,0,0,Friendly,in South Africa,-1,1,1565,1546,0,0,69,74,1566,1545,draw
3013,January 8,2013,Oman,Qatar,1,2,Gulf Cup,in Bahrain,-25,25,1512,1473,-7,4,83,93,1537,1448,T1
3014,January 8,2013,Norway,South Africa,1,0,Friendly,in South Africa,8,-8,1767,1565,1,-2,27,69,1759,1573,T2
3015,January 9,2013,Cape Verde,Nigeria,0,0,Friendly,in Portugal,6,-6,1434,1646,1,0,102,50,1428,1652,draw
3016,January 9,2013,Iraq,Kuwait,1,0,Gulf Cup,in Bahrain,13,-13,1617,1466,2,-3,54,95,1604,1479,T1
3017,January 9,2013,Yemen,Saudi Arabia,0,2,Gulf Cup,in Bahrain,-13,13,1239,1495,-5,3,148,88,1252,1482,T1
3018,January 10,2013,Niger,Burkina Faso,0,0,Friendly,in South Africa,3,-3,1357,1444,0,0,124,98,1354,1447,draw
3019,January 10,2013,Gabon,Tunisia,1,1,Friendly,in the United Arab Emirates,2,-2,1544,1596,1,0,74,61,1542,1598,draw
3020,January 10,2013,Ghana,Egypt,3,0,Friendly,in the United Arab Emirates,19,-19,1697,1689,6,-4,38,40,1678,1708,T1
3021,January 10,2013,Panama,Guatemala,3,0,Friendly,in Panama,7,-7,1688,1542,1,-2,41,75,1681,1549,T1
3022,January 11,2013,Bahrain,Qatar,1,0,Gulf Cup,in Bahrain,15,-15,1482,1458,2,-4,92,96,1467,1473,T1
3023,January 11,2013,Tanzania,Ethiopia,1,2,Friendly,in Ethiopia,-8,8,1356,1337,-4,2,124,127,1364,1329,T1
3024,January 11,2013,Oman,United Arab Emirates,0,2,Gulf Cup,in Bahrain,-28,28,1484,1559,-8,5,91,73,1512,1531,T1
3025,January 12,2013,Iraq,Yemen,2,0,Gulf Cup,in Bahrain,6,-6,1623,1233,0,-1,54,149,1617,1239,T1
3026,January 12,2013,Kuwait,Saudi Arabia,1,0,Gulf Cup,in Bahrain,22,-22,1488,1473,6,-6,88,93,1466,1495,T1
3027,January 12,2013,Namibia,Morocco,1,2,Friendly,in South Africa,-4,4,1313,1550,-2,0,132,74,1317,1546,T1
3028,January 12,2013,South Africa,Algeria,0,0,Friendly,in South Africa,-3,3,1562,1566,-2,2,71,69,1565,1563,draw
3029,January 12,2013,Norway,Zambia,0,0,Friendly,in Zambia,-3,3,1764,1568,0,2,27,67,1767,1565,draw
3030,January 13,2013,Botswana,Angola,0,2,Friendly,in South Africa,-7,7,1295,1502,-1,1,138,86,1302,1495,T1
3031,January 13,2013,Ghana,Tunisia,4,2,Friendly,in the United Arab Emirates,11,-11,1708,1585,2,-2,36,63,1697,1596,T1
3032,January 13,2013,Guatemala,Panama,0,2,Friendly,in Panama,-6,6,1536,1694,-2,2,78,39,1542,1688,T1
3033,January 13,2013,Niger,Togo,1,2,Friendly,in Togo,-6,6,1351,1412,-2,2,125,106,1357,1406,T1
3034,January 14,2013,Ivory Coast,Egypt,4,2,Friendly,in the United Arab Emirates,9,-9,1847,1680,0,-3,17,44,1838,1689,T1
3035,January 15,2013,Bahrain,Iraq,1,1,Gulf Cup,in Bahrain,2,-2,1484,1621,2,0,90,54,1482,1623,draw
3036,January 15,2013,Lebanon,Gabon,0,0,Friendly,in Lebanon,4,-4,1318,1540,1,0,130,75,1314,1544,draw
3037,January 15,2013,Kuwait,United Arab Emirates,0,1,Gulf Cup,in Bahrain,-16,16,1472,1575,-5,6,93,67,1488,1559,T1
3038,January 17,2013,Burkina Faso,Swaziland,3,0,Friendly,in South Africa,4,-4,1448,1106,0,-1,98,178,1444,1110,T1
3039,January 18,2013,Bahrain,Kuwait,1,6,Gulf Cup,in Bahrain,-52,52,1432,1524,-13,13,103,80,1484,1472,T2
3040,January 18,2013,Costa Rica,Belize,1,0,CONCACAF Champ q &amp; Central Am Cup,in Costa Rica,1,-1,1669,1129,0,-1,45,174,1668,1130,T1
3041,January 18,2013,El Salvador,Honduras,1,1,CONCACAF Champ q &amp; Central Am Cup,in Costa Rica,8,-8,1545,1676,1,-2,75,44,1537,1684,draw
3042,January 18,2013,Nicaragua,Guatemala,1,1,CONCACAF Champ q &amp; Central Am Cup,in Costa Rica,17,-17,1138,1519,3,-4,172,82,1121,1536,draw
3043,January 18,2013,Iraq,United Arab Emirates,1,2,Gulf Cup,in Bahrain,-23,23,1598,1598,-6,7,60,60,1621,1575,T1
3044,January 19,2013,Angola,Morocco,0,0,African Nations Cup,in South Africa,3,-3,1505,1547,1,0,86,74,1502,1550,draw
3045,January 19,2013,Chile,Haiti,3,0,Friendly,in Chile,3,-3,1806,1460,0,0,21,94,1803,1463,T1
3046,January 19,2013,South Africa,Cape Verde,0,0,African Nations Cup,in South Africa,-14,14,1548,1448,-1,4,73,97,1562,1434,draw
3047,January 20,2013,Guatemala,Belize,0,0,CONCACAF Champ q &amp; Central Am Cup,in Costa Rica,-16,16,1503,1145,-5,3,87,171,1519,1129,draw
3048,January 20,2013,Costa Rica,Nicaragua,2,0,CONCACAF Champ q &amp; Central Am Cup,in Costa Rica,2,-2,1671,1136,0,-1,45,173,1669,1138,T1
3049,January 20,2013,Democratic Republic of Congo,Ghana,2,2,African Nations Cup,in South Africa,16,-16,1455,1692,4,-2,96,38,1439,1708,draw
3050,January 20,2013,Panama,El Salvador,0,0,CONCACAF Champ q &amp; Central Am Cup,in Costa Rica,-8,8,1686,1553,-1,2,40,73,1694,1545,draw
3051,January 20,2013,Niger,Mali,0,1,African Nations Cup,in South Africa,-9,9,1342,1614,0,0,125,55,1351,1605,T1
3052,January 21,2013,Nigeria,Burkina Faso,1,1,African Nations Cup,in South Africa,-13,13,1633,1461,0,4,50,94,1646,1448,draw
3053,January 21,2013,Zambia,Ethiopia,1,1,African Nations Cup,in South Africa,-15,15,1553,1352,-4,2,72,125,1568,1337,draw
3054,January 22,2013,Belize,Nicaragua,2,1,CONCACAF Champ q &amp; Central Am Cup,in Costa Rica,19,-19,1164,1117,6,-3,165,176,1145,1136,T1
3055,January 22,2013,Costa Rica,Guatemala,1,1,CONCACAF Champ q &amp; Central Am Cup,in Costa Rica,-13,13,1658,1516,-1,5,46,82,1671,1503,draw
3056,January 22,2013,Panama,Honduras,1,1,CONCACAF Champ q &amp; Central Am Cup,in Costa Rica,-1,1,1685,1677,0,0,40,44,1686,1676,draw
3057,January 22,2013,Ivory Coast,Togo,2,1,African Nations Cup,in South Africa,4,-4,1851,1408,1,-2,16,108,1847,1412,T1
3058,January 22,2013,Tunisia,Algeria,1,0,African Nations Cup,in South Africa,24,-24,1609,1542,8,-6,56,75,1585,1566,T1
3059,January 23,2013,Morocco,Cape Verde,1,1,African Nations Cup,in South Africa,-7,7,1540,1455,-1,2,75,97,1547,1448,draw
3060,January 23,2013,Sweden,North Korea,1,1,King's Cup,in Thailand,-11,11,1896,1588,-2,2,11,64,1907,1577,draw
3061,January 23,2013,Angola,South Africa,0,2,African Nations Cup,in South Africa,-23,23,1482,1571,-5,5,91,68,1505,1548,T1
3062,January 23,2013,Finland,Thailand,3,1,King's Cup,in Thailand,14,-14,1646,1373,1,-4,50,115,1632,1387,T2
3063,January 24,2013,Democratic Republic of Congo,Niger,0,0,African Nations Cup,in South Africa,-8,8,1447,1350,-2,0,99,126,1455,1342,draw
3064,January 24,2013,Mali,Ghana,0,1,African Nations Cup,in South Africa,-19,19,1595,1711,-8,4,63,34,1614,1692,T1
3065,January 25,2013,Ethiopia,Burkina Faso,0,4,African Nations Cup,in South Africa,-33,33,1319,1494,-4,6,129,88,1352,1461,T1
3066,January 25,2013,Costa Rica,El Salvador,1,0,Central American Cup,in Costa Rica,9,-9,1667,1544,1,-1,45,73,1658,1553,T1
3067,January 25,2013,Honduras,Belize,1,0,Central American Cup,in Costa Rica,2,-2,1679,1162,0,-1,44,166,1677,1164,T1
3068,January 25,2013,Zambia,Nigeria,1,1,African Nations Cup,in South Africa,6,-6,1559,1627,0,-1,72,52,1553,1633,draw
3069,January 25,2013,Panama,Guatemala,3,1,CONCACAF Champ q &amp; Central Am Cup,in Costa Rica,16,-16,1701,1500,1,-4,39,86,1685,1516,T1
3070,January 26,2013,Ivory Coast,Tunisia,3,0,African Nations Cup,in South Africa,17,-17,1868,1592,1,-8,15,63,1851,1609,T1
3071,January 26,2013,Finland,Sweden,0,3,King's Cup,in Thailand,-10,10,1636,1906,0,2,50,9,1646,1896,T1
3072,January 26,2013,North Korea,Thailand,2,2,King's Cup,in Thailand,-5,5,1583,1378,-1,0,65,115,1588,1373,draw
3073,January 26,2013,Algeria,Togo,0,2,African Nations Cup,in South Africa,-51,51,1491,1459,-14,12,88,96,1542,1408,T1
3074,January 27,2013,Angola,Cape Verde,1,2,African Nations Cup,in South Africa,-27,27,1455,1482,-6,6,98,92,1482,1455,T1
3075,January 27,2013,Honduras,Costa Rica,0,1,Central American Cup,in Costa Rica,-15,15,1664,1682,-1,3,45,42,1679,1667,T1
3076,January 27,2013,Belize,El Salvador,0,1,Central American Cup,in Costa Rica,-4,4,1158,1548,0,-1,166,74,1162,1544,T1
3077,January 27,2013,Morocco,South Africa,2,2,African Nations Cup,in South Africa,9,-9,1549,1562,1,-2,73,70,1540,1571,draw
3078,January 28,2013,Democratic Republic of Congo,Mali,1,1,African Nations Cup,in South Africa,10,-10,1457,1585,2,-2,98,64,1447,1595,draw
3079,January 28,2013,Ghana,Niger,3,0,African Nations Cup,in South Africa,10,-10,1721,1340,2,0,32,125,1711,1350,T1
3080,January 29,2013,Zambia,Burkina Faso,0,0,African Nations Cup,in South Africa,-5,5,1554,1499,0,1,72,86,1559,1494,draw
3081,January 29,2013,Ethiopia,Nigeria,0,2,African Nations Cup,in South Africa,-11,11,1308,1638,-5,2,134,50,1319,1627,T1
3082,January 29,2013,United States,Canada,0,0,Friendly,in the United States,-7,7,1764,1593,0,1,26,62,1771,1586,draw
3083,January 30,2013,Ivory Coast,Algeria,2,2,African Nations Cup,in South Africa,-20,20,1848,1511,-2,6,17,82,1868,1491,draw
3084,January 30,2013,China,Oman,0,1,Friendly,in Oman,-11,11,1616,1495,-1,2,54,89,1627,1484,T1
3085,January 30,2013,Togo,Tunisia,1,1,African Nations Cup,in South Africa,9,-9,1468,1583,1,-1,95,64,1459,1592,draw
3086,January 31,2013,Jordan,Indonesia,5,0,Friendly,in Jordan,5,-5,1491,1230,0,-2,90,150,1486,1235,T1
3087,January 31,2013,North Korea,United Arab Emirates,1,0,Friendly,in China,10,-10,1593,1588,3,-4,61,63,1583,1598,T1
3088,January 31,2013,Qatar,Lebanon,1,0,Friendly,in Qatar,4,-4,1462,1314,1,-1,96,130,1458,1318,T1
3089,February 1,2013,Azerbaijan,Uzbekistan,0,0,Friendly,in the United Arab Emirates,6,-6,1415,1648,1,0,107,49,1409,1654,draw
3090,February 1,2013,Bahrain,Singapore,3,1,Friendly,in Bahrain,6,-6,1438,1280,2,0,102,139,1432,1286,T1
3091,February 1,2013,Malaysia,Iraq,0,3,Friendly,in the United Arab Emirates,-3,3,1193,1601,0,2,158,57,1196,1598,T1
3092,February 2,2013,Cape Verde,Ghana,0,2,African Nations Cup,in South Africa,-15,15,1467,1736,-3,1,95,31,1482,1721,T1
3093,February 2,2013,South Africa,Mali,1,1,African Nations Cup,in South Africa,-5,5,1557,1590,-1,1,71,63,1562,1585,draw
3094,February 3,2013,Togo,Burkina Faso,0,1,African Nations Cup,in South Africa,-23,23,1445,1522,-6,6,100,81,1468,1499,T1
3095,February 3,2013,Nigeria,Ivory Coast,2,1,African Nations Cup,in South Africa,39,-39,1677,1809,5,-3,45,20,1638,1848,T1
3096,February 5,2013,Luxembourg,Armenia,1,1,Friendly,in France,8,-8,1155,1523,2,-2,167,79,1147,1531,draw
3097,February 5,2013,Guinea,Senegal,1,1,Friendly,in France,1,-1,1505,1522,0,0,86,80,1504,1523,draw
3098,February 6,2013,Albania,Georgia,1,2,Friendly,in Albania,-13,13,1497,1526,-4,3,88,79,1510,1513,T2
3099,February 6,2013,Liechtenstein,Azerbaijan,0,1,Friendly,in the United Arab Emirates,-4,4,1178,1419,-2,1,162,106,1182,1415,T1
3100,February 6,2013,Yemen,Bahrain,0,2,Asian Cup qualifier,in the United Arab Emirates,-14,14,1219,1452,-4,2,152,100,1233,1438,T1
3101,February 6,2013,Belarus,Hungary,1,1,Friendly,in Turkey,3,-3,1599,1689,5,-1,55,41,1596,1692,draw
3102,February 6,2013,Slovakia,Belgium,1,2,Friendly,in Belgium,-3,3,1599,1789,1,-1,55,23,1602,1786,T1
3103,February 6,2013,Bolivia,Haiti,2,1,Friendly,in Bolivia,4,-4,1632,1456,2,-1,50,97,1628,1460,T1
3104,February 6,2013,Ghana,Burkina Faso,1,1,African Nations Cup,in South Africa,-14,14,1722,1536,-3,2,34,78,1736,1522,draw
3105,February 6,2013,Egypt,Chile,1,2,Friendly,in Spain,-7,7,1673,1813,-2,1,46,20,1680,1806,T1
3106,February 6,2013,Colombia,Guatemala,4,1,Friendly,in the United States,3,-3,1905,1497,3,-1,8,88,1902,1500,T1
3107,February 6,2013,Croatia,South Korea,4,0,Friendly,in England,13,-13,1893,1750,3,0,11,28,1880,1763,T1
3108,February 6,2013,Serbia,Cyprus,3,1,Friendly,in Cyprus,9,-9,1694,1416,3,-2,38,107,1685,1425,T2
3109,February 6,2013,England,Brazil,2,1,Friendly,in England,10,-10,1963,2050,0,-1,6,3,1953,2060,T1
3110,February 6,2013,Germany,France,2,1,Friendly,in France,8,-8,2060,1881,1,-2,2,14,2052,1889,T2
3111,February 6,2013,Greece,Switzerland,0,0,Friendly,in Greece,-3,3,1822,1834,-1,0,19,17,1825,1831,draw
3112,February 6,2013,United States,Honduras,1,2,World Cup qualifier,in Honduras,-20,20,1744,1684,-4,2,30,44,1764,1664,T1
3113,February 6,2013,Palestine,India,4,2,Friendly,in India,14,-14,1290,1141,3,-5,138,172,1276,1155,T2
3114,February 6,2013,Lebanon,Iran,0,5,Asian Cup qualifier,in Iran,-6,6,1308,1662,-3,2,133,47,1314,1656,T1
3115,February 6,2013,Iraq,Indonesia,1,0,Asian Cup qualifier,in the United Arab Emirates,4,-4,1605,1226,3,1,54,149,1601,1230,T1
3116,February 6,2013,Ireland,Poland,2,0,Friendly,in Ireland,10,-10,1739,1694,1,-1,31,38,1729,1704,T1
3117,February 6,2013,Finland,Israel,1,2,Friendly,in Israel,-8,8,1628,1625,-1,0,52,53,1636,1617,T1
3118,February 6,2013,Japan,Latvia,3,0,Friendly,in Japan,3,-3,1823,1507,1,-1,18,85,1820,1510,T1
3119,February 6,2013,Singapore,Jordan,0,4,Asian Cup qualifier,in Jordan,-11,11,1269,1502,-2,3,141,87,1280,1491,T1
3120,February 6,2013,Kazakhstan,Moldova,3,1,Friendly,in Turkey,18,-18,1357,1393,3,-2,123,110,1339,1411,T1
3121,February 6,2013,Libya,Kenya,0,3,Friendly,in Tunisia,-27,27,1541,1388,-8,10,76,111,1568,1361,T1
3122,February 6,2013,Macedonia,Denmark,3,0,Friendly,in Macedonia,24,-24,1553,1752,5,-4,72,27,1529,1776,T1
3123,February 6,2013,Malta,Northern Ireland,0,0,Friendly,in Malta,3,-3,1245,1440,2,-1,145,102,1242,1443,draw
3124,February 6,2013,Mexico,Jamaica,0,0,World Cup qualifier,in Mexico,-17,17,1900,1577,-2,4,9,66,1917,1560,draw
3125,February 6,2013,Myanmar,Philippines,0,1,Friendly,in Myanmar,-8,8,995,1189,-1,3,189,158,1003,1181,T2
3126,February 6,2013,Pakistan,Nepal,1,0,Friendly,in Nepal,13,-13,918,907,2,-2,198,200,905,920,T2
3127,February 6,2013,Italy,Netherlands,1,1,Friendly,in the Netherlands,5,-5,1916,1992,1,0,7,5,1911,1997,draw
3128,February 6,2013,Mali,Nigeria,1,4,African Nations Cup,in South Africa,-33,33,1557,1710,-6,9,69,36,1590,1677,T1
3129,February 6,2013,North Korea,Laos,1,0,Friendly,in China,0,0,1593,854,1,0,60,207,1593,854,T1
3130,February 6,2013,Oman,Syria,1,0,Asian Cup qualifier,in Oman,17,-17,1512,1520,6,-6,83,82,1495,1537,T1
3131,February 6,2013,Panama,Costa Rica,2,2,World Cup qualifier,in Panama,-7,7,1694,1689,1,1,38,41,1701,1682,draw
3132,February 6,2013,Paraguay,El Salvador,3,0,Friendly,in Paraguay,6,-6,1725,1542,0,-1,33,75,1719,1548,T1
3133,February 6,2013,Portugal,Ecuador,2,3,Friendly,in Portugal,-14,14,1890,1864,-2,1,12,15,1904,1850,T2
3134,February 6,2013,Malaysia,Qatar,0,2,Asian Cup qualifier,in Qatar,-6,6,1187,1468,-2,1,160,94,1193,1462,T1
3135,February 6,2013,Australia,Romania,2,3,Friendly,in Spain,-11,11,1763,1765,0,5,25,24,1774,1754,T1
3136,February 6,2013,Russia,Iceland,2,0,Friendly,in Spain,3,-3,1890,1482,1,-1,12,92,1887,1485,T1
3137,February 6,2013,Uganda,Rwanda,2,2,Friendly,in Rwanda,-3,3,1563,1373,1,0,68,116,1566,1370,draw
3138,February 6,2013,China,Saudi Arabia,1,2,Asian Cup qualifier,in Saudi Arabia,-22,22,1594,1495,-5,2,59,90,1616,1473,T1
3139,February 6,2013,Estonia,Scotland,0,1,Friendly,in Scotland,-4,4,1492,1661,-3,-1,91,49,1496,1657,T1
3140,February 6,2013,Slovenia,Bosnia and Herzegovina,0,3,Friendly,in Slovenia,-15,15,1586,1761,-6,4,63,26,1601,1746,T2
3141,February 6,2013,Uruguay,Spain,1,3,Friendly,in Qatar,-5,5,1850,2155,-1,0,16,1,1855,2150,T1
3142,February 6,2013,Sweden,Argentina,2,3,Friendly,in Sweden,-10,10,1896,2024,-1,0,10,4,1906,2014,T2
3143,February 6,2013,Tanzania,Cameroon,1,0,Friendly,in Tanzania,14,-14,1370,1585,5,-5,118,64,1356,1599,T1
3144,February 6,2013,Kuwait,Thailand,3,1,Asian Cup qualifier,in Thailand,26,-26,1550,1352,5,-10,73,125,1524,1378,T2
3145,February 6,2013,Peru,Trinidad and Tobago,2,0,Friendly,in Trinidad and Tobago,8,-8,1717,1430,1,-2,35,104,1709,1438,T2
3146,February 6,2013,Czechia,Turkey,2,0,Friendly,in Turkey,16,-16,1791,1686,2,-5,22,43,1775,1702,T2
3147,February 6,2013,Norway,Ukraine,0,2,Friendly,in Spain,-17,17,1747,1730,-3,2,29,32,1764,1713,T1
3148,February 6,2013,Uzbekistan,Hong Kong,0,0,Asian Cup qualifier,in Uzbekistan,-19,19,1629,1185,-1,3,51,161,1648,1166,draw
3149,February 6,2013,United Arab Emirates,Vietnam,2,1,Asian Cup qualifier,in Vietnam,8,-8,1596,1236,7,-1,57,147,1588,1244,T2
3150,February 6,2013,Wales,Austria,2,1,Friendly,in Wales,8,-8,1588,1596,4,-2,62,57,1580,1604,T1
3151,February 6,2013,Zimbabwe,Botswana,2,1,Friendly,in Zimbabwe,5,-5,1371,1290,2,0,117,138,1366,1295,T1
3152,February 9,2013,Mali,Ghana,3,1,African Nations Cup,in South Africa,54,-54,1611,1668,15,-12,54,46,1557,1722,T1
3153,February 9,2013,Nepal,Pakistan,0,1,Friendly,in Nepal,-13,13,894,931,-1,1,201,197,907,918,T2
3154,February 10,2013,Burkina Faso,Nigeria,0,1,African Nations Cup,in South Africa,-13,13,1523,1723,-1,1,79,34,1536,1710,T1
3155,February 12,2013,Maldives,Pakistan,1,1,Friendly,in the Maldives,-7,7,1100,938,-2,2,179,195,1107,931,draw
3156,February 14,2013,Maldives,Pakistan,3,0,Friendly,in the Maldives,6,-6,1106,932,2,-1,177,196,1100,938,T1
3157,February 27,2013,Gambia,Mauritania,0,2,Friendly,in The Gambia,-26,26,1309,1144,-5,4,132,171,1335,1118,T2
3158,March 2,2013,Sri Lanka,Afghanistan,0,1,Asian Cup &amp; Asian Challenge Cup qual,in Laos,-16,16,840,934,-2,3,208,196,856,918,T1
3159,March 2,2013,Mauritania,Gambia,0,0,Friendly,in The Gambia,6,-6,1150,1303,3,-3,168,135,1144,1309,draw
3160,March 2,2013,Taiwan,India,1,2,Asian Cup &amp; Asian Challenge Cup qual,in Myanmar,-7,7,868,1148,-1,3,205,170,875,1141,T1
3161,March 2,2013,Mongolia,Laos,1,1,Asian Cup &amp; Asian Challenge Cup qual,in Laos,7,-7,829,847,0,0,209,207,822,854,draw
3162,March 2,2013,Guam,Myanmar,0,5,Asian Cup &amp; Asian Challenge Cup qual,in Myanmar,-7,7,683,1002,-2,1,219,188,690,995,T1
3163,March 2,2013,Nepal,Northern Mariana Islands,6,0,Asian Cup &amp; Asian Challenge Cup qual,in Nepal,4,-4,898,454,1,0,200,234,894,458,T1
3164,March 2,2013,Palestine,Bangladesh,1,0,Asian Cup &amp; Asian Challenge Cup qual,in Nepal,5,-5,1295,951,0,0,138,194,1290,956,T1
3165,March 4,2013,Mongolia,Afghanistan,0,1,Asian Cup &amp; Asian Challenge Cup qual,in Laos,-14,14,815,948,0,1,209,195,829,934,T1
3166,March 4,2013,India,Guam,4,0,Asian Cup &amp; Asian Challenge Cup qual,in Myanmar,5,-5,1153,678,2,-1,168,220,1148,683,T1
3167,March 4,2013,Laos,Sri Lanka,4,2,Asian Cup &amp; Asian Challenge Cup qual,in Laos,21,-21,868,819,2,0,205,208,847,840,T1
3168,March 4,2013,Taiwan,Myanmar,1,1,Asian Cup &amp; Asian Challenge Cup qual,in Myanmar,12,-12,880,990,3,-2,202,190,868,1002,draw
3169,March 4,2013,Nepal,Bangladesh,0,2,Asian Cup &amp; Asian Challenge Cup qual,in Nepal,-34,34,864,985,-6,3,206,191,898,951,T2
3170,March 4,2013,Palestine,Northern Mariana Islands,9,0,Asian Cup &amp; Asian Challenge Cup qual,in Nepal,1,-1,1296,453,0,0,138,234,1295,454,T1
3171,March 6,2013,Northern Mariana Islands,Bangladesh,0,4,Asian Cup &amp; Asian Challenge Cup qual,in Nepal,-3,3,450,988,0,0,234,191,453,985,T1
3172,March 6,2013,Guam,Taiwan,3,0,Asian Cup &amp; Asian Challenge Cup qual,in Myanmar,53,-53,731,827,8,-6,212,208,678,880,T1
3173,March 6,2013,Laos,Afghanistan,1,1,Asian Cup &amp; Asian Challenge Cup qual,in Laos,-1,1,867,949,0,0,205,195,868,948,draw
3174,March 6,2013,India,Myanmar,0,1,Asian Cup &amp; Asian Challenge Cup qual,in Myanmar,-24,24,1129,1014,-6,4,174,186,1153,990,T1
3175,March 6,2013,Palestine,Nepal,0,0,Asian Cup &amp; Asian Challenge Cup qual,in Nepal,-15,15,1281,879,-1,4,139,202,1296,864,draw
3176,March 6,2013,Mongolia,Sri Lanka,0,3,Asian Cup &amp; Asian Challenge Cup qual,in Laos,-35,35,780,854,-1,2,210,206,815,819,T1
3177,March 7,2013,Qatar,Egypt,3,1,Friendly,in Qatar,19,-19,1487,1654,2,-4,92,49,1468,1673,T1
3178,March 13,2013,Mozambique,Swaziland,0,0,Friendly,in Mozambique,-7,7,1328,1113,0,0,127,177,1335,1106,draw
3179,March 17,2013,Bahrain,Lebanon,0,0,Friendly,in Bahrain,-6,6,1446,1314,0,3,100,129,1452,1308,draw
3180,March 17,2013,Kyrgyzstan,Macao,1,0,Asian Cup &amp; Asian Challenge Cup qual,in Kyrgyzstan,1,-1,1124,629,0,0,175,226,1123,630,T1
3181,March 17,2013,Saudi Arabia,Malaysia,4,1,Friendly,in Malaysia,8,-8,1503,1179,3,-1,87,161,1495,1187,T2
3182,March 17,2013,Thailand,Qatar,0,1,Friendly,in Qatar,-4,4,1348,1491,0,0,125,92,1352,1487,T1
3183,March 17,2013,Pakistan,Tajikistan,0,1,Asian Cup &amp; Asian Challenge Cup qual,in Kyrgyzstan,-6,6,926,1251,-2,2,199,143,932,1245,T1
3184,March 19,2013,Malawi,Botswana,0,1,Friendly,in Botswana,-9,9,1359,1299,-2,1,122,137,1368,1290,T1
3185,March 19,2013,Pakistan,Kyrgyzstan,0,1,Asian Cup &amp; Asian Challenge Cup qual,in Kyrgyzstan,-6,6,920,1130,0,1,199,174,926,1124,T1
3186,March 19,2013,Macao,Tajikistan,0,3,Asian Cup &amp; Asian Challenge Cup qual,in Kyrgyzstan,-2,2,627,1253,0,0,226,143,629,1251,T1
3187,March 20,2013,Niger,Gambia,1,3,Friendly,in Niger,-21,21,1319,1324,-2,8,128,127,1340,1303,T2
3188,March 20,2013,Haiti,Oman,0,3,Friendly,in Oman,-10,10,1446,1522,-2,2,99,81,1456,1512,T1
3189,March 20,2013,Libya,Rwanda,1,0,Friendly,in Rwanda,8,-8,1549,1365,2,-3,74,119,1541,1373,T2
3190,March 21,2013,Italy,Brazil,2,2,Friendly,in Switzerland,4,-4,1920,2046,0,0,7,3,1916,2050,draw
3191,March 21,2013,El Salvador,Ecuador,0,5,Friendly,in Ecuador,-3,3,1539,1867,-1,0,77,15,1542,1864,T1
3192,March 21,2013,Belarus,Jordan,0,1,Friendly,in Jordan,-10,10,1589,1512,-6,4,62,84,1599,1502,T1
3193,March 21,2013,Palestine,Kuwait,1,2,Friendly,in Kuwait,-2,2,1279,1552,-1,0,140,73,1281,1550,T1
3194,March 21,2013,Tajikistan,Kyrgyzstan,0,1,Asian Cup &amp; Asian Challenge Cup qual,in Kyrgyzstan,-21,21,1232,1151,-5,6,148,168,1253,1130,T1
3195,March 21,2013,Macao,Pakistan,0,2,Asian Cup &amp; Asian Challenge Cup qual,in Kyrgyzstan,-9,9,618,929,0,0,226,199,627,920,T1
3196,March 22,2013,Andorra,Turkey,0,2,World Cup qualifier,in Andorra,-2,2,990,1688,0,2,190,40,992,1686,T2
3197,March 22,2013,Venezuela,Argentina,0,3,World Cup qualifier,in Argentina,-6,6,1704,2030,0,0,36,4,1710,2024,T1
3198,March 22,2013,Faroe Islands,Austria,0,6,World Cup qualifier,in Austria,-5,5,1206,1601,1,-1,152,58,1211,1596,T1
3199,March 22,2013,Qatar,Bahrain,0,1,Asian Cup qualifier,in Bahrain,-17,17,1474,1463,-2,3,94,96,1491,1446,T1
3200,March 22,2013,Bosnia and Herzegovina,Greece,3,1,World Cup qualifier,in Bosnia and Herzegovina,27,-27,1788,1795,2,-3,24,22,1761,1822,T1
3201,March 22,2013,Bulgaria,Malta,6,0,World Cup qualifier,in Bulgaria,4,-4,1666,1241,1,-1,45,146,1662,1245,T1
3202,March 22,2013,China,Iraq,1,0,Asian Cup qualifier,in China,15,-15,1609,1590,2,-5,57,60,1594,1605,T1
3203,March 22,2013,Bolivia,Colombia,0,5,World Cup qualifier,in Colombia,-8,8,1624,1913,-2,0,52,8,1632,1905,T1
3204,March 22,2013,Croatia,Serbia,2,0,World Cup qualifier,in Croatia,9,-9,1902,1685,2,-5,9,42,1893,1694,T1
3205,March 22,2013,Czechia,Denmark,0,3,World Cup qualifier,in Czechia,-48,48,1743,1800,-9,6,31,21,1791,1752,T2
3206,March 22,2013,Egypt,Swaziland,10,0,Friendly,in Egypt,1,-1,1655,1112,1,0,48,177,1654,1113,T1
3207,March 22,2013,Georgia,France,1,3,World Cup qualifier,in France,-4,4,1522,1885,-3,2,81,12,1526,1881,T1
3208,March 22,2013,Honduras,Mexico,2,2,World Cup qualifier,in Honduras,6,-6,1690,1894,4,-1,39,10,1684,1900,draw
3209,March 22,2013,Hong Kong,Vietnam,1,0,Asian Cup qualifier,in Hong Kong,17,-17,1202,1219,6,-5,154,151,1185,1236,T1
3210,March 22,2013,Hungary,Romania,2,2,World Cup qualifier,in Hungary,-1,1,1688,1766,0,-1,40,25,1689,1765,draw
3211,March 22,2013,Israel,Portugal,3,3,World Cup qualifier,in Israel,9,-9,1634,1881,3,-2,50,14,1625,1890,draw
3212,March 22,2013,Panama,Jamaica,1,1,World Cup qualifier,in Jamaica,-1,1,1693,1578,0,0,37,67,1694,1577,draw
3213,March 22,2013,Canada,Japan,1,2,Friendly,in Qatar,-4,4,1589,1827,-1,0,61,18,1593,1823,T1
3214,March 22,2013,Lebanon,Thailand,5,2,Asian Cup qualifier,in Lebanon,28,-28,1342,1320,5,-3,125,128,1314,1348,T1
3215,March 22,2013,Liechtenstein,Latvia,1,1,World Cup qualifier,in Liechtenstein,12,-12,1190,1495,3,-5,159,91,1178,1507,draw
3216,March 22,2013,Azerbaijan,Luxembourg,0,0,World Cup qualifier,in Luxembourg,-9,9,1410,1164,-1,2,107,165,1419,1155,draw
3217,March 22,2013,Belgium,Macedonia,2,0,World Cup qualifier,in Macedonia,19,-19,1808,1534,3,-5,20,77,1789,1553,T2
3218,March 22,2013,Yemen,Malaysia,1,2,Asian Cup qualifier,in Malaysia,-17,17,1202,1196,-2,3,154,158,1219,1179,T1
3219,March 22,2013,Moldova,Montenegro,0,1,World Cup qualifier,in Moldova,-10,10,1383,1691,-3,6,113,38,1393,1681,T2
3220,March 22,2013,Estonia,Netherlands,0,3,World Cup qualifier,in the Netherlands,-2,2,1490,1994,-1,0,92,5,1492,1992,T1
3221,March 22,2013,New Caledonia,New Zealand,1,2,World Cup qualifier,in New Zealand,-5,5,1349,1581,0,2,124,66,1354,1576,T1
3222,March 22,2013,Albania,Norway,1,0,World Cup qualifier,in Norway,35,-35,1532,1712,11,-6,78,35,1497,1747,T2
3223,March 22,2013,Peru,Chile,1,0,World Cup qualifier,in Peru,20,-20,1737,1793,3,-3,32,23,1717,1813,T1
3224,March 22,2013,Ukraine,Poland,3,1,World Cup qualifier,in Poland,35,-35,1765,1659,6,-10,26,47,1730,1694,T2
3225,March 22,2013,San Marino,England,0,8,World Cup qualifier,in San Marino,0,0,884,1963,0,0,201,6,884,1963,T2
3226,March 22,2013,Scotland,Wales,1,2,World Cup qualifier,in Scotland,-29,29,1632,1617,-3,10,51,53,1661,1588,T2
3227,March 22,2013,Slovakia,Lithuania,1,1,World Cup qualifier,in Slovakia,-12,12,1587,1481,-7,1,63,93,1599,1469,draw
3228,March 22,2013,Slovenia,Iceland,1,2,World Cup qualifier,in Slovenia,-31,31,1555,1513,-6,8,70,85,1586,1482,T2
3229,March 22,2013,Spain,Finland,1,1,World Cup qualifier,in Spain,-19,19,2136,1647,0,3,1,49,2155,1628,draw
3230,March 22,2013,Sweden,Ireland,0,0,World Cup qualifier,in Sweden,-13,13,1883,1752,-3,2,13,29,1896,1739,draw
3231,March 22,2013,Tahiti,Solomon Islands,2,0,World Cup qualifier,in Tahiti,20,-20,1245,1185,5,-8,145,162,1225,1205,T1
3232,March 22,2013,Turkmenistan,Cambodia,7,0,Asian Cup &amp; Asian Challenge Cup qual,in the Philippines,2,-2,1372,676,1,-1,116,222,1370,678,T1
3233,March 22,2013,United Arab Emirates,Uzbekistan,2,1,Asian Cup qualifier,in the United Arab Emirates,16,-16,1612,1613,2,-3,55,54,1596,1629,T1
3234,March 22,2013,Paraguay,Uruguay,1,1,World Cup qualifier,in Uruguay,11,-11,1736,1839,0,0,33,16,1725,1850,draw
3235,March 22,2013,Costa Rica,United States,0,1,World Cup qualifier,in the United States,-12,12,1677,1756,-3,2,43,28,1689,1744,T1
3236,March 23,2013,Senegal,Angola,1,1,World Cup qualifier,in Guinea,-4,4,1518,1459,-2,1,83,97,1522,1455,draw
3237,March 23,2013,Belize,Trinidad and Tobago,0,0,Friendly,in Belize,5,-5,1163,1425,0,-1,167,105,1158,1430,draw
3238,March 23,2013,Burkina Faso,Niger,4,0,World Cup qualifier,in Burkina Faso,11,-11,1534,1308,3,-2,76,131,1523,1319,T1
3239,March 23,2013,Togo,Cameroon,1,2,World Cup qualifier,in Cameroon,-8,8,1437,1593,-1,5,102,59,1445,1585,T1
3240,March 23,2013,Gabon,Congo,0,1,World Cup qualifier,in Congo,-23,23,1517,1410,-9,4,84,107,1540,1387,T1
3241,March 23,2013,Cyprus,Switzerland,0,0,World Cup qualifier,in Cyprus,14,-14,1430,1820,2,-1,104,18,1416,1834,draw
3242,March 23,2013,Saudi Arabia,Indonesia,2,1,Asian Cup qualifier,in Indonesia,11,-11,1514,1215,4,-2,85,151,1503,1226,T2
3243,March 23,2013,Ivory Coast,Gambia,3,0,World Cup qualifier,in Ivory Coast,2,-2,1811,1322,0,0,19,127,1809,1324,T1
3244,March 23,2013,Germany,Kazakhstan,3,0,World Cup qualifier,in Kazakhstan,2,-2,2062,1355,0,1,2,122,2060,1357,T2
3245,March 23,2013,Namibia,Malawi,0,1,World Cup qualifier,in Namibia,-23,23,1290,1382,-7,8,138,114,1313,1359,T2
3246,March 23,2013,Kenya,Nigeria,1,1,World Cup qualifier,in Nigeria,17,-17,1405,1706,1,-1,109,35,1388,1723,draw
3247,March 23,2013,South Africa,Central African Republic,2,0,World Cup qualifier,in South Africa,7,-7,1564,1304,1,-2,68,134,1557,1311,T1
3248,March 23,2013,Tunisia,Sierra Leone,2,1,World Cup qualifier,in Tunisia,5,-5,1588,1355,1,-1,64,122,1583,1360,T1
3249,March 24,2013,Haiti,Dominican Republic,1,3,Friendly,in the Dominican Republic,-19,19,1427,1270,-4,2,104,141,1446,1251,T1
3250,March 24,2013,Libya,Democratic Republic of Congo,0,0,World Cup qualifier,in the Democratic Republic of the Congo,0,0,1549,1457,2,1,71,97,1549,1457,draw
3251,March 24,2013,Equatorial Guinea,Cape Verde,4,3,World Cup qualifier,in Equatorial Guinea,24,-24,1322,1443,9,-4,128,99,1298,1467,T1
3252,March 24,2013,Ethiopia,Botswana,1,0,World Cup qualifier,in Ethiopia,14,-14,1322,1285,3,-2,128,138,1308,1299,T1
3253,March 24,2013,Ghana,Sudan,4,0,World Cup qualifier,in Ghana,7,-7,1675,1372,0,-2,44,117,1668,1379,T1
3254,March 24,2013,Lesotho,Zambia,1,1,World Cup qualifier,in Lesotho,14,-14,1160,1540,3,-1,168,72,1146,1554,draw
3255,March 24,2013,Uganda,Liberia,0,2,World Cup qualifier,in Liberia,-43,43,1520,1346,-11,10,80,125,1563,1303,T1
3256,March 24,2013,Mozambique,Guinea,0,0,World Cup qualifier,in Mozambique,4,-4,1332,1501,-1,0,127,89,1328,1505,draw
3257,March 24,2013,Philippines,Cambodia,8,0,Asian Cup &amp; Asian Challenge Cup qual,in the Philippines,3,-3,1192,673,1,-1,159,223,1189,676,T1
3258,March 24,2013,Mali,Rwanda,2,1,World Cup qualifier,in Rwanda,12,-12,1623,1353,3,-3,53,123,1611,1365,T2
3259,March 24,2013,Morocco,Tanzania,1,3,World Cup qualifier,in Tanzania,-37,37,1512,1407,-13,10,86,109,1549,1370,T1
3260,March 25,2013,Canada,Belarus,0,2,Friendly,in Qatar,-15,15,1574,1604,-5,4,67,58,1589,1589,T1
3261,March 25,2013,Russia,Brazil,1,1,Friendly,in England,4,-4,1894,2042,1,0,10,3,1890,2046,draw
3262,March 26,2013,Lithuania,Albania,1,4,Friendly,in Albania,-10,10,1471,1542,0,3,93,73,1481,1532,T1
3263,March 26,2013,Benin,Algeria,1,3,World Cup qualifier,in Algeria,-14,14,1386,1525,-1,9,112,79,1400,1511,T1
3264,March 26,2013,Czechia,Armenia,3,0,World Cup qualifier,in Armenia,23,-23,1766,1500,4,-12,27,89,1743,1523,T2
3265,March 26,2013,Australia,Oman,2,2,World Cup qualifier,in Australia,-15,15,1748,1537,-3,2,30,76,1763,1522,draw
3266,March 26,2013,Azerbaijan,Portugal,0,2,World Cup qualifier,in Azerbaijan,-6,6,1404,1887,-3,4,110,10,1410,1881,T2
3267,March 26,2013,Macedonia,Belgium,0,1,World Cup qualifier,in Belgium,-4,4,1530,1812,-4,1,78,19,1534,1808,T1
3268,March 26,2013,Argentina,Bolivia,1,1,World Cup qualifier,in Bolivia,-14,14,2016,1638,0,1,4,51,2030,1624,draw
3269,March 26,2013,Chile,Uruguay,2,0,World Cup qualifier,in Chile,25,-25,1818,1814,6,-2,17,18,1793,1839,T1
3270,March 26,2013,Jamaica,Costa Rica,0,2,World Cup qualifier,in Costa Rica,-14,14,1564,1691,-1,2,67,41,1578,1677,T1
3271,March 26,2013,Denmark,Bulgaria,1,1,World Cup qualifier,in Denmark,-12,12,1788,1678,-2,2,23,43,1800,1666,draw
3272,March 26,2013,Ecuador,Paraguay,4,1,World Cup qualifier,in Ecuador,15,-15,1882,1721,3,-1,12,34,1867,1736,T1
3273,March 26,2013,Zimbabwe,Egypt,1,2,World Cup qualifier,in Egypt,-4,4,1367,1659,1,0,118,48,1371,1655,T1
3274,March 26,2013,Estonia,Andorra,2,0,World Cup qualifier,in Estonia,2,-2,1492,988,0,0,92,190,1490,990,T1
3275,March 26,2013,Spain,France,1,0,World Cup qualifier,in France,12,-12,2148,1873,0,-3,1,15,2136,1885,T2
3276,March 26,2013,Kazakhstan,Germany,1,4,World Cup qualifier,in Germany,-1,1,1354,2063,-1,0,122,2,1355,2062,T1
3277,March 26,2013,Syria,Iraq,1,2,Friendly,in Iraq,-5,5,1515,1595,-4,2,84,60,1520,1590,T1
3278,March 26,2013,Austria,Ireland,2,2,World Cup qualifier,in Ireland,12,-12,1613,1740,4,-2,55,31,1601,1752,draw
3279,March 26,2013,Jordan,Japan,2,1,World Cup qualifier,in Jordan,31,-31,1543,1796,14,-4,72,21,1512,1827,T1
3280,March 26,2013,Iran,Kuwait,1,1,Asian Cup qualifier,in Kuwait,-1,1,1661,1553,0,0,46,70,1662,1552,draw
3281,March 26,2013,Finland,Luxembourg,3,0,Friendly,in Luxembourg,3,-3,1650,1161,-1,-2,50,167,1647,1164,T2
3282,March 26,2013,Palestine,Malaysia,2,0,Friendly,in Malaysia,16,-16,1295,1180,3,-3,137,161,1279,1196,T2
3283,March 26,2013,Malta,Italy,0,2,World Cup qualifier,in Malta,-2,2,1239,1922,1,0,145,7,1241,1920,T2
3284,March 26,2013,United States,Mexico,0,0,World Cup qualifier,in Mexico,12,-12,1768,1882,3,-2,25,12,1756,1894,draw
3285,March 26,2013,England,Montenegro,1,1,World Cup qualifier,in Montenegro,-9,9,1954,1700,0,-1,6,39,1963,1691,draw
3286,March 26,2013,Netherlands,Romania,4,0,World Cup qualifier,in the Netherlands,10,-10,2004,1756,0,-3,5,28,1994,1766,T1
3287,March 26,2013,New Caledonia,Tahiti,1,0,World Cup qualifier,in New Caledonia,9,-9,1358,1236,4,-1,120,146,1349,1245,T1
3288,March 26,2013,Israel,Northern Ireland,2,0,World Cup qualifier,in Northern Ireland,22,-22,1656,1418,1,-6,49,106,1634,1440,T2
3289,March 26,2013,Panama,Honduras,2,0,World Cup qualifier,in Panama,21,-21,1714,1669,2,-6,35,45,1693,1690,T1
3290,March 26,2013,Trinidad and Tobago,Peru,0,3,Friendly,in Peru,-3,3,1422,1740,0,1,105,31,1425,1737,T1
3291,March 26,2013,Philippines,Turkmenistan,1,0,Asian Cup &amp; Asian Challenge Cup qual,in the Philippines,25,-25,1217,1347,8,-7,151,124,1192,1372,T1
3292,March 26,2013,San Marino,Poland,0,5,World Cup qualifier,in Poland,-1,1,883,1660,0,0,201,47,884,1659,T1
3293,March 26,2013,Scotland,Serbia,0,2,World Cup qualifier,in Serbia,-18,18,1614,1703,-3,4,54,38,1632,1685,T1
3294,March 26,2013,Slovakia,Sweden,0,0,Friendly,in Slovakia,5,-5,1592,1878,1,-1,63,14,1587,1883,draw
3295,March 26,2013,Solomon Islands,New Zealand,0,2,World Cup qualifier,in the Solomon Islands,-9,9,1176,1590,0,1,162,64,1185,1581,T2
3296,March 26,2013,South Korea,Qatar,2,1,World Cup qualifier,in South Korea,4,-4,1754,1470,1,0,29,94,1750,1474,T1
3297,March 26,2013,Hungary,Turkey,1,1,World Cup qualifier,in Turkey,6,-6,1694,1682,0,-2,40,42,1688,1688,draw
3298,March 26,2013,Ukraine,Moldova,2,1,World Cup qualifier,in Ukraine,2,-2,1767,1381,0,-1,26,115,1765,1383,T1
3299,March 26,2013,Lebanon,Uzbekistan,0,1,World Cup qualifier,in Uzbekistan,-4,4,1338,1617,0,2,126,53,1342,1613,T1
3300,March 26,2013,Venezuela,Colombia,1,0,World Cup qualifier,in Venezuela,26,-26,1730,1887,3,-2,33,10,1704,1913,T1
3301,March 26,2013,Croatia,Wales,2,1,World Cup qualifier,in Wales,10,-10,1912,1607,1,-4,8,58,1902,1617,T2
3302,April 6,2013,Brazil,Bolivia,4,0,Friendly,in Bolivia,6,-6,2048,1632,0,0,3,51,2042,1638,T2
3303,April 17,2013,Mexico,Peru,0,0,Friendly,in the United States,-4,4,1878,1744,-1,0,13,31,1882,1740,draw
3304,April 17,2013,Palestine,Qatar,0,2,Friendly,in Qatar,-5,5,1290,1475,0,1,137,93,1295,1470,T1
3305,April 21,2013,Saint Lucia,Saint Vincent and the Grenadines,2,0,Windward Islands Championship,in Saint Vincent and the Grenadines,37,-37,1062,1160,1,-9,183,167,1025,1197,T2
3306,April 23,2013,Grenada,Saint Lucia,2,1,Windward Islands Championship,in Saint Vincent and the Grenadines,11,-11,1180,1051,3,0,160,183,1169,1062,T1
3307,April 24,2013,Chile,Brazil,2,2,Friendly,in Brazil,7,-7,1825,2041,1,0,16,3,1818,2048,draw
3308,April 25,2013,Saint Vincent and the Grenadines,Grenada,0,1,Windward Islands Championship,in Saint Vincent and the Grenadines,-18,18,1142,1198,-6,2,173,158,1160,1180,T2
3309,April 28,2013,Zimbabwe,Zambia,0,2,Friendly,in Zambia,-5,5,1362,1545,0,2,118,72,1367,1540,T1
3310,May 13,2013,Libya,Mauritania,2,0,Friendly,in Libya,2,-2,1551,1148,0,-1,71,170,1549,1150,T1
3311,May 22,2013,Oman,Iran,3,1,Friendly,in Oman,16,-16,1553,1645,6,-4,70,50,1537,1661,T1
3312,May 22,2013,El Salvador,Venezuela,1,2,Friendly,in Venezuela,-3,3,1536,1733,-1,0,76,33,1539,1730,T1
3313,May 24,2013,Latvia,Qatar,1,3,Friendly,in Qatar,-12,12,1483,1487,-2,1,93,92,1495,1475,T1
3314,May 25,2013,Mauritania,Algeria,0,1,Friendly,in Algeria,-1,1,1147,1526,0,0,170,79,1148,1525,T1
3315,May 25,2013,Ethiopia,Sudan,2,0,Friendly,in Ethiopia,13,-13,1335,1359,1,-2,127,119,1322,1372,T1
3316,May 25,2013,Malawi,Zimbabwe,1,1,Friendly,in Malawi,-3,3,1379,1365,-1,1,115,117,1382,1362,draw
3317,May 25,2013,Namibia,Zambia,0,0,Friendly,in Namibia,4,-4,1294,1541,0,-2,137,75,1290,1545,draw
3318,May 27,2013,Liberia,Iraq,1,0,Friendly,in Iraq,18,-18,1364,1577,7,-5,118,65,1346,1595,T2
3319,May 27,2013,Libya,Jordan,0,1,Friendly,in Jordan,-7,7,1544,1550,-1,1,73,72,1551,1543,T1
3320,May 28,2013,Costa Rica,Canada,1,0,Friendly,in Canada,10,-10,1701,1564,2,0,39,66,1691,1574,T2
3321,May 28,2013,Latvia,Turkey,3,3,Friendly,in Germany,5,-5,1488,1677,1,-1,92,43,1483,1682,draw
3322,May 29,2013,England,Ireland,1,1,Friendly,in England,-7,7,1947,1747,0,1,6,31,1954,1740,draw
3323,May 29,2013,Ecuador,Germany,2,4,Friendly,in the United States,-8,8,1874,2071,-2,0,14,2,1882,2063,T1
3324,May 29,2013,Oman,Lebanon,1,1,Friendly,in Qatar,-6,6,1547,1344,-2,0,72,126,1553,1338,draw
3325,May 29,2013,Azerbaijan,Qatar,1,1,Friendly,in Qatar,5,-5,1409,1482,2,0,108,93,1404,1487,draw
3326,May 29,2013,United States,Belgium,2,4,Friendly,in the United States,-17,17,1751,1829,-4,3,29,16,1768,1812,T2
3327,May 30,2013,Japan,Bulgaria,0,2,Friendly,in Japan,-23,23,1773,1701,-3,3,24,39,1796,1678,T2
3328,May 31,2013,Italy,San Marino,4,0,Friendly,in Italy,0,0,1922,883,0,0,7,201,1922,883,T1
3329,May 31,2013,Nigeria,Mexico,2,2,Friendly,in the United States,5,-5,1711,1873,0,-2,37,14,1706,1878,draw
3330,May 31,2013,Slovenia,Turkey,2,0,Friendly,in Germany,20,-20,1575,1657,3,-4,66,47,1555,1677,T1
3331,June 1,2013,Libya,Uganda,3,0,Friendly,in Libya,12,-12,1556,1508,3,-6,70,87,1544,1520,T1
3332,June 1,2013,Peru,Panama,2,1,Friendly,in Panama,12,-12,1756,1702,5,-3,27,38,1744,1714,T2
3333,June 2,2013,Burkina Faso,Algeria,0,2,Friendly,in Algeria,-11,11,1523,1537,-2,3,79,76,1534,1526,T1
3334,June 2,2013,Brazil,England,2,2,Friendly,in Brazil,-5,5,2036,1952,0,0,3,6,2041,1947,draw
3335,June 2,2013,Georgia,Ireland,0,4,Friendly,in Ireland,-5,5,1517,1752,-1,1,81,31,1522,1747,T1
3336,June 2,2013,Honduras,Israel,0,2,Friendly,in the United States,-16,16,1653,1672,-4,4,48,44,1669,1656,T1
3337,June 2,2013,Lesotho,South Africa,0,2,Friendly,in Lesotho,-4,4,1156,1568,0,0,167,67,1160,1564,T2
3338,June 2,2013,Sudan,Tanzania,0,0,Friendly,in Ethiopia,1,-1,1360,1406,0,0,120,109,1359,1407,draw
3339,June 2,2013,Cameroon,Ukraine,0,0,Friendly,in Ukraine,7,-7,1600,1760,0,-2,60,27,1593,1767,draw
3340,June 2,2013,United States,Germany,4,3,Friendly,in the United States,16,-16,1767,2055,5,0,25,2,1751,2071,T1
3341,June 3,2013,Belarus,Estonia,2,0,Friendly,in Estonia,14,-14,1618,1478,6,-2,53,93,1604,1492,T2
3342,June 3,2013,Sweden,Macedonia,1,0,Friendly,in Sweden,1,-1,1879,1529,0,0,12,78,1878,1530,T1
3343,June 4,2013,Egypt,Botswana,1,1,Friendly,in Egypt,-9,9,1650,1294,-3,2,49,137,1659,1285,draw
3344,June 4,2013,Hong Kong,Philippines,0,1,Friendly,in Hong Kong,-12,12,1190,1229,-3,2,158,149,1202,1217,T2
3345,June 4,2013,Mexico,Jamaica,1,0,World Cup qualifier,in Jamaica,9,-9,1882,1555,2,-3,12,71,1873,1564,T2
3346,June 4,2013,Japan,Australia,1,1,World Cup qualifier,in Japan,-7,7,1766,1755,-1,2,25,30,1773,1748,draw
3347,June 4,2013,Bulgaria,Kazakhstan,2,1,Friendly,in Kazakhstan,4,-4,1705,1350,2,-2,37,125,1701,1354,T2
3348,June 4,2013,South Korea,Lebanon,1,1,World Cup qualifier,in Lebanon,-14,14,1740,1358,-2,5,32,121,1754,1344,draw
3349,June 4,2013,Myanmar,Singapore,0,2,Friendly,in Myanmar,-9,9,1005,1278,-2,1,188,141,1014,1269,T2
3350,June 4,2013,Oman,Iraq,1,0,World Cup qualifier,in Oman,16,-16,1563,1561,5,-4,68,69,1547,1577,T1
3351,June 4,2013,Poland,Liechtenstein,2,0,Friendly,in Poland,1,-1,1661,1189,0,0,45,159,1660,1190,T1
3352,June 4,2013,Qatar,Iran,0,1,World Cup qualifier,in Qatar,-16,16,1466,1661,-2,5,94,45,1482,1645,T2
3353,June 4,2013,Trinidad and Tobago,Romania,0,4,Friendly,in Romania,-3,3,1419,1759,0,0,105,28,1422,1756,T1
3354,June 4,2013,Afghanistan,Tajikistan,2,3,Friendly,in Tajikistan,-2,2,947,1234,0,1,195,147,949,1232,T1
3355,June 5,2013,Georgia,Denmark,1,2,Friendly,in Denmark,-2,2,1515,1790,-1,0,82,22,1517,1788,T1
3356,June 5,2013,Togo,Equatorial Guinea,1,0,Friendly,in Equatorial Guinea,10,-10,1447,1312,1,-3,99,132,1437,1322,T2
3357,June 5,2013,Nigeria,Kenya,1,0,World Cup qualifier,in Kenya,9,-9,1720,1396,1,-1,35,111,1711,1405,T2
3358,June 5,2013,Namibia,Malawi,0,0,World Cup qualifier,in Malawi,10,-10,1304,1369,1,-1,136,116,1294,1379,draw
3359,June 5,2013,Uruguay,France,1,0,Friendly,in Uruguay,9,-9,1823,1864,1,0,18,15,1814,1873,T1
3360,June 6,2013,Uzbekistan,China,2,1,Friendly,in China,13,-13,1630,1596,2,-2,52,60,1617,1609,T2
3361,June 6,2013,Hungary,Kuwait,1,0,Friendly,in Hungary,4,-4,1698,1549,0,-1,42,73,1694,1553,T1
3362,June 7,2013,Albania,Norway,1,1,World Cup qualifier,in Albania,4,-4,1546,1708,2,0,72,36,1542,1712,draw
3363,June 7,2013,Colombia,Argentina,0,0,World Cup qualifier,in Argentina,12,-12,1899,2004,1,-1,9,5,1887,2016,draw
3364,June 7,2013,Malta,Armenia,1,0,World Cup qualifier,in Armenia,36,-36,1275,1464,3,-5,142,94,1239,1500,T2
3365,June 7,2013,Sweden,Austria,1,2,World Cup qualifier,in Austria,-29,29,1850,1642,-2,5,15,51,1879,1613,T1
3366,June 7,2013,Azerbaijan,Luxembourg,1,1,World Cup qualifier,in Azerbaijan,-15,15,1394,1176,-3,4,111,162,1409,1161,draw
3367,June 7,2013,Serbia,Belgium,1,2,World Cup qualifier,in Belgium,-9,9,1694,1838,-3,-1,41,17,1703,1829,T1
3368,June 7,2013,Bolivia,Venezuela,1,1,World Cup qualifier,in Bolivia,0,0,1632,1733,-2,0,53,33,1632,1733,draw
3369,June 7,2013,Costa Rica,Honduras,1,0,World Cup qualifier,in Costa Rica,12,-12,1713,1641,5,-4,35,52,1701,1653,T1
3370,June 7,2013,Scotland,Croatia,1,0,World Cup qualifier,in Croatia,36,-36,1650,1876,6,-4,49,12,1614,1912,T2
3371,June 7,2013,Czechia,Italy,0,0,World Cup qualifier,in Czechia,3,-3,1769,1919,-2,0,27,7,1766,1922,draw
3372,June 7,2013,Estonia,Trinidad and Tobago,1,0,Friendly,in Estonia,6,-6,1484,1413,3,-1,89,106,1478,1419,T1
3373,June 7,2013,Finland,Belarus,1,0,World Cup qualifier,in Finland,13,-13,1663,1605,5,-5,44,59,1650,1618,T1
3374,June 7,2013,Slovenia,Iceland,4,2,World Cup qualifier,in Iceland,33,-33,1608,1480,8,-5,57,90,1575,1513,T2
3375,June 7,2013,Netherlands,Indonesia,3,0,Friendly,in Indonesia,1,-1,2005,1214,1,0,4,152,2004,1215,T2
3376,June 7,2013,Ireland,Faroe Islands,3,0,World Cup qualifier,in Ireland,2,-2,1754,1204,0,0,31,153,1752,1206,T1
3377,June 7,2013,Jamaica,United States,1,2,World Cup qualifier,in Jamaica,-14,14,1541,1781,-3,-1,74,25,1555,1767,T2
3378,June 7,2013,Laos,Singapore,2,5,Friendly,in Laos,-5,5,862,1283,0,1,205,140,867,1278,T2
3379,June 7,2013,Latvia,Bosnia and Herzegovina,0,5,World Cup qualifier,in Latvia,-19,19,1469,1807,0,2,91,21,1488,1788,T2
3380,June 7,2013,Libya,Democratic Republic of Congo,0,0,World Cup qualifier,in Libya,-10,10,1546,1467,-2,5,72,92,1556,1457,draw
3381,June 7,2013,Slovakia,Liechtenstein,1,1,World Cup qualifier,in Liechtenstein,-14,14,1578,1203,-3,5,65,154,1592,1189,draw
3382,June 7,2013,Lithuania,Greece,0,1,World Cup qualifier,in Lithuania,-9,9,1462,1804,-3,-1,96,22,1471,1795,T2
3383,June 7,2013,Poland,Moldova,1,1,World Cup qualifier,in Moldova,-10,10,1651,1391,-3,2,48,112,1661,1381,draw
3384,June 7,2013,Ukraine,Montenegro,4,0,World Cup qualifier,in Montenegro,42,-42,1802,1658,4,-5,23,46,1760,1700,T2
3385,June 7,2013,Panama,Mexico,0,0,World Cup qualifier,in Panama,5,-5,1707,1877,2,1,37,11,1702,1882,draw
3386,June 7,2013,Chile,Paraguay,2,1,World Cup qualifier,in Paraguay,20,-20,1845,1701,1,-5,16,39,1825,1721,T2
3387,June 7,2013,Peru,Ecuador,1,0,World Cup qualifier,in Peru,21,-21,1777,1853,3,0,26,14,1756,1874,T1
3388,June 7,2013,Russia,Portugal,0,1,World Cup qualifier,in Portugal,-15,15,1879,1902,-1,2,10,8,1894,1887,T1
3389,June 7,2013,Ghana,Sudan,3,1,World Cup qualifier,in Sudan,13,-13,1688,1347,1,-5,42,125,1675,1360,T2
3390,June 8,2013,Angola,Senegal,1,1,World Cup qualifier,in Angola,-2,2,1457,1520,0,-1,97,81,1459,1518,draw
3391,June 8,2013,Ethiopia,Botswana,2,1,World Cup qualifier,in Botswana,23,-23,1358,1271,7,-4,120,142,1335,1294,T2
3392,June 8,2013,Cape Verde,Equatorial Guinea,2,1,World Cup qualifier,in Cape Verde,8,-8,1451,1304,1,-3,99,135,1443,1312,T1
3393,June 8,2013,Congo,Gabon,0,0,World Cup qualifier,in Gabon,11,-11,1421,1506,2,-5,105,86,1410,1517,draw
3394,June 8,2013,Ivory Coast,Gambia,3,0,World Cup qualifier,in The Gambia,7,-7,1818,1315,0,-2,20,131,1811,1322,T2
3395,June 8,2013,Tanzania,Morocco,1,2,World Cup qualifier,in Morocco,-9,9,1397,1521,-1,5,109,80,1406,1512,T1
3396,June 8,2013,Tunisia,Sierra Leone,2,2,World Cup qualifier,in Sierra Leone,-7,7,1581,1362,0,4,64,118,1588,1355,draw
3397,June 8,2013,Central African Republic,South Africa,0,3,World Cup qualifier,in Cameroon,-13,13,1291,1581,-1,2,137,64,1304,1568,T1
3398,June 8,2013,Haiti,Spain,1,2,Friendly,in the United States,0,0,1427,2148,0,0,103,1,1427,2148,T1
3399,June 8,2013,Switzerland,Cyprus,1,0,World Cup qualifier,in Switzerland,2,-2,1822,1428,0,0,19,102,1820,1430,T1
3400,June 8,2013,Uganda,Liberia,1,0,World Cup qualifier,in Uganda,8,-8,1516,1356,4,-5,82,123,1508,1364,T1
3401,June 8,2013,Lesotho,Zambia,0,4,World Cup qualifier,in Zambia,-4,4,1152,1545,0,0,167,74,1156,1541,T1
3402,June 9,2013,Algeria,Benin,3,1,World Cup qualifier,in Benin,26,-26,1563,1360,8,-6,68,119,1537,1386,T2
3403,June 9,2013,Brazil,France,3,0,Friendly,in Brazil,6,-6,2042,1858,0,0,3,13,2036,1864,T1
3404,June 9,2013,Mozambique,Guinea,1,6,World Cup qualifier,in Guinea,-14,14,1318,1515,-1,4,129,83,1332,1501,T1
3405,June 9,2013,Rwanda,Mali,1,1,World Cup qualifier,in Mali,16,-16,1369,1607,9,-2,115,57,1353,1623,draw
3406,June 9,2013,Burkina Faso,Niger,1,0,World Cup qualifier,in Niger,14,-14,1537,1294,2,-3,77,136,1523,1308,T2
3407,June 9,2013,Togo,Cameroon,2,0,World Cup qualifier,in Togo,35,-35,1482,1565,10,-6,90,66,1447,1600,T1
3408,June 9,2013,Zimbabwe,Egypt,2,4,World Cup qualifier,in Zimbabwe,-15,15,1350,1665,-7,5,124,44,1365,1650,T2
3409,June 10,2013,Croatia,Portugal,0,1,Friendly,in Switzerland,-9,9,1867,1911,0,0,12,8,1876,1902,T1
3410,June 11,2013,Australia,Jordan,4,0,World Cup qualifier,in Australia,11,-11,1766,1539,3,-4,27,75,1755,1550,T1
3411,June 11,2013,Belarus,Finland,1,1,World Cup qualifier,in Belarus,-2,2,1603,1665,0,0,59,45,1605,1663,draw
3412,June 11,2013,Chile,Bolivia,3,1,World Cup qualifier,in Chile,8,-8,1853,1624,1,0,15,53,1845,1632,T1
3413,June 11,2013,Netherlands,China,2,0,Friendly,in China,4,-4,2009,1592,0,0,4,60,2005,1596,T2
3414,June 11,2013,Colombia,Peru,2,0,World Cup qualifier,in Colombia,13,-13,1912,1764,2,-2,7,28,1899,1777,T1
3415,June 11,2013,Denmark,Armenia,0,4,World Cup qualifier,in Denmark,-69,69,1721,1533,-9,17,33,78,1790,1464,T2
3416,June 11,2013,Argentina,Ecuador,1,1,World Cup qualifier,in Ecuador,-3,3,2001,1856,0,0,5,14,2004,1853,draw
3417,June 11,2013,Estonia,Kyrgyzstan,1,1,Friendly,in Estonia,-8,8,1476,1159,-3,1,92,167,1484,1151,draw
3418,June 11,2013,Guatemala,Belize,0,0,Friendly,in Guatemala,-8,8,1489,1171,-1,1,89,165,1497,1163,draw
3419,June 11,2013,Haiti,Italy,2,2,Friendly,in Brazil,9,-9,1436,1910,2,-2,101,9,1427,1919,draw
3420,June 11,2013,Jamaica,Honduras,0,2,World Cup qualifier,in Honduras,-14,14,1527,1655,-3,3,79,49,1541,1641,T1
3421,June 11,2013,Iran,Lebanon,4,0,World Cup qualifier,in Iran,7,-7,1668,1351,2,-3,44,123,1661,1358,T1
3422,June 11,2013,Iraq,Japan,0,1,World Cup qualifier,in Qatar,-9,9,1552,1775,0,3,70,25,1561,1766,T1
3423,June 11,2013,Mexico,Costa Rica,0,0,World Cup qualifier,in Mexico,-13,13,1864,1726,-1,3,12,32,1877,1713,draw
3424,June 11,2013,Norway,Macedonia,2,0,Friendly,in Norway,5,-5,1713,1524,1,-1,35,80,1708,1529,T1
3425,June 11,2013,North Korea,Qatar,0,0,Friendly,in Qatar,-1,1,1592,1467,1,0,60,94,1593,1466,draw
3426,June 11,2013,Uzbekistan,South Korea,0,1,World Cup qualifier,in South Korea,-9,9,1621,1749,0,1,54,31,1630,1740,T1
3427,June 11,2013,Ireland,Spain,0,2,Friendly,in the United States,-3,3,1751,2151,1,0,30,1,1754,2148,T1
3428,June 11,2013,Sweden,Faroe Islands,2,0,World Cup qualifier,in Sweden,1,-1,1851,1203,-1,0,16,153,1850,1204,T1
3429,June 11,2013,United States,Panama,2,0,World Cup qualifier,in the United States,16,-16,1797,1691,1,-4,24,41,1781,1707,T1
3430,June 11,2013,Venezuela,Uruguay,0,1,World Cup qualifier,in Venezuela,-21,21,1712,1844,-3,1,36,17,1733,1823,T2
3431,June 12,2013,Ivory Coast,Ghana,1,2,Friendly,in Ghana,-11,11,1807,1699,0,3,20,39,1818,1688,T1
3432,June 12,2013,Malawi,Kenya,2,2,World Cup qualifier,in Malawi,-4,4,1365,1400,-1,2,116,108,1369,1396,draw
3433,June 12,2013,Namibia,Nigeria,1,1,World Cup qualifier,in Namibia,14,-14,1318,1706,5,-2,129,36,1304,1720,draw
3434,June 14,2013,Ghana,Ivory Coast,1,1,Friendly,in Ghana,0,0,1699,1807,0,0,39,20,1699,1807,draw
3435,June 14,2013,Argentina,Guatemala,4,0,Friendly,in Guatemala,3,-3,2004,1486,0,0,5,89,2001,1489,T2
3436,June 14,2013,Libya,Togo,2,0,World Cup qualifier,in Libya,17,-17,1563,1465,4,-5,68,95,1546,1482,T1
3437,June 14,2013,Moldova,Kyrgyzstan,2,1,Friendly,in Moldova,3,-3,1394,1156,1,0,111,167,1391,1159,T1
3438,June 15,2013,Central African Republic,Botswana,2,3,World Cup qualifier,in Botswana,-15,15,1276,1286,-4,5,141,137,1291,1271,T1
3439,June 15,2013,Brazil,Japan,3,0,Confederations Cup,in Brazil,9,-9,2051,1766,0,-1,3,26,2042,1775,T1
3440,June 15,2013,Cape Verde,Sierra Leone,1,0,World Cup qualifier,in Cape Verde,10,-10,1461,1352,2,-7,98,124,1451,1362,T1
3441,June 15,2013,Thailand,China,5,1,Friendly,in China,34,-34,1354,1558,5,-10,123,70,1320,1592,T2
3442,June 15,2013,Congo,Burkina Faso,0,1,World Cup qualifier,in Congo,-19,19,1402,1556,-2,5,107,71,1421,1537,T2
3443,June 15,2013,Niger,Gabon,1,4,World Cup qualifier,in Gabon,-10,10,1284,1516,-2,4,138,84,1294,1506,T1
3444,June 15,2013,Morocco,Gambia,2,0,World Cup qualifier,in Morocco,9,-9,1530,1306,2,-2,79,134,1521,1315,T1
3445,June 15,2013,Uganda,Angola,2,1,World Cup qualifier,in Uganda,11,-11,1527,1446,3,-2,80,100,1516,1457,T1
3446,June 15,2013,Zambia,Sudan,1,1,World Cup qualifier,in Zambia,-14,14,1531,1361,-4,8,78,118,1545,1347,draw
3447,June 16,2013,Democratic Republic of Congo,Cameroon,0,0,World Cup qualifier,in the Democratic Republic of the Congo,0,0,1467,1565,0,0,93,65,1467,1565,draw
3448,June 16,2013,Tunisia,Equatorial Guinea,1,1,World Cup qualifier,in Equatorial Guinea,-9,9,1572,1313,-2,4,64,131,1581,1304,draw
3449,June 16,2013,South Africa,Ethiopia,1,2,World Cup qualifier,in Ethiopia,-27,27,1554,1385,-9,7,71,113,1581,1358,T1
3450,June 16,2013,Zimbabwe,Guinea,0,1,World Cup qualifier,in Guinea,-7,7,1343,1522,-1,1,127,84,1350,1515,T1
3451,June 16,2013,Italy,Mexico,2,1,Confederations Cup,in Brazil,22,-22,1932,1842,2,-4,7,16,1910,1864,T1
3452,June 16,2013,Lesotho,Ghana,0,2,World Cup qualifier,in Lesotho,-4,4,1148,1703,-1,1,169,38,1152,1699,T2
3453,June 16,2013,Senegal,Liberia,2,0,World Cup qualifier,in Liberia,25,-25,1545,1331,8,-6,75,128,1520,1356,T2
3454,June 16,2013,Benin,Mali,2,2,World Cup qualifier,in Mali,15,-15,1375,1592,3,-2,116,59,1360,1607,draw
3455,June 16,2013,Mozambique,Egypt,0,1,World Cup qualifier,in Mozambique,-8,8,1310,1673,-4,2,133,43,1318,1665,T2
3456,June 16,2013,Rwanda,Algeria,0,1,World Cup qualifier,in Rwanda,-15,15,1354,1578,-6,5,121,62,1369,1563,T2
3457,June 16,2013,Uruguay,Spain,1,2,Confederations Cup,in Brazil,-7,7,1837,2158,-1,0,18,1,1844,2151,T1
3458,June 16,2013,Ivory Coast,Tanzania,4,2,World Cup qualifier,in Tanzania,9,-9,1816,1388,0,-2,20,112,1807,1397,T2
3459,June 17,2013,Tahiti,Nigeria,1,6,Confederations Cup,in Brazil,-6,6,1230,1712,-2,1,148,35,1236,1706,T1
3460,June 18,2013,Australia,Iraq,1,0,World Cup qualifier,in Australia,6,-6,1772,1546,1,-2,25,74,1766,1552,T1
3461,June 18,2013,Panama,Costa Rica,0,2,World Cup qualifier,in Costa Rica,-19,19,1672,1745,-2,1,44,31,1691,1726,T1
3462,June 18,2013,Jordan,Oman,1,0,World Cup qualifier,in Jordan,16,-16,1555,1547,6,-6,70,73,1539,1563,T1
3463,June 18,2013,Iran,South Korea,1,0,World Cup qualifier,in South Korea,30,-30,1698,1719,5,-2,40,33,1668,1749,T2
3464,June 18,2013,United States,Honduras,1,0,World Cup qualifier,in the United States,8,-8,1805,1647,2,-2,22,51,1797,1655,T1
3465,June 18,2013,Qatar,Uzbekistan,1,5,World Cup qualifier,in Uzbekistan,-14,14,1453,1635,-6,1,99,53,1467,1621,T1
3466,June 19,2013,Brazil,Mexico,2,0,Confederations Cup,in Brazil,11,-11,2062,1831,1,-2,2,18,2051,1842,T1
3467,June 19,2013,Italy,Japan,4,3,Confederations Cup,in Brazil,14,-14,1946,1752,0,-2,7,29,1932,1766,T1
3468,June 20,2013,Spain,Tahiti,10,0,Confederations Cup,in Brazil,1,-1,2159,1229,0,0,1,148,2158,1230,T1
3469,June 20,2013,Uruguay,Nigeria,2,1,Confederations Cup,in Brazil,16,-16,1853,1696,3,-6,14,41,1837,1712,T1
3470,June 22,2013,Brazil,Italy,4,2,Confederations Cup,in Brazil,17,-17,2079,1929,0,0,2,7,2062,1946,T1
3471,June 22,2013,Mexico,Japan,2,1,Confederations Cup,in Brazil,19,-19,1850,1733,1,-2,17,31,1831,1752,T1
3472,June 22,2013,Monaco,Vatican,2,0,Friendly,in France,7,-7,902,693,0,-1,200,217,895,700,T1
3473,June 23,2013,Nigeria,Spain,0,3,Confederations Cup,in Brazil,-6,6,1690,2165,-1,0,42,1,1696,2159,T1
3474,June 23,2013,Uruguay,Tahiti,8,0,Confederations Cup,in Brazil,3,-3,1856,1226,1,-1,13,149,1853,1229,T1
3475,June 26,2013,Brazil,Uruguay,2,1,Confederations Cup,in Brazil,7,-7,2086,1849,0,-4,2,17,2079,1856,T1
3476,June 27,2013,Spain,Italy,0,0,Confederations Cup,in Brazil,-15,15,2150,1944,0,0,1,7,2165,1929,draw
3477,June 30,2013,Spain,Brazil,0,3,Confederations Cup,in Brazil,-39,39,2111,2125,-1,1,2,1,2150,2086,T1
3478,June 30,2013,Uruguay,Italy,2,2,Confederations Cup,in Brazil,7,-7,1856,1937,4,0,13,7,1849,1944,draw
3479,July 5,2013,Guatemala,United States,0,6,Friendly,in the United States,-3,3,1483,1808,0,1,89,21,1486,1805,T1
3480,July 6,2013,Mozambique,Malawi,1,0,Friendly,in Malawi,14,-14,1324,1351,4,-6,129,123,1310,1365,T2
3481,July 6,2013,Namibia,Mauritius,2,1,COSAFA Cup,in Zambia,6,-6,1324,1021,0,0,129,184,1318,1027,T1
3482,July 7,2013,Botswana,Swaziland,0,0,COSAFA Cup,in Zambia,-9,9,1277,1121,-3,1,140,176,1286,1112,draw
3483,July 7,2013,Martinique,Canada,1,0,CONCACAF Championship,in the United States,36,-36,1435,1528,7,-14,102,80,1399,1564,T1
3484,July 7,2013,Panama,Mexico,2,1,CONCACAF Championship,in the United States,37,-37,1709,1813,8,-3,36,20,1672,1850,T1
3485,July 8,2013,Trinidad and Tobago,El Salvador,2,2,CONCACAF Championship,in the United States,8,-8,1421,1528,2,-3,105,79,1413,1536,draw
3486,July 8,2013,Haiti,Honduras,0,2,CONCACAF Championship,in the United States,-17,17,1419,1664,-5,4,106,47,1436,1647,T1
3487,July 8,2013,Kenya,Lesotho,2,2,COSAFA Cup,in Zambia,-12,12,1388,1160,-2,2,111,167,1400,1148,draw
3488,July 8,2013,Namibia,Seychelles,4,2,COSAFA Cup,in Zambia,8,-8,1332,1002,1,-2,128,188,1324,1010,T1
3489,July 9,2013,Lesotho,Botswana,3,3,COSAFA Cup,in Zambia,6,-6,1166,1271,1,-2,166,142,1160,1277,draw
3490,July 9,2013,Cuba,Costa Rica,0,3,CONCACAF Championship,in the United States,-12,12,1421,1757,-2,1,104,29,1433,1745,T1
3491,July 9,2013,Kenya,Swaziland,2,0,COSAFA Cup,in Zambia,11,-11,1399,1110,2,-1,109,177,1388,1121,T1
3492,July 9,2013,Belize,United States,1,6,CONCACAF Championship,in the United States,-1,1,1170,1809,0,0,165,21,1171,1808,T1
3493,July 10,2013,Seychelles,Mauritius,0,4,COSAFA Cup,in Zambia,-35,35,967,1056,-4,1,192,183,1002,1021,T1
3494,July 11,2013,Kenya,Botswana,1,2,COSAFA Cup,in Zambia,-27,27,1372,1298,-7,6,116,136,1399,1271,T1
3495,July 11,2013,Lesotho,Swaziland,2,0,COSAFA Cup,in Zambia,25,-25,1191,1085,7,-3,159,180,1166,1110,T1
3496,July 11,2013,Mexico,Canada,2,0,CONCACAF Championship,in the United States,12,-12,1825,1516,2,-5,18,84,1813,1528,T1
3497,July 11,2013,Panama,Martinique,1,0,CONCACAF Championship,in the United States,9,-9,1718,1426,2,-1,34,102,1709,1435,T1
3498,July 12,2013,Trinidad and Tobago,Haiti,0,2,CONCACAF Championship,in the United States,-38,38,1383,1457,-9,8,113,98,1421,1419,T1
3499,July 12,2013,Honduras,El Salvador,1,0,CONCACAF Championship,in the United States,16,-16,1680,1512,3,-9,44,88,1664,1528,T1
3500,July 13,2013,Costa Rica,Belize,1,0,CONCACAF Championship,in the United States,2,-2,1759,1168,1,0,28,166,1757,1170,T1
3501,July 13,2013,Zimbabwe,Malawi,1,1,COSAFA Cup,in Zambia,0,0,1343,1351,0,0,127,123,1343,1351,draw
3502,July 13,2013,South Africa,Namibia,2,1,COSAFA Cup,in Zambia,9,-9,1563,1323,4,-2,66,130,1554,1332,T1
3503,July 13,2013,Cuba,United States,1,4,CONCACAF Championship,in the United States,-5,5,1416,1814,-1,0,106,21,1421,1809,T1
3504,July 14,2013,Lesotho,Angola,1,1,COSAFA Cup,in Zambia,13,-13,1204,1433,6,0,153,101,1191,1446,draw
3505,July 14,2013,Greenland,Bermuda,0,3,Island Games,in Bermuda,-9,9,951,1197,0,1,194,160,960,1188,T1
3506,July 14,2013,Panama,Canada,0,0,CONCACAF Championship,in the United States,-13,13,1705,1529,-2,4,36,79,1718,1516,draw
3507,July 14,2013,Martinique,Mexico,1,3,CONCACAF Championship,in the United States,-7,7,1419,1832,-1,0,104,18,1426,1825,T1
3508,July 14,2013,Zambia,Mozambique,3,1,COSAFA Cup,in Zambia,9,-9,1540,1315,1,-2,76,131,1531,1324,T1
3509,July 15,2013,Haiti,El Salvador,0,1,CONCACAF Championship,in the United States,-21,21,1436,1533,-3,11,101,77,1457,1512,T1
3510,July 15,2013,Trinidad and Tobago,Honduras,2,0,CONCACAF Championship,in the United States,64,-64,1447,1616,13,-10,100,54,1383,1680,T1
3511,July 16,2013,Angola,Malawi,3,2,COSAFA Cup,in Zambia,15,-15,1448,1336,2,-4,100,127,1433,1351,T1
3512,July 16,2013,Belize,Cuba,0,4,CONCACAF Championship,in the United States,-18,18,1150,1434,-2,4,168,103,1168,1416,T1
3513,July 16,2013,Mozambique,Namibia,1,0,COSAFA Cup,in Zambia,20,-20,1335,1303,3,-6,128,135,1315,1323,T1
3514,July 16,2013,United States,Costa Rica,1,0,CONCACAF Championship,in the United States,15,-15,1829,1744,2,-2,19,30,1814,1759,T1
3515,July 17,2013,Zambia,South Africa,0,0,COSAFA Cup,in Zambia,-4,4,1536,1567,0,1,76,65,1540,1563,draw
3516,July 17,2013,Zimbabwe,Lesotho,2,1,COSAFA Cup,in Zambia,12,-12,1355,1192,6,-7,120,160,1343,1204,T1
3517,July 18,2013,Greenland,Bermuda,0,1,Island Games,in Bermuda,-5,5,946,1202,-1,3,195,156,951,1197,T1
3518,July 18,2013,Mozambique,Angola,1,0,COSAFA Cup,in Zambia,26,-26,1361,1422,10,-5,118,105,1335,1448,T1
3519,July 20,2013,Trinidad and Tobago,Mexico,0,1,CONCACAF Championship,in the United States,-5,5,1442,1837,0,0,100,18,1447,1832,T1
3520,July 20,2013,Cuba,Panama,1,6,CONCACAF Championship,in the United States,-17,17,1417,1722,-5,4,107,32,1434,1705,T1
3521,July 20,2013,Lesotho,South Africa,1,2,COSAFA Cup,in Zambia,-4,4,1188,1571,-1,0,161,65,1192,1567,T1
3522,July 20,2013,South Korea,Australia,0,0,East Asian Cup,in South Korea,-3,3,1716,1775,-1,0,34,25,1719,1772,draw
3523,July 20,2013,Zimbabwe,Zambia,0,2,COSAFA Cup,in Zambia,-10,10,1345,1546,-6,3,127,73,1355,1536,T1
3524,July 21,2013,Japan,China,3,3,East Asian Cup,in South Korea,-9,9,1724,1567,1,2,30,66,1733,1558,draw
3525,July 21,2013,Costa Rica,Honduras,0,1,CONCACAF Championship,in the United States,-34,34,1710,1650,-6,4,36,50,1744,1616,T1
3526,July 21,2013,El Salvador,United States,1,5,CONCACAF Championship,in the United States,-9,9,1524,1838,-5,2,82,17,1533,1829,T1
3527,July 24,2013,Panama,Mexico,2,1,CONCACAF Championship,in the United States,33,-33,1755,1804,2,-3,29,22,1722,1837,T1
3528,July 24,2013,South Korea,China,0,0,East Asian Cup,in South Korea,-12,12,1704,1579,-4,4,37,62,1716,1567,draw
3529,July 24,2013,United States,Honduras,3,1,CONCACAF Championship,in the United States,12,-12,1850,1638,0,-2,17,52,1838,1650,T1
3530,July 25,2013,Australia,Japan,2,3,East Asian Cup,in South Korea,-23,23,1752,1747,-4,0,29,31,1775,1724,T1
3531,July 28,2013,Australia,China,3,4,East Asian Cup,in South Korea,-29,29,1723,1608,-2,6,31,56,1752,1579,T1
3532,July 28,2013,South Korea,Japan,1,2,East Asian Cup,in South Korea,-23,23,1681,1770,-6,6,43,25,1704,1747,T2
3533,July 28,2013,United States,Panama,1,0,CONCACAF Championship,in the United States,12,-12,1862,1743,5,-2,12,30,1850,1755,T1
3534,August 6,2013,Jordan,Palestine,4,1,Friendly,in Jordan,4,-4,1559,1286,1,0,69,137,1555,1290,T1
3535,August 9,2013,Libya,Jordan,1,2,Friendly,in Jordan,-7,7,1556,1566,-1,2,69,67,1563,1559,T1
3536,August 14,2013,Albania,Armenia,2,0,Friendly,in Albania,10,-10,1556,1523,2,-5,71,82,1546,1533,T1
3537,August 14,2013,Algeria,Guinea,2,2,Friendly,in Algeria,-4,4,1574,1526,-2,4,65,80,1578,1522,draw
3538,August 14,2013,Greece,Austria,2,0,Friendly,in Austria,12,-12,1816,1630,1,-2,21,53,1804,1642,T2
3539,August 14,2013,Malta,Azerbaijan,0,3,Friendly,in Azerbaijan,-8,8,1267,1402,0,1,142,108,1275,1394,T1
3540,August 14,2013,Belarus,Montenegro,1,1,Friendly,in Belarus,-1,1,1602,1659,1,-1,58,48,1603,1658,draw
3541,August 14,2013,France,Belgium,0,0,Friendly,in Belgium,2,-2,1860,1836,0,-1,13,19,1858,1838,draw
3542,August 14,2013,United States,Bosnia and Herzegovina,4,3,Friendly,in Bosnia and Herzegovina,11,-11,1873,1796,2,-3,10,24,1862,1807,T2
3543,August 14,2013,Gabon,Cape Verde,1,1,Friendly,in Portugal,-2,2,1514,1463,-1,2,86,95,1516,1461,draw
3544,August 14,2013,Chile,Iraq,6,0,Friendly,in Denmark,6,-6,1859,1540,2,-4,14,77,1853,1546,T1
3545,August 14,2013,Colombia,Serbia,1,0,Friendly,in Spain,4,-4,1916,1690,0,0,8,41,1912,1694,T1
3546,August 14,2013,Dominican Republic,Costa Rica,0,4,Friendly,in the Dominican Republic,-5,5,1265,1715,-1,3,144,32,1270,1710,T2
3547,August 14,2013,Spain,Ecuador,2,0,Friendly,in Ecuador,9,-9,2120,1847,1,-2,1,16,2111,1856,T2
3548,August 14,2013,Uganda,Egypt,0,3,Friendly,in Egypt,-7,7,1520,1680,-3,0,83,44,1527,1673,T1
3549,August 14,2013,England,Scotland,3,2,Friendly,in England,2,-2,1954,1648,0,0,6,50,1952,1650,T1
3550,August 14,2013,Latvia,Estonia,1,1,Friendly,in Estonia,3,-3,1472,1473,0,0,92,91,1469,1476,draw
3551,August 14,2013,Finland,Slovenia,2,0,Friendly,in Finland,9,-9,1674,1599,1,-3,45,59,1665,1608,T1
3552,August 14,2013,Paraguay,Germany,3,3,Friendly,in Germany,9,-9,1710,2046,4,0,34,3,1701,2055,draw
3553,August 14,2013,Czechia,Hungary,1,1,Friendly,in Hungary,1,-1,1770,1697,1,-1,25,40,1769,1698,draw
3554,August 14,2013,Iceland,Faroe Islands,1,0,Friendly,in Iceland,2,-2,1482,1201,0,-4,90,157,1480,1203,T1
3555,August 14,2013,Indonesia,Philippines,2,0,Friendly,in Indonesia,11,-11,1225,1218,3,-4,149,152,1214,1229,T1
3556,August 14,2013,Argentina,Italy,2,1,Friendly tournament,in Italy,16,-16,2020,1921,1,0,4,7,2004,1937,T2
3557,August 14,2013,Uruguay,Japan,4,2,Friendly,in Japan,16,-16,1872,1754,3,-2,11,27,1856,1770,T2
3558,August 14,2013,Georgia,Kazakhstan,0,1,Friendly,in Kazakhstan,-12,12,1503,1362,-2,8,88,117,1515,1350,T1
3559,August 14,2013,Central African Republic,Libya,0,0,Friendly,in Libya,8,-8,1284,1548,3,-4,138,73,1276,1556,draw
3560,August 14,2013,Liechtenstein,Croatia,2,3,Friendly,in Liechtenstein,-1,1,1202,1868,-1,-1,154,12,1203,1867,T2
3561,August 14,2013,Luxembourg,Lithuania,2,1,Friendly,in Luxembourg,15,-15,1191,1447,3,-4,160,100,1176,1462,T1
3562,August 14,2013,Macedonia,Bulgaria,2,0,Friendly,in Macedonia,18,-18,1542,1687,6,-6,76,42,1524,1705,T1
3563,August 14,2013,Mexico,Ivory Coast,4,1,Friendly,in the United States,18,-18,1822,1798,2,-3,20,23,1804,1816,T1
3564,August 14,2013,Moldova,Andorra,1,1,Friendly,in Moldova,-9,9,1385,997,-2,1,111,188,1394,988,draw
3565,August 14,2013,Burkina Faso,Morocco,2,1,Friendly,in Morocco,12,-12,1568,1518,3,-6,66,84,1556,1530,T2
3566,August 14,2013,Northern Ireland,Russia,1,0,World Cup qualifier,in Northern Ireland,36,-36,1454,1843,8,-7,98,17,1418,1879,T1
3567,August 14,2013,Poland,Denmark,3,2,Friendly,in Poland,9,-9,1660,1712,2,-1,47,33,1651,1721,T1
3568,August 14,2013,Netherlands,Portugal,1,1,Friendly,in Portugal,0,0,2009,1911,-1,0,5,9,2009,1911,draw
3569,August 14,2013,Slovakia,Romania,1,1,Friendly,in Romania,7,-7,1585,1752,0,0,63,28,1578,1759,draw
3570,August 14,2013,Rwanda,Malawi,0,1,Friendly,in Rwanda,-13,13,1341,1349,-7,3,128,125,1354,1336,T2
3571,August 14,2013,Senegal,Zambia,1,1,Friendly,in France,0,0,1545,1546,1,-1,75,74,1545,1546,draw
3572,August 14,2013,Oman,Singapore,2,0,Asian Cup qualifier,in Singapore,17,-17,1564,1266,3,-4,69,143,1547,1283,T2
3573,August 14,2013,South Africa,Nigeria,0,2,Friendly,in South Africa,-14,14,1557,1704,-4,4,70,38,1571,1690,T2
3574,August 14,2013,Peru,South Korea,0,0,Friendly,in South Korea,0,0,1764,1681,1,0,26,43,1764,1681,draw
3575,August 14,2013,Norway,Sweden,2,4,Friendly,in Sweden,-6,6,1707,1857,-2,2,35,15,1713,1851,T1
3576,August 14,2013,Switzerland,Brazil,1,0,Friendly,in Switzerland,15,-15,1837,2110,1,-1,18,2,1822,2125,T1
3577,August 14,2013,Tajikistan,India,3,0,Friendly,in Tajikistan,8,-8,1242,1121,0,0,146,175,1234,1129,T1
3578,August 14,2013,Congo,Tunisia,0,3,Friendly,in Tunisia,-6,6,1396,1578,-1,1,109,64,1402,1572,T1
3579,August 14,2013,Ghana,Turkey,2,2,Friendly,in Turkey,2,-2,1705,1655,0,-1,37,49,1703,1657,draw
3580,August 14,2013,Israel,Ukraine,0,2,Friendly,in Ukraine,-6,6,1666,1808,-1,2,46,22,1672,1802,T1
3581,August 14,2013,Bolivia,Venezuela,2,2,Friendly,in Venezuela,5,-5,1629,1707,0,-1,54,35,1624,1712,draw
3582,August 14,2013,Wales,Ireland,0,0,Friendly,in Wales,1,-1,1608,1750,2,0,56,29,1607,1751,draw
3583,August 15,2013,Jordan,Syria,1,1,Asian Cup qualifier,in Iran,-3,3,1563,1518,-2,1,69,84,1566,1515,draw
3584,August 17,2013,South Africa,Burkina Faso,2,0,Friendly,in South Africa,11,-11,1568,1557,4,-4,66,70,1557,1568,T1
3585,August 20,2013,Afghanistan,Pakistan,3,0,Friendly,in Afghanistan,12,-12,959,917,0,0,194,199,947,929,T1
3586,August 27,2013,Libya,Mali,1,0,Friendly,in Tunisia,11,-11,1559,1581,3,-3,70,63,1548,1592,T1
3587,August 30,2013,Ghana,Libya,0,1,Friendly,in Tunisia,-14,14,1691,1573,-3,4,40,66,1705,1559,T1
3588,August 31,2013,Uganda,Botswana,3,1,Friendly,in Botswana,10,-10,1530,1288,5,0,78,136,1520,1298,T2
3589,August 31,2013,Bangladesh,Nepal,0,2,South Asian Cup,in Nepal,-31,31,957,910,-4,2,194,200,988,879,T1
3590,September 1,2013,India,Pakistan,1,0,South Asian Cup,in Nepal,9,-9,1130,908,0,-1,175,200,1121,917,T1
3591,September 2,2013,Bhutan,Afghanistan,0,3,South Asian Cup,in Nepal,-6,6,538,965,0,1,233,192,544,959,T1
3592,September 2,2013,Sri Lanka,Maldives,0,10,South Asian Cup,in Nepal,-20,20,834,1126,-1,1,207,176,854,1106,T1
3593,September 3,2013,India,Bangladesh,1,1,South Asian Cup,in Nepal,-9,9,1121,966,-1,2,176,192,1130,957,draw
3594,September 3,2013,Botswana,Malawi,1,0,Friendly,in Botswana,9,-9,1297,1340,0,-3,136,128,1288,1349,T1
3595,September 3,2013,Nepal,Pakistan,1,1,South Asian Cup,in Nepal,-6,6,904,914,-1,1,200,199,910,908,draw
3596,September 4,2013,Sri Lanka,Afghanistan,1,3,South Asian Cup,in Nepal,-19,19,815,984,-1,3,208,190,834,965,T1
3597,September 4,2013,Libya,Equatorial Guinea,1,1,Friendly,in Equatorial Guinea,-4,4,1569,1317,0,1,66,130,1573,1313,draw
3598,September 4,2013,Maldives,Bhutan,8,2,South Asian Cup,in Nepal,3,-3,1129,535,0,0,175,233,1126,538,T1
3599,September 5,2013,India,Nepal,1,2,South Asian Cup,in Nepal,-26,26,1095,930,-2,1,178,199,1121,904,T1
3600,September 5,2013,Pakistan,Bangladesh,2,1,South Asian Cup,in Nepal,23,-23,937,943,3,-2,196,195,914,966,T1
3601,September 5,2013,Mauritius,Qatar,0,3,Friendly,in Qatar,-2,2,1054,1455,0,2,183,97,1056,1453,T1
3602,September 5,2013,Saudi Arabia,New Zealand,0,1,Friendly tournament,in Saudi Arabia,-16,16,1498,1606,-2,4,88,57,1514,1590,T2
3603,September 5,2013,United Arab Emirates,Trinidad and Tobago,3,3,Friendly tournament,in Saudi Arabia,-7,7,1605,1449,-3,1,58,100,1612,1442,draw
3604,September 6,2013,Maldives,Afghanistan,0,0,South Asian Cup,in Nepal,-8,8,1121,992,0,0,175,190,1129,984,draw
3605,September 6,2013,Kyrgyzstan,Belarus,1,3,Friendly,in Belarus,-1,1,1155,1603,0,-1,167,60,1156,1602,T1
3606,September 6,2013,Slovakia,Bosnia and Herzegovina,1,0,World Cup qualifier,in Bosnia and Herzegovina,34,-34,1619,1762,8,-1,54,25,1585,1796,T2
3607,September 6,2013,Chile,Venezuela,3,0,World Cup qualifier,in Chile,13,-13,1872,1694,2,-4,12,39,1859,1707,T1
3608,September 6,2013,Singapore,China,1,6,Friendly,in China,-3,3,1263,1611,0,0,143,55,1266,1608,T1
3609,September 6,2013,Ecuador,Colombia,0,1,World Cup qualifier,in Colombia,-11,11,1836,1927,-2,1,18,7,1847,1916,T1
3610,September 6,2013,Costa Rica,United States,3,1,World Cup qualifier,in Costa Rica,35,-35,1750,1838,5,-7,27,17,1715,1873,T1
3611,September 6,2013,Armenia,Czechia,2,1,World Cup qualifier,in Czechia,35,-35,1558,1735,11,-4,72,29,1523,1770,T2
3612,September 6,2013,Moldova,England,0,4,World Cup qualifier,in England,-2,2,1383,1956,-2,0,113,6,1385,1954,T1
3613,September 6,2013,Netherlands,Estonia,2,2,World Cup qualifier,in Estonia,-17,17,1992,1490,0,1,5,90,2009,1473,draw
3614,September 6,2013,Finland,Spain,0,2,World Cup qualifier,in Finland,-7,7,1667,2127,-1,0,46,1,1674,2120,T2
3615,September 6,2013,Georgia,France,0,0,World Cup qualifier,in Georgia,13,-13,1516,1847,2,-2,85,15,1503,1860,draw
3616,September 6,2013,Germany,Austria,3,0,World Cup qualifier,in Germany,3,-3,2049,1627,0,1,3,52,2046,1630,T1
3617,September 6,2013,Zambia,Ghana,1,2,World Cup qualifier,in Ghana,-8,8,1538,1699,-5,3,79,37,1546,1691,T1
3618,September 6,2013,Sweden,Ireland,2,1,World Cup qualifier,in Ireland,20,-20,1877,1730,4,-1,11,30,1857,1750,T2
3619,September 6,2013,Bulgaria,Italy,0,1,World Cup qualifier,in Italy,-5,5,1682,1926,0,-1,42,8,1687,1921,T1
3620,September 6,2013,Guatemala,Japan,0,3,Friendly,in Japan,-4,4,1479,1758,-3,1,92,26,1483,1754,T1
3621,September 6,2013,Jordan,Uzbekistan,1,1,World Cup qualifier,in Jordan,-2,2,1561,1637,0,1,70,51,1563,1635,draw
3622,September 6,2013,Faroe Islands,Kazakhstan,1,2,World Cup qualifier,in Kazakhstan,-7,7,1194,1369,-2,0,159,117,1201,1362,T1
3623,September 6,2013,North Korea,Kuwait,1,2,Friendly,in Kuwait,-8,8,1584,1557,-1,0,62,73,1592,1549,T1
3624,September 6,2013,Lithuania,Latvia,1,2,World Cup qualifier,in Latvia,-13,13,1434,1485,0,1,101,91,1447,1472,T1
3625,September 6,2013,Syria,Lebanon,0,2,Friendly,in Lebanon,-18,18,1500,1369,-3,7,87,117,1518,1351,T1
3626,September 6,2013,Greece,Liechtenstein,1,0,World Cup qualifier,in Liechtenstein,2,-2,1818,1200,1,-2,20,156,1816,1202,T2
3627,September 6,2013,Wales,Macedonia,1,2,World Cup qualifier,in Macedonia,-18,18,1590,1560,-6,5,61,71,1608,1542,T1
3628,September 6,2013,Malta,Denmark,1,2,World Cup qualifier,in Malta,-5,5,1262,1717,-2,-1,144,34,1267,1712,T2
3629,September 6,2013,Mexico,Honduras,1,2,World Cup qualifier,in Mexico,-33,33,1789,1671,-3,6,23,45,1822,1638,T2
3630,September 6,2013,Myanmar,Hong Kong,0,0,Friendly,in Myanmar,2,-2,1007,1188,0,0,187,161,1005,1190,draw
3631,September 6,2013,Cyprus,Norway,0,2,World Cup qualifier,in Norway,-6,6,1422,1713,-1,0,104,35,1428,1707,T1
3632,September 6,2013,Northern Ireland,Portugal,2,4,World Cup qualifier,in Northern Ireland,-7,7,1447,1918,-1,0,100,9,1454,1911,T2
3633,September 6,2013,Jamaica,Panama,0,0,World Cup qualifier,in Panama,14,-14,1541,1729,3,-2,77,32,1527,1743,draw
3634,September 6,2013,Paraguay,Bolivia,4,0,World Cup qualifier,in Paraguay,20,-20,1730,1609,4,-3,30,57,1710,1629,T1
3635,September 6,2013,Uruguay,Peru,2,1,World Cup qualifier,in Peru,20,-20,1892,1744,1,-2,10,28,1872,1764,T2
3636,September 6,2013,Montenegro,Poland,1,1,World Cup qualifier,in Poland,6,-6,1665,1654,0,-3,48,50,1659,1660,draw
3637,September 6,2013,Hungary,Romania,0,3,World Cup qualifier,in Romania,-20,20,1677,1772,-5,4,44,24,1697,1752,T1
3638,September 6,2013,Russia,Luxembourg,4,1,World Cup qualifier,in Russia,1,-1,1844,1190,1,0,16,160,1843,1191,T1
3639,September 6,2013,Belgium,Scotland,2,0,World Cup qualifier,in Scotland,23,-23,1859,1625,5,-3,14,53,1836,1648,T2
3640,September 6,2013,Serbia,Croatia,1,1,World Cup qualifier,in Serbia,4,-4,1694,1864,2,-1,39,13,1690,1868,draw
3641,September 6,2013,Slovenia,Albania,1,0,World Cup qualifier,in Slovenia,12,-12,1611,1544,5,-4,55,76,1599,1556,T1
3642,September 6,2013,South Korea,Haiti,4,1,Friendly,in South Korea,4,-4,1685,1432,2,0,41,102,1681,1436,T1
3643,September 6,2013,Sri Lanka,Bhutan,5,2,South Asian Cup,in Nepal,12,-12,827,523,1,0,207,233,815,535,T1
3644,September 6,2013,Iceland,Switzerland,4,4,World Cup qualifier,in Switzerland,17,-17,1499,1820,2,-1,88,19,1482,1837,draw
3645,September 6,2013,Andorra,Turkey,0,5,World Cup qualifier,in Turkey,-1,1,996,1656,0,0,188,49,997,1655,T1
3646,September 6,2013,San Marino,Ukraine,0,9,World Cup qualifier,in Ukraine,0,0,883,1808,0,1,202,21,883,1808,T1
3647,September 7,2013,Liberia,Angola,1,4,World Cup qualifier,in Angola,-17,17,1314,1439,-2,3,131,101,1331,1422,T1
3648,September 7,2013,Brazil,Australia,6,0,Friendly,in Brazil,2,-2,2112,1721,0,0,2,33,2110,1723,T1
3649,September 7,2013,Burkina Faso,Gabon,1,0,World Cup qualifier,in Burkina Faso,12,-12,1569,1502,7,-1,66,87,1557,1514,T1
3650,September 7,2013,Central African Republic,Ethiopia,1,2,World Cup qualifier,in Congo,-14,14,1270,1399,-2,2,140,109,1284,1385,T1
3651,September 7,2013,Tanzania,Gambia,0,2,World Cup qualifier,in The Gambia,-28,28,1360,1334,-12,5,122,129,1388,1306,T1
3652,September 7,2013,Azerbaijan,Israel,1,1,World Cup qualifier,in Israel,16,-16,1418,1650,1,-3,107,50,1402,1666,draw
3653,September 7,2013,Ivory Coast,Morocco,1,1,World Cup qualifier,in Ivory Coast,-16,16,1782,1534,-1,5,23,79,1798,1518,draw
3654,September 7,2013,Niger,Congo,2,2,World Cup qualifier,in Niger,1,-1,1285,1395,0,-1,138,110,1284,1396,draw
3655,September 7,2013,Nigeria,Malawi,2,0,World Cup qualifier,in Nigeria,4,-4,1708,1336,0,0,36,128,1704,1340,T1
3656,September 7,2013,Senegal,Uganda,1,0,World Cup qualifier,in Morocco,19,-19,1564,1511,6,-5,69,85,1545,1530,T1
3657,September 7,2013,Sierra Leone,Equatorial Guinea,3,2,World Cup qualifier,in Sierra Leone,13,-13,1365,1304,6,-4,118,134,1352,1317,T1
3658,September 7,2013,South Africa,Botswana,4,1,World Cup qualifier,in South Africa,7,-7,1575,1290,3,0,64,136,1568,1297,T1
3659,September 7,2013,Tunisia,Cape Verde,0,2,World Cup qualifier,in Tunisia,-47,47,1531,1510,-16,9,80,86,1578,1463,T2
3660,September 8,2013,Benin,Rwanda,2,0,World Cup qualifier,in Benin,19,-19,1394,1322,3,-1,111,128,1375,1341,T1
3661,September 8,2013,Libya,Cameroon,0,1,World Cup qualifier,in Cameroon,-15,15,1554,1580,-8,4,74,64,1569,1565,T1
3662,September 8,2013,Canada,Mauritania,0,0,Friendly,in Spain,-8,8,1521,1155,-2,3,83,167,1529,1147,draw
3663,September 8,2013,Namibia,Kenya,0,1,World Cup qualifier,in Kenya,-11,11,1292,1383,0,2,135,113,1303,1372,T1
3664,September 8,2013,Nepal,Afghanistan,0,1,South Asian Cup,in Nepal,-22,22,908,1014,-1,4,200,186,930,992,T2
3665,September 8,2013,Sudan,Lesotho,1,3,World Cup qualifier,in Sudan,-50,50,1311,1238,-11,14,131,147,1361,1188,T2
3666,September 8,2013,Togo,Democratic Republic of Congo,2,1,World Cup qualifier,in Togo,15,-15,1480,1452,2,-4,93,98,1465,1467,T1
3667,September 8,2013,Mozambique,Zimbabwe,1,1,World Cup qualifier,in Zimbabwe,5,-5,1366,1340,2,1,118,125,1361,1345,draw
3668,September 9,2013,India,Maldives,1,0,South Asian Cup,in Nepal,21,-21,1116,1100,2,-3,176,178,1095,1121,T1
3669,September 9,2013,Bahrain,Kuwait,1,2,Friendly,in Kuwait,-5,5,1458,1562,-1,3,96,70,1463,1557,T1
3670,September 9,2013,Qatar,Lebanon,1,1,Friendly,in Qatar,-5,5,1450,1374,-3,0,99,116,1455,1369,draw
3671,September 9,2013,Saudi Arabia,Trinidad and Tobago,1,3,Friendly tournament,in Saudi Arabia,-32,32,1466,1481,-5,7,95,92,1498,1449,T2
3672,September 9,2013,United Arab Emirates,New Zealand,2,0,Friendly tournament,in Saudi Arabia,23,-23,1628,1583,7,-4,52,62,1605,1606,T1
3673,September 10,2013,Algeria,Mali,1,0,World Cup qualifier,in Algeria,15,-15,1589,1566,7,-2,59,65,1574,1581,T1
3674,September 10,2013,Andorra,Netherlands,0,2,World Cup qualifier,in Andorra,0,0,996,1992,0,0,189,5,996,1992,T2
3675,September 10,2013,Denmark,Armenia,1,0,World Cup qualifier,in Armenia,17,-17,1734,1541,7,-1,27,74,1717,1558,T2
3676,September 10,2013,Austria,Ireland,1,0,World Cup qualifier,in Austria,20,-20,1647,1710,3,-7,50,37,1627,1730,T1
3677,September 10,2013,Belarus,France,2,4,World Cup qualifier,in Belarus,-18,18,1585,1865,-1,1,60,14,1603,1847,T2
3678,September 10,2013,Ecuador,Bolivia,1,1,World Cup qualifier,in Bolivia,-7,7,1829,1616,-1,2,19,56,1836,1609,draw
3679,September 10,2013,Brazil,Portugal,3,1,Friendly,in the United States,7,-7,2119,1911,0,0,2,9,2112,1918,T1
3680,September 10,2013,Chile,Spain,2,2,Friendly,in Switzerland,6,-6,1878,2121,0,0,12,1,1872,2127,draw
3681,September 10,2013,China,Malaysia,2,0,Friendly,in China,1,-1,1612,1179,-1,0,57,163,1611,1180,T1
3682,September 10,2013,Slovenia,Cyprus,2,0,World Cup qualifier,in Cyprus,22,-22,1633,1400,3,-3,53,108,1611,1422,T2
3683,September 10,2013,Guinea,Egypt,2,4,World Cup qualifier,in Egypt,-11,11,1515,1691,-2,3,83,40,1526,1680,T1
3684,September 10,2013,Germany,Faroe Islands,3,0,World Cup qualifier,in the Faroe Islands,1,-1,2050,1193,0,-1,3,161,2049,1194,T2
3685,September 10,2013,Finland,Georgia,1,0,World Cup qualifier,in Georgia,17,-17,1684,1499,2,-5,44,89,1667,1516,T2
3686,September 10,2013,Latvia,Greece,0,1,World Cup qualifier,in Greece,-3,3,1482,1821,1,0,90,20,1485,1818,T1
3687,September 10,2013,Honduras,Panama,2,2,World Cup qualifier,in Honduras,-2,2,1669,1731,-2,4,47,28,1671,1729,draw
3688,September 10,2013,Singapore,Hong Kong,0,1,Friendly,in Hong Kong,-9,9,1254,1197,-1,2,144,160,1263,1188,T1
3689,September 10,2013,Estonia,Hungary,1,5,World Cup qualifier,in Hungary,-12,12,1478,1689,-4,2,94,42,1490,1677,T1
3690,September 10,2013,Iceland,Albania,2,1,World Cup qualifier,in Iceland,17,-17,1516,1527,7,-5,82,80,1499,1544,T1
3691,September 10,2013,Czechia,Italy,1,2,World Cup qualifier,in Italy,-6,6,1729,1932,0,1,29,7,1735,1926,T1
3692,September 10,2013,Jamaica,Costa Rica,1,1,World Cup qualifier,in Jamaica,6,-6,1547,1744,3,1,73,26,1541,1750,draw
3693,September 10,2013,Japan,Ghana,3,1,Friendly,in Japan,9,-9,1767,1690,1,-4,25,41,1758,1699,T1
3694,September 10,2013,Kazakhstan,Sweden,0,1,World Cup qualifier,in Kazakhstan,-3,3,1366,1880,0,0,117,11,1369,1877,T2
3695,September 10,2013,Lithuania,Liechtenstein,2,0,World Cup qualifier,in Lithuania,8,-8,1442,1192,2,-5,100,162,1434,1200,T1
3696,September 10,2013,Northern Ireland,Luxembourg,2,3,World Cup qualifier,in Luxembourg,-28,28,1419,1218,-4,8,104,153,1447,1190,T1
3697,September 10,2013,Scotland,Macedonia,2,1,World Cup qualifier,in Macedonia,22,-22,1647,1538,4,-4,50,76,1625,1560,T2
3698,September 10,2013,Malta,Bulgaria,1,2,World Cup qualifier,in Malta,-5,5,1257,1687,1,-1,143,43,1262,1682,T2
3699,September 10,2013,Canada,Mauritania,0,1,Friendly,in Spain,-18,18,1503,1173,-3,1,86,166,1521,1155,T1
3700,September 10,2013,Nigeria,Burkina Faso,4,1,Friendly,in Nigeria,7,-7,1715,1562,2,-1,34,68,1708,1569,T1
3701,September 10,2013,Norway,Switzerland,0,2,World Cup qualifier,in Norway,-29,29,1684,1849,-9,1,44,18,1713,1820,T2
3702,September 10,2013,Paraguay,Argentina,2,5,World Cup qualifier,in Paraguay,-18,18,1712,2038,-5,0,35,4,1730,2020,T2
3703,September 10,2013,Romania,Turkey,0,2,World Cup qualifier,in Romania,-47,47,1725,1703,-8,10,32,38,1772,1656,T2
3704,September 10,2013,Russia,Israel,3,1,World Cup qualifier,in Russia,9,-9,1853,1641,-1,-2,17,52,1844,1650,T1
3705,September 10,2013,San Marino,Poland,1,5,World Cup qualifier,in San Marino,-2,2,881,1656,0,0,202,49,883,1654,T2
3706,September 10,2013,Bosnia and Herzegovina,Slovakia,2,1,World Cup qualifier,in Slovakia,18,-18,1780,1601,2,-3,23,58,1762,1619,T2
3707,September 10,2013,Zimbabwe,South Africa,2,1,Friendly,in South Africa,17,-17,1357,1558,2,-5,123,70,1340,1575,T2
3708,September 10,2013,South Korea,Croatia,1,2,Friendly,in South Korea,-8,8,1677,1872,-5,0,46,13,1685,1864,T2
3709,September 10,2013,England,Ukraine,0,0,World Cup qualifier,in Ukraine,-3,3,1953,1811,0,0,6,21,1956,1808,draw
3710,September 10,2013,Colombia,Uruguay,0,2,World Cup qualifier,in Uruguay,-24,24,1903,1916,-3,2,10,8,1927,1892,T1
3711,September 10,2013,Mexico,United States,0,2,World Cup qualifier,in the United States,-18,18,1771,1856,-2,1,24,16,1789,1838,T1
3712,September 10,2013,Uzbekistan,Jordan,1,1,World Cup qualifier,in Uzbekistan,-9,9,1628,1570,-3,7,54,64,1637,1561,draw
3713,September 10,2013,Peru,Venezuela,2,3,World Cup qualifier,in Venezuela,-17,17,1727,1711,-3,3,31,36,1744,1694,T1
3714,September 10,2013,Wales,Serbia,0,3,World Cup qualifier,in Wales,-35,35,1555,1729,-11,10,71,29,1590,1694,T2
3715,September 11,2013,Afghanistan,India,2,0,South Asian Cup,in Nepal,39,-39,1053,1077,2,-5,184,181,1014,1116,T1
3716,September 30,2013,Botswana,Burkina Faso,1,0,Friendly,in Botswana,15,-15,1305,1547,2,-4,134,72,1290,1562,T1
3717,September 30,2013,Egypt,Uganda,2,0,Friendly,in Egypt,5,-5,1696,1506,0,-1,40,85,1691,1511,T1
3718,October 2,2013,Uganda,Egypt,0,3,Friendly,in Egypt,-6,6,1500,1702,-2,1,87,39,1506,1696,T1
3719,October 5,2013,Laos,United Arab Emirates,0,2,Friendly,in China,0,0,862,1628,0,0,205,54,862,1628,T1
3720,October 6,2013,Yemen,Iraq,2,3,Friendly,in Lebanon,-3,3,1199,1543,-2,1,158,74,1202,1540,T1
3721,October 8,2013,Lebanon,Iraq,1,1,Friendly,in Lebanon,2,-2,1376,1541,0,0,116,74,1374,1543,draw
3722,October 9,2013,Kuwait,Jordan,1,1,Friendly,in Jordan,3,-3,1565,1567,2,0,66,64,1562,1570,draw
3723,October 9,2013,Mauritania,Oman,0,0,Friendly,in Oman,9,-9,1182,1555,3,-3,163,69,1173,1564,draw
3724,October 9,2013,Vietnam,Qatar,2,1,Friendly,in Qatar,17,-17,1236,1433,4,-2,148,101,1219,1450,T2
3725,October 9,2013,Malaysia,United Arab Emirates,1,3,Friendly,in China,-2,2,1177,1630,-1,0,164,54,1179,1628,T1
3726,October 10,2013,Laos,Singapore,0,1,Friendly,in Singapore,-1,1,861,1255,0,0,205,144,862,1254,T1
3727,October 10,2013,Thailand,Bahrain,1,0,Friendly,in Thailand,10,-10,1364,1448,4,-2,120,98,1354,1458,T1
3728,October 11,2013,Albania,Switzerland,1,2,World Cup qualifier,in Albania,-9,9,1518,1858,-2,2,82,16,1527,1849,T2
3729,October 11,2013,Romania,Andorra,4,0,World Cup qualifier,in Andorra,2,-2,1727,994,3,-1,29,190,1725,996,T2
3730,October 11,2013,Argentina,Peru,3,1,World Cup qualifier,in Argentina,5,-5,2043,1722,0,-1,4,32,2038,1727,T1
3731,October 11,2013,Armenia,Bulgaria,2,1,World Cup qualifier,in Armenia,23,-23,1564,1664,6,-3,68,46,1541,1687,T1
3732,October 11,2013,Northern Ireland,Azerbaijan,0,2,World Cup qualifier,in Azerbaijan,-22,22,1397,1440,-4,6,108,100,1419,1418,T1
3733,October 11,2013,Bosnia and Herzegovina,Liechtenstein,4,1,World Cup qualifier,in Bosnia and Herzegovina,1,-1,1781,1191,-1,1,24,161,1780,1192,T1
3734,October 11,2013,Chile,Colombia,3,3,World Cup qualifier,in Colombia,7,-7,1885,1896,1,1,11,9,1878,1903,draw
3735,October 11,2013,Belgium,Croatia,2,1,World Cup qualifier,in Croatia,26,-26,1885,1846,4,-6,11,19,1859,1872,T2
3736,October 11,2013,Denmark,Italy,2,2,World Cup qualifier,in Denmark,5,-5,1739,1927,0,0,27,7,1734,1932,draw
3737,October 11,2013,Ecuador,Uruguay,1,0,World Cup qualifier,in Ecuador,19,-19,1848,1897,1,0,18,8,1829,1916,T1
3738,October 11,2013,Montenegro,England,1,4,World Cup qualifier,in England,-7,7,1658,1960,0,0,48,6,1665,1953,T1
3739,October 11,2013,Estonia,Turkey,0,2,World Cup qualifier,in Estonia,-20,20,1458,1723,-1,7,95,31,1478,1703,T2
3740,October 11,2013,Kazakhstan,Faroe Islands,1,1,World Cup qualifier,in the Faroe Islands,-4,4,1362,1197,-3,2,120,159,1366,1193,draw
3741,October 11,2013,France,Australia,6,0,Friendly,in France,8,-8,1873,1713,0,-3,14,36,1865,1721,T1
3742,October 11,2013,Ireland,Germany,0,3,World Cup qualifier,in Germany,-5,5,1705,2055,0,0,37,3,1710,2050,T1
3743,October 11,2013,Slovakia,Greece,0,1,World Cup qualifier,in Greece,-5,5,1596,1826,0,0,58,20,1601,1821,T1
3744,October 11,2013,Costa Rica,Honduras,0,1,World Cup qualifier,in Honduras,-19,19,1725,1688,-4,5,30,42,1744,1669,T1
3745,October 11,2013,Iceland,Cyprus,2,0,World Cup qualifier,in Iceland,13,-13,1529,1387,3,-3,79,111,1516,1400,T1
3746,October 11,2013,Lithuania,Latvia,2,0,World Cup qualifier,in Lithuania,25,-25,1467,1457,6,-6,93,96,1442,1482,T1
3747,October 11,2013,Luxembourg,Russia,0,4,World Cup qualifier,in Luxembourg,-3,3,1215,1856,0,0,153,17,1218,1853,T2
3748,October 11,2013,Malta,Czechia,1,4,World Cup qualifier,in Malta,-7,7,1250,1736,-1,1,144,28,1257,1729,T2
3749,October 11,2013,Panama,Mexico,1,2,World Cup qualifier,in Mexico,-12,12,1719,1783,-5,2,33,22,1731,1771,T1
3750,October 11,2013,San Marino,Moldova,0,3,World Cup qualifier,in Moldova,-2,2,879,1385,0,1,202,112,881,1383,T1
3751,October 11,2013,South Africa,Morocco,1,1,Friendly,in Morocco,2,-2,1560,1532,-2,1,70,77,1558,1534,draw
3752,October 11,2013,Hungary,Netherlands,1,8,World Cup qualifier,in the Netherlands,-8,8,1681,2000,-2,0,44,5,1689,1992,T1
3753,October 11,2013,Philippines,Taiwan,1,2,Friendly tournament,in the Philippines,-28,28,1190,855,-9,1,162,206,1218,827,T2
3754,October 11,2013,Portugal,Israel,1,1,World Cup qualifier,in Portugal,-16,16,1895,1657,-1,3,10,49,1911,1641,draw
3755,October 11,2013,Serbia,Japan,2,0,Friendly,in Serbia,12,-12,1741,1755,3,0,26,25,1729,1767,T1
3756,October 11,2013,Slovenia,Norway,3,0,World Cup qualifier,in Slovenia,30,-30,1663,1654,6,-6,47,50,1633,1684,T1
3757,October 11,2013,Spain,Belarus,2,1,World Cup qualifier,in Spain,1,-1,2122,1584,0,0,1,60,2121,1585,T1
3758,October 11,2013,Austria,Sweden,1,2,World Cup qualifier,in Sweden,-5,5,1642,1885,-3,0,53,11,1647,1880,T1
3759,October 11,2013,Poland,Ukraine,0,1,World Cup qualifier,in Ukraine,-7,7,1649,1818,-2,0,51,21,1656,1811,T1
3760,October 11,2013,United States,Jamaica,2,0,World Cup qualifier,in the United States,5,-5,1861,1542,1,-2,15,74,1856,1547,T1
3761,October 11,2013,Venezuela,Paraguay,1,1,World Cup qualifier,in Venezuela,-6,6,1705,1718,-1,1,37,34,1711,1712,draw
3762,October 11,2013,Macedonia,Wales,0,1,World Cup qualifier,in Wales,-14,14,1524,1569,-4,5,80,64,1538,1555,T1
3763,October 12,2013,Algeria,Burkina Faso,2,3,World Cup qualifier,in Burkina Faso,-17,17,1572,1564,-4,5,63,68,1589,1547,T1
3764,October 12,2013,Ivory Coast,Senegal,3,1,World Cup qualifier,in Ivory Coast,8,-8,1790,1556,1,-3,22,71,1782,1564,T1
3765,October 12,2013,Brazil,South Korea,2,0,Friendly,in South Korea,4,-4,2123,1673,1,0,1,45,2119,1677,T2
3766,October 13,2013,Nigeria,Ethiopia,2,1,World Cup qualifier,in Ethiopia,9,-9,1724,1390,4,-3,31,110,1715,1399,T2
3767,October 13,2013,Pakistan,Taiwan,1,0,Friendly tournament,in the Philippines,12,-12,949,843,2,-1,194,207,937,855,T1
3768,October 13,2013,Qatar,Yemen,6,0,Asian Cup qualifier,in Qatar,11,-11,1444,1188,2,-5,100,162,1433,1199,T1
3769,October 13,2013,Tunisia,Cameroon,0,0,World Cup qualifier,in Tunisia,-3,3,1528,1583,-1,1,79,61,1531,1580,draw
3770,October 15,2013,Australia,Canada,3,0,Friendly,in England,8,-8,1721,1495,4,-4,32,89,1713,1503,T1
3771,October 15,2013,Azerbaijan,Russia,1,1,World Cup qualifier,in Azerbaijan,14,-14,1454,1842,4,0,97,17,1440,1856,draw
3772,October 15,2013,Japan,Belarus,0,1,Friendly,in Belarus,-12,12,1743,1596,-2,2,27,57,1755,1584,T1
3773,October 15,2013,Belgium,Wales,1,1,World Cup qualifier,in Belgium,-17,17,1868,1586,-3,4,14,60,1885,1569,draw
3774,October 15,2013,Brazil,Zambia,2,0,Friendly,in China,1,-1,2124,1537,0,0,1,76,2123,1538,T1
3775,October 15,2013,Bulgaria,Czechia,0,1,World Cup qualifier,in Bulgaria,-22,22,1642,1758,-5,3,51,25,1664,1736,T2
3776,October 15,2013,Ecuador,Chile,1,2,World Cup qualifier,in Chile,-12,12,1836,1897,0,1,18,10,1848,1885,T1
3777,October 15,2013,Mexico,Costa Rica,1,2,World Cup qualifier,in Costa Rica,-18,18,1765,1743,-1,3,24,27,1783,1725,T1
3778,October 15,2013,Albania,Cyprus,0,0,World Cup qualifier,in Cyprus,-2,2,1516,1389,2,-1,80,112,1518,1387,draw
3779,October 15,2013,Malta,Denmark,0,6,World Cup qualifier,in Denmark,-3,3,1247,1742,-1,-2,145,29,1250,1739,T1
3780,October 15,2013,Poland,England,0,2,World Cup qualifier,in England,-5,5,1644,1965,2,0,49,6,1649,1960,T1
3781,October 15,2013,Faroe Islands,Austria,0,3,World Cup qualifier,in the Faroe Islands,-8,8,1189,1650,-2,5,160,48,1197,1642,T2
3782,October 15,2013,France,Finland,3,0,World Cup qualifier,in France,11,-11,1884,1673,2,-2,12,45,1873,1684,T1
3783,October 15,2013,Egypt,Ghana,1,6,World Cup qualifier,in Ghana,-30,30,1672,1720,-7,8,46,33,1702,1690,T1
3784,October 15,2013,Liechtenstein,Greece,0,2,World Cup qualifier,in Greece,-1,1,1190,1827,1,1,159,19,1191,1826,T1
3785,October 15,2013,Hong Kong,United Arab Emirates,0,4,Asian Cup qualifier,in Hong Kong,-10,10,1187,1640,-4,1,162,53,1197,1630,T2
3786,October 15,2013,Hungary,Andorra,2,0,World Cup qualifier,in Hungary,1,-1,1682,993,1,0,43,190,1681,994,T1
3787,October 15,2013,Indonesia,China,1,1,Asian Cup qualifier,in Indonesia,14,-14,1239,1598,4,1,147,56,1225,1612,draw
3788,October 15,2013,Iran,Thailand,2,1,Asian Cup qualifier,in Iran,3,-3,1701,1361,1,-1,39,120,1698,1364,T1
3789,October 15,2013,Kazakhstan,Ireland,1,3,World Cup qualifier,in Ireland,-4,4,1358,1709,-2,2,122,35,1362,1705,T1
3790,October 15,2013,Israel,Northern Ireland,1,1,World Cup qualifier,in Israel,-16,16,1641,1413,-3,-1,52,108,1657,1397,draw
3791,October 15,2013,Italy,Armenia,2,2,World Cup qualifier,in Italy,-17,17,1910,1581,-2,4,9,64,1927,1564,draw
3792,October 15,2013,Honduras,Jamaica,2,2,World Cup qualifier,in Jamaica,-3,3,1685,1545,1,0,41,74,1688,1542,draw
3793,October 15,2013,Oman,Jordan,0,0,Asian Cup qualifier,in Jordan,6,-6,1561,1561,5,-2,67,67,1555,1567,draw
3794,October 15,2013,Tajikistan,Kyrgyzstan,4,1,Friendly,in Kyrgyzstan,18,-18,1260,1137,2,-5,144,173,1242,1155,T2
3795,October 15,2013,Latvia,Slovakia,2,2,World Cup qualifier,in Latvia,2,-2,1459,1594,2,-1,94,59,1457,1596,draw
3796,October 15,2013,Kuwait,Lebanon,1,1,Asian Cup qualifier,in Lebanon,-5,5,1560,1381,-2,1,69,115,1565,1376,draw
3797,October 15,2013,Lithuania,Bosnia and Herzegovina,0,1,World Cup qualifier,in Lithuania,-9,9,1458,1790,-2,2,95,22,1467,1781,T2
3798,October 15,2013,Malaysia,Bahrain,1,1,Asian Cup qualifier,in Malaysia,9,-9,1186,1439,1,-3,163,102,1177,1448,draw
3799,October 15,2013,Montenegro,Moldova,2,5,World Cup qualifier,in Montenegro,-63,63,1595,1448,-10,12,58,100,1658,1385,T2
3800,October 15,2013,Iceland,Norway,1,1,World Cup qualifier,in Norway,11,-11,1540,1643,3,0,75,50,1529,1654,draw
3801,October 15,2013,United States,Panama,3,2,World Cup qualifier,in Panama,18,-18,1879,1701,2,-5,13,39,1861,1719,T2
3802,October 15,2013,Paraguay,Colombia,1,2,World Cup qualifier,in Paraguay,-16,16,1702,1912,-3,1,38,8,1718,1896,T2
3803,October 15,2013,Bolivia,Peru,1,1,World Cup qualifier,in Peru,11,-11,1627,1711,1,-1,55,34,1616,1722,draw
3804,October 15,2013,Philippines,Pakistan,3,1,Friendly tournament,in the Philippines,6,-6,1196,943,3,-1,158,195,1190,949,T1
3805,October 15,2013,Luxembourg,Portugal,0,3,World Cup qualifier,in Portugal,-1,1,1214,1896,0,-1,153,11,1215,1895,T1
3806,October 15,2013,Romania,Estonia,2,0,World Cup qualifier,in Romania,6,-6,1733,1452,-1,-3,30,98,1727,1458,T1
3807,October 15,2013,Ukraine,San Marino,8,0,World Cup qualifier,in San Marino,1,-1,1819,878,1,0,20,202,1818,879,T2
3808,October 15,2013,Saudi Arabia,Iraq,2,0,Asian Cup qualifier,in Jordan,36,-36,1502,1505,9,-9,85,84,1466,1541,T1
3809,October 15,2013,Scotland,Croatia,2,0,World Cup qualifier,in Scotland,38,-38,1685,1808,11,-2,41,21,1647,1846,T1
3810,October 15,2013,Serbia,Macedonia,5,1,World Cup qualifier,in Serbia,10,-10,1751,1514,0,-2,26,82,1741,1524,T1
3811,October 15,2013,Syria,Singapore,1,2,Asian Cup qualifier,in Singapore,-28,28,1472,1283,-6,4,93,139,1500,1255,T1
3812,October 15,2013,South Korea,Mali,3,1,Friendly,in South Korea,7,-7,1680,1559,1,-5,44,71,1673,1566,T1
3813,October 15,2013,Spain,Georgia,2,0,World Cup qualifier,in Spain,1,-1,2123,1498,0,1,2,88,2122,1499,T1
3814,October 15,2013,Germany,Sweden,5,3,World Cup qualifier,in Sweden,24,-24,2079,1861,0,-5,3,16,2055,1885,T2
3815,October 15,2013,Slovenia,Switzerland,0,1,World Cup qualifier,in Switzerland,-6,6,1657,1864,0,1,47,15,1663,1858,T1
3816,October 15,2013,Trinidad and Tobago,New Zealand,0,0,Friendly,in Trinidad and Tobago,0,0,1481,1583,0,-1,90,62,1481,1583,draw
3817,October 15,2013,Netherlands,Turkey,2,0,World Cup qualifier,in Turkey,16,-16,2016,1707,0,-4,5,36,2000,1723,T2
3818,October 15,2013,Argentina,Uruguay,2,3,World Cup qualifier,in Uruguay,-23,23,2020,1920,0,1,4,7,2043,1897,T1
3819,October 15,2013,Uzbekistan,Vietnam,3,1,Asian Cup qualifier,in Uzbekistan,3,-3,1631,1233,1,-1,54,149,1628,1236,T1
3820,October 28,2013,Jordan,Nigeria,1,0,Friendly,in Jordan,12,-12,1573,1712,2,-2,65,33,1561,1724,T1
3821,November 1,2013,Indonesia,Kyrgyzstan,4,0,Friendly,in Indonesia,9,-9,1248,1128,2,-1,145,174,1239,1137,T1
3822,November 6,2013,Jordan,Zambia,1,0,Friendly,in Qatar,9,-9,1582,1528,1,-1,64,77,1573,1537,T1
3823,November 8,2013,Malaysia,Kuwait,0,3,Friendly,in Kuwait,-2,2,1184,1562,0,1,163,68,1186,1560,T1
3824,November 9,2013,Bahrain,Lebanon,1,0,Friendly,in Bahrain,6,-6,1445,1375,1,-1,101,116,1439,1381,T1
3825,November 9,2013,United Arab Emirates,Philippines,4,0,Friendly,in the United Arab Emirates,2,-2,1642,1194,2,0,51,158,1640,1196,T1
3826,November 11,2013,Iraq,Syria,2,1,Friendly,in Jordan,9,-9,1514,1463,2,0,82,93,1505,1472,T1
3827,November 13,2013,Jordan,Uruguay,0,5,World Cup qualifier,in Jordan,-16,16,1566,1936,-2,0,66,7,1582,1920,T2
3828,November 13,2013,Mexico,New Zealand,5,1,World Cup qualifier,in Mexico,12,-12,1777,1571,0,-3,24,65,1765,1583,T1
3829,November 14,2013,Belgium,Colombia,0,2,Friendly,in Belgium,-17,17,1851,1929,-2,0,16,8,1868,1912,T2
3830,November 14,2013,Aruba,Curaçao,0,2,Friendly tournament,in Curaçao,-14,14,964,1024,-1,1,192,186,978,1010,T1
3831,November 14,2013,Egypt,Zambia,2,0,Friendly,in Egypt,6,-6,1678,1522,1,-2,45,79,1672,1528,T1
3832,November 14,2013,Suriname,Bonaire,2,0,Friendly tournament,in Curaçao,9,-9,1212,954,0,0,154,193,1203,963,T1
3833,November 15,2013,Belarus,Albania,0,0,Friendly,in Turkey,-2,2,1594,1518,-2,0,59,80,1596,1516,draw
3834,November 15,2013,Ecuador,Argentina,0,0,Friendly,in the United States,5,-5,1841,2015,-1,-1,19,5,1836,2020,draw
3835,November 15,2013,Malaysia,Bahrain,0,1,Asian Cup qualifier,in Bahrain,-4,4,1180,1449,0,1,163,100,1184,1445,T1
3836,November 15,2013,Indonesia,China,0,1,Asian Cup qualifier,in China,-3,3,1245,1601,-2,-1,147,57,1248,1598,T1
3837,November 15,2013,Czechia,Canada,2,0,Friendly,in Czechia,3,-3,1761,1492,0,-1,25,90,1758,1495,T1
3838,November 15,2013,Denmark,Norway,2,1,Friendly,in Denmark,5,-5,1747,1638,2,-3,27,53,1742,1643,T1
3839,November 15,2013,England,Chile,0,2,Friendly,in England,-22,22,1943,1919,0,1,6,9,1965,1897,T2
3840,November 15,2013,Azerbaijan,Estonia,1,2,Friendly,in Estonia,-7,7,1447,1459,-5,4,102,94,1454,1452,T1
3841,November 15,2013,Greece,Romania,3,1,World Cup qualifier,in Greece,15,-15,1842,1718,1,-2,18,32,1827,1733,T1
3842,November 15,2013,Iceland,Croatia,0,0,World Cup qualifier,in Iceland,9,-9,1549,1799,3,0,72,21,1540,1808,draw
3843,November 15,2013,India,Philippines,1,1,Friendly,in India,0,0,1077,1194,0,0,181,158,1077,1194,draw
3844,November 15,2013,Ireland,Latvia,3,0,Friendly,in Ireland,4,-4,1713,1455,1,-3,34,97,1709,1459,T1
3845,November 15,2013,Italy,Germany,1,1,Friendly,in Italy,2,-2,1912,2077,-1,0,10,3,1910,2079,draw
3846,November 15,2013,Trinidad and Tobago,Jamaica,1,0,Friendly,in Jamaica,14,-14,1495,1531,1,-2,89,76,1481,1545,T2
3847,November 15,2013,Lebanon,Kuwait,0,0,Asian Cup qualifier,in Kuwait,14,-14,1389,1548,4,-5,112,73,1375,1562,draw
3848,November 15,2013,Niger,Libya,1,1,Friendly,in Tunisia,6,-6,1291,1548,1,0,137,73,1285,1554,draw
3849,November 15,2013,Poland,Slovakia,0,2,Friendly,in Poland,-21,21,1623,1615,-6,3,55,56,1644,1594,T2
3850,November 15,2013,Sweden,Portugal,0,1,World Cup qualifier,in Portugal,-13,13,1848,1909,-1,0,16,11,1861,1896,T1
3851,November 15,2013,Yemen,Qatar,1,4,Asian Cup qualifier,in the United Arab Emirates,-13,13,1175,1457,-4,6,165,96,1188,1444,T1
3852,November 15,2013,Russia,Serbia,1,1,Friendly,in the United Arab Emirates,-3,3,1839,1754,-3,0,20,26,1842,1751,draw
3853,November 15,2013,Iraq,Saudi Arabia,1,2,Asian Cup qualifier,in Saudi Arabia,-15,15,1499,1517,-5,4,87,81,1514,1502,T1
3854,November 15,2013,Scotland,United States,0,0,Friendly,in Scotland,3,-3,1688,1876,-1,1,42,12,1685,1879,draw
3855,November 15,2013,Switzerland,South Korea,1,2,Friendly,in South Korea,-12,12,1852,1692,0,3,14,41,1864,1680,T1
3856,November 15,2013,South Africa,Swaziland,3,0,Friendly,in Swaziland,4,-4,1564,1081,3,-1,67,180,1560,1085,T2
3857,November 15,2013,Syria,Singapore,4,0,Asian Cup qualifier,in Iran,20,-20,1483,1263,2,-4,91,143,1463,1283,T1
3858,November 15,2013,Thailand,Iran,0,3,Asian Cup qualifier,in Thailand,-14,14,1347,1715,-4,6,124,33,1361,1701,T2
3859,November 15,2013,Northern Ireland,Turkey,0,1,Friendly,in Turkey,-2,2,1411,1709,0,-1,108,37,1413,1707,T1
3860,November 15,2013,Hong Kong,United Arab Emirates,0,4,Asian Cup qualifier,in the United Arab Emirates,-3,3,1184,1645,1,2,161,49,1187,1642,T1
3861,November 15,2013,Ukraine,France,2,0,World Cup qualifier,in Ukraine,27,-27,1846,1857,3,-1,17,13,1819,1884,T1
3862,November 15,2013,Uzbekistan,Vietnam,3,0,Asian Cup qualifier,in Vietnam,11,-11,1642,1222,4,-2,50,151,1631,1233,T2
3863,November 16,2013,Aruba,Bonaire,1,2,Friendly tournament,in Curaçao,-15,15,949,969,-1,2,193,191,964,954,T1
3864,November 16,2013,Honduras,Brazil,0,5,Friendly,in the United States,-3,3,1682,2127,0,0,43,1,1685,2124,T1
3865,November 16,2013,Curaçao,Suriname,1,3,Friendly tournament,in Curaçao,-17,17,1007,1229,-1,4,187,150,1024,1212,T2
3866,November 16,2013,Spain,Equatorial Guinea,2,1,Friendly,in Equatorial Guinea,0,0,2123,1304,0,0,2,135,2123,1304,T2
3867,November 16,2013,Senegal,Ivory Coast,1,1,World Cup qualifier,in Morocco,12,-12,1568,1778,5,-1,66,23,1556,1790,draw
3868,November 16,2013,Japan,Netherlands,2,2,Friendly,in Belgium,7,-7,1750,2009,1,-1,27,5,1743,2016,draw
3869,November 16,2013,Laos,Guam,1,1,Friendly,in Laos,-6,6,855,737,0,0,205,212,861,731,draw
3870,November 16,2013,Nigeria,Ethiopia,2,0,World Cup qualifier,in Nigeria,5,-5,1717,1385,2,-2,33,113,1712,1390,T1
3871,November 16,2013,Rwanda,Uganda,0,0,Friendly,in Uganda,7,-7,1329,1493,0,-3,128,89,1322,1500,draw
3872,November 16,2013,Finland,Wales,1,1,Friendly,in Wales,0,0,1673,1586,0,0,46,60,1673,1586,draw
3873,November 17,2013,Cameroon,Tunisia,4,1,World Cup qualifier,in Cameroon,20,-20,1603,1508,5,-7,57,84,1583,1528,T1
3874,November 17,2013,Montenegro,Luxembourg,4,1,Friendly,in Luxembourg,6,-6,1601,1208,0,0,58,154,1595,1214,T2
3875,November 18,2013,Bosnia and Herzegovina,Argentina,0,2,Friendly,in the United States,-6,6,1784,2021,0,0,22,4,1790,2015,T1
3876,November 18,2013,Nigeria,Italy,2,2,Friendly,in England,5,-5,1722,1907,3,-1,30,11,1717,1912,draw
3877,November 18,2013,Benin,Libya,0,1,Friendly,in Tunisia,-6,6,1388,1554,-2,1,112,72,1394,1548,T1
3878,November 18,2013,Moldova,Lithuania,1,1,Friendly,in Moldova,-3,3,1445,1461,-1,1,102,94,1448,1458,draw
3879,November 19,2013,Algeria,Burkina Faso,1,0,World Cup qualifier,in Algeria,14,-14,1586,1550,3,-5,61,73,1572,1564,T1
3880,November 19,2013,Costa Rica,Australia,0,1,Friendly,in Australia,-8,8,1735,1729,0,0,29,31,1743,1721,T1
3881,November 19,2013,United States,Austria,0,1,Friendly,in Austria,-13,13,1863,1663,-1,1,13,47,1876,1650,T1
3882,November 19,2013,Bahrain,Yemen,2,0,Asian Cup qualifier,in Bahrain,6,-6,1455,1169,3,0,97,165,1449,1175,T1
3883,November 19,2013,Japan,Belgium,3,2,Friendly,in Belgium,15,-15,1765,1836,2,-3,25,18,1750,1851,T2
3884,November 19,2013,Chile,Brazil,1,2,Friendly,in Canada,-5,5,1914,2132,-1,0,10,1,1919,2127,T1
3885,November 19,2013,China,Saudi Arabia,0,0,Asian Cup qualifier,in China,-10,10,1591,1527,-1,4,59,76,1601,1517,draw
3886,November 19,2013,Croatia,Iceland,2,0,World Cup qualifier,in Croatia,7,-7,1806,1542,0,-1,21,74,1799,1549,T1
3887,November 19,2013,Honduras,Ecuador,2,2,Friendly,in the United States,4,-4,1686,1837,0,2,43,17,1682,1841,draw
3888,November 19,2013,Ghana,Egypt,1,2,World Cup qualifier,in Egypt,-17,17,1703,1695,-6,3,38,42,1720,1678,T1
3889,November 19,2013,Germany,England,1,0,Friendly,in England,9,-9,2086,1934,0,-1,3,7,2077,1943,T2
3890,November 19,2013,Ukraine,France,0,3,World Cup qualifier,in France,-24,24,1822,1881,-3,1,20,12,1846,1857,T1
3891,November 19,2013,Gibraltar,Slovakia,0,0,Friendly,in Portugal,9,-9,1152,1606,3,0,168,56,1143,1615,draw
3892,November 19,2013,Hong Kong,Uzbekistan,0,2,Asian Cup qualifier,in Hong Kong,-7,7,1177,1649,-1,1,162,49,1184,1642,T2
3893,November 19,2013,Nepal,India,0,2,Friendly,in India,-5,5,903,1082,0,2,200,179,908,1077,T1
3894,November 19,2013,Iraq,Indonesia,2,0,Asian Cup qualifier,in Indonesia,18,-18,1517,1227,5,-3,81,150,1499,1245,T2
3895,November 19,2013,Thailand,Kuwait,1,3,Asian Cup qualifier,in Kuwait,-9,9,1338,1557,-1,3,125,71,1347,1548,T1
3896,November 19,2013,Kyrgyzstan,Azerbaijan,0,0,Friendly,in Kyrgyzstan,6,-6,1134,1441,0,-1,174,102,1128,1447,draw
3897,November 19,2013,Lebanon,Iran,1,4,Asian Cup qualifier,in Lebanon,-15,15,1374,1730,-6,4,116,30,1389,1715,T2
3898,November 19,2013,Liechtenstein,Estonia,0,3,Friendly,in Liechtenstein,-10,10,1180,1469,-2,2,161,93,1190,1459,T2
3899,November 19,2013,Qatar,Malaysia,1,0,Asian Cup qualifier,in Malaysia,11,-11,1468,1169,2,-2,94,165,1457,1180,T2
3900,November 19,2013,Malta,Faroe Islands,3,2,Friendly,in Malta,6,-6,1253,1183,0,1,145,159,1247,1189,T1
3901,November 19,2013,Namibia,Mozambique,0,0,Friendly,in Namibia,-1,1,1291,1367,0,0,136,117,1292,1366,draw
3902,November 19,2013,Colombia,Netherlands,0,0,Friendly,in the Netherlands,5,-5,1934,2004,1,0,7,5,1929,2009,draw
3903,November 19,2013,Scotland,Norway,1,0,Friendly,in Norway,11,-11,1699,1627,1,0,41,53,1688,1638,T2
3904,November 19,2013,Oman,Syria,1,0,Asian Cup qualifier,in Iran,16,-16,1577,1467,4,-4,66,95,1561,1483,T1
3905,November 19,2013,Poland,Ireland,0,0,Friendly,in Poland,0,0,1623,1713,0,1,55,34,1623,1713,draw
3906,November 19,2013,Greece,Romania,1,1,World Cup qualifier,in Romania,-1,1,1841,1719,2,0,16,33,1842,1718,draw
3907,November 19,2013,South Korea,Russia,1,2,Friendly,in the United Arab Emirates,-6,6,1686,1845,-2,5,43,15,1692,1839,T1
3908,November 19,2013,Slovenia,Canada,1,0,Friendly,in Slovenia,4,-4,1661,1488,-1,0,48,90,1657,1492,T1
3909,November 19,2013,South Africa,Spain,1,0,Friendly,in South Africa,19,-19,1583,2104,4,0,64,2,1564,2123,T1
3910,November 19,2013,Portugal,Sweden,3,2,World Cup qualifier,in Sweden,22,-22,1931,1826,1,-3,9,19,1909,1848,T2
3911,November 19,2013,Tanzania,Zimbabwe,0,0,Friendly,in Tanzania,-3,3,1357,1360,-3,3,123,120,1360,1357,draw
3912,November 19,2013,Trinidad and Tobago,Jamaica,2,0,Friendly,in Trinidad and Tobago,12,-12,1507,1519,2,-3,86,79,1495,1531,T1
3913,November 19,2013,Belarus,Turkey,1,2,Friendly,in Turkey,-4,4,1590,1713,0,3,60,34,1594,1709,T1
3914,November 19,2013,Vietnam,United Arab Emirates,0,5,Asian Cup qualifier,in the United Arab Emirates,-4,4,1218,1649,-1,0,153,49,1222,1645,T1
3915,November 20,2013,Mexico,New Zealand,4,2,World Cup qualifier,in New Zealand,21,-21,1798,1550,2,-5,22,72,1777,1571,T2
3916,November 20,2013,Jordan,Uruguay,0,0,World Cup qualifier,in Uruguay,17,-17,1583,1919,5,-3,64,9,1566,1936,draw
3917,November 27,2013,Ethiopia,Kenya,0,0,CECAFA Cup,in Kenya,5,-5,1390,1378,2,-1,110,115,1385,1383,draw
3918,November 27,2013,Maldives,Seychelles,1,3,Friendly,in the Seychelles,-16,16,1084,983,-1,1,178,191,1100,967,T1
3919,November 27,2013,Zanzibar,South Sudan,2,1,CECAFA Cup,in Kenya,9,-9,1316,1073,4,-2,129,181,1307,1082,T1
3920,November 28,2013,Somalia,Burundi,0,2,CECAFA Cup,in Kenya,-4,4,872,1320,0,0,203,129,876,1316,T1
3921,November 28,2013,Tanzania,Zambia,1,1,CECAFA Cup,in Kenya,9,-9,1366,1513,5,-5,118,83,1357,1522,draw
3922,November 29,2013,Seychelles,Maldives,2,1,Friendly,in the Seychelles,10,-10,993,1074,1,-2,190,180,983,1084,T1
3923,November 29,2013,Sudan,Eritrea,3,0,CECAFA Cup,in Kenya,20,-20,1331,1126,4,-3,128,174,1311,1146,T1
3924,November 29,2013,Uganda,Rwanda,1,0,CECAFA Cup,in Kenya,11,-11,1504,1318,2,-2,87,130,1493,1329,T1
3925,November 30,2013,Dominica,Saint Lucia,0,1,Friendly,in Dominica,-12,12,1006,1063,-2,2,188,183,1018,1051,T2
3926,November 30,2013,Ethiopia,Zanzibar,3,1,CECAFA Cup,in Kenya,24,-24,1414,1292,2,-4,108,135,1390,1316,T1
3927,November 30,2013,Kenya,South Sudan,3,1,CECAFA Cup,in Kenya,5,-5,1383,1068,1,0,114,181,1378,1073,T1
3928,December 1,2013,Dominica,Saint Lucia,1,0,Friendly,in Dominica,9,-9,1015,1054,2,0,186,183,1006,1063,T1
3929,December 1,2013,Somalia,Tanzania,0,1,CECAFA Cup,in Kenya,-2,2,870,1368,0,1,203,117,872,1366,T1
3930,December 1,2013,Zambia,Burundi,1,0,CECAFA Cup,in Kenya,10,-10,1523,1310,5,-3,78,132,1513,1320,T1
3931,December 2,2013,Sudan,Rwanda,1,0,CECAFA Cup,in Kenya,19,-19,1350,1299,4,-5,124,134,1331,1318,T1
3932,December 2,2013,Eritrea,Uganda,0,3,CECAFA Cup,in Kenya,-7,7,1119,1511,0,3,174,84,1126,1504,T1
3933,December 3,2013,Ethiopia,South Sudan,2,0,CECAFA Cup,in Kenya,7,-7,1421,1061,2,-1,106,182,1414,1068,T1
3934,December 3,2013,Kenya,Zanzibar,2,0,CECAFA Cup,in Kenya,15,-15,1398,1277,4,-4,110,139,1383,1292,T1
3935,December 4,2013,Tanzania,Burundi,1,0,CECAFA Cup,in Kenya,17,-17,1385,1293,3,-3,114,134,1368,1310,T1
3936,December 4,2013,Zambia,Somalia,4,0,CECAFA Cup,in Kenya,2,-2,1525,868,1,-1,77,204,1523,870,T1
3937,December 5,2013,Rwanda,Eritrea,1,0,CECAFA Cup,in Kenya,10,-10,1309,1109,2,-1,131,175,1299,1119,T1
3938,December 5,2013,Sudan,Uganda,0,1,CECAFA Cup,in Kenya,-11,11,1339,1522,-1,5,125,79,1350,1511,T1
3939,December 7,2013,Kenya,Rwanda,1,0,CECAFA Cup,in Kenya,10,-10,1408,1299,0,-2,110,133,1398,1309,T1
3940,December 7,2013,Tanzania,Uganda,2,2,CECAFA Cup,in Kenya,8,-8,1393,1514,2,-4,112,83,1385,1522,draw
3941,December 8,2013,Burundi,Zambia,0,0,CECAFA Cup,in Kenya,12,-12,1305,1513,3,-7,131,84,1293,1525,draw
3942,December 8,2013,Ethiopia,Sudan,0,2,CECAFA Cup,in Kenya,-37,37,1384,1376,-9,8,115,117,1421,1339,T1
3943,December 10,2013,Tanzania,Kenya,0,1,CECAFA Cup,in Kenya,-14,14,1379,1422,-5,3,116,106,1393,1408,T1
3944,December 10,2013,Zambia,Sudan,1,2,CECAFA Cup,in Kenya,-28,28,1485,1404,-6,7,90,110,1513,1376,T1
3945,December 12,2013,Sudan,Kenya,0,2,CECAFA Cup,in Kenya,-20,20,1384,1442,-5,4,115,102,1404,1422,T1
3946,December 12,2013,Zambia,Tanzania,1,1,CECAFA Cup,in Kenya,-6,6,1479,1385,-1,3,91,113,1485,1379,draw
3947,December 21,2013,Bahrain,Qatar,1,1,Friendly,in Qatar,3,-3,1458,1465,0,-1,97,95,1455,1468,draw
3948,December 25,2013,Qatar,Palestine,1,0,West Asian Championship,in Qatar,7,-7,1472,1279,2,-1,93,138,1465,1286,T1
3949,January 4,2014,Jordan,Bahrain,1,0,West Asian Championship,in Qatar,14,-14,1586,1444,6,-4,61,101,1572,1458,T1
3950,January 7,2014,Qatar,Jordan,2,0,West Asian Championship,in Qatar,31,-31,1503,1555,6,-9,87,70,1472,1586,T1
3951,January 15,2014,Moldova,Norway,1,2,Friendly,in the United Arab Emirates,-5,5,1440,1632,-3,0,103,53,1445,1627,T1
3952,January 17,2014,Moldova,Sweden,1,2,Friendly,in the United Arab Emirates,-2,2,1438,1828,-1,0,104,19,1440,1826,T1
3953,January 18,2014,Norway,Poland,0,3,Friendly,in the United Arab Emirates,-18,18,1614,1641,-2,3,55,52,1632,1623,T1
3954,January 20,2014,Poland,Moldova,1,0,Friendly,in the United Arab Emirates,5,-5,1646,1433,1,0,51,104,1641,1438,T1
3955,January 21,2014,Iceland,Sweden,0,2,Friendly,in the United Arab Emirates,-5,5,1537,1833,0,0,74,19,1542,1828,T1
3956,January 22,2014,Costa Rica,Chile,0,4,Friendly,in Chile,-6,6,1729,1920,-1,1,30,9,1735,1914,T1
3957,January 24,2014,Finland,Oman,0,0,Friendly,in Oman,0,0,1673,1577,0,0,46,66,1673,1577,draw
3958,January 25,2014,South Korea,Costa Rica,1,0,Friendly,in the United States,11,-11,1697,1718,1,-3,42,33,1686,1729,T1
3959,January 29,2014,South Korea,Mexico,0,4,Friendly,in the United States,-13,13,1684,1811,-2,1,44,21,1697,1798,T1
3960,January 31,2014,Jordan,Oman,0,0,Asian Cup qualifier,in Oman,7,-7,1562,1570,2,0,68,66,1555,1577,draw
3961,February 1,2014,South Korea,United States,0,2,Friendly,in the United States,-5,5,1679,1868,-1,0,45,13,1684,1863,T1
3962,February 4,2014,Singapore,Jordan,1,3,Asian Cup qualifier,in Singapore,-14,14,1249,1576,-2,2,145,66,1263,1562,T2
3963,February 7,2014,Saint Vincent and the Grenadines,Dominica,3,2,Friendly,in Saint Vincent and the Grenadines,4,-4,1146,1011,0,0,171,186,1142,1015,T1
3964,February 9,2014,Dominica,Saint Vincent and the Grenadines,0,0,Friendly,in Saint Vincent and the Grenadines,6,-6,1017,1140,0,0,186,171,1011,1146,draw
3965,February 19,2014,Lebanon,Pakistan,3,1,Friendly,in Lebanon,1,-1,1386,942,0,-1,113,196,1385,943,T1
3966,February 21,2014,Iraq,North Korea,2,0,Friendly,in the United Arab Emirates,18,-18,1535,1566,5,-5,75,68,1517,1584,T1
3967,March 1,2014,Gibraltar,Faroe Islands,1,4,Friendly,in Gibraltar,-21,21,1131,1204,-5,4,173,155,1152,1183,T2
3968,March 1,2014,Philippines,Malaysia,0,0,Friendly,in Malaysia,2,-2,1196,1167,-1,-1,159,166,1194,1169,draw
3969,March 2,2014,Barbados,Jamaica,0,2,Friendly,in Barbados,-5,5,1130,1524,-2,1,173,78,1135,1519,T2
3970,March 3,2014,Kuwait,Iran,2,3,Asian Cup qualifier,in Iran,-7,7,1550,1737,-1,0,71,29,1557,1730,T1
3971,March 5,2014,Malta,Albania,0,2,Friendly,in Albania,-3,3,1250,1521,0,-1,144,81,1253,1518,T1
3972,March 5,2014,Algeria,Slovenia,2,0,Friendly,in Algeria,14,-14,1600,1647,3,-2,58,50,1586,1661,T1
3973,March 5,2014,Andorra,Moldova,0,3,Friendly,in Andorra,-4,4,989,1437,-1,0,191,104,993,1433,T2
3974,March 5,2014,Austria,Uruguay,1,1,Friendly,in Austria,4,-4,1667,1915,0,0,47,10,1663,1919,draw
3975,March 5,2014,Azerbaijan,Philippines,1,0,Friendly,in the United Arab Emirates,4,-4,1445,1192,1,0,101,159,1441,1196,T1
3976,March 5,2014,Ivory Coast,Belgium,2,2,Friendly,in Belgium,4,-4,1782,1832,1,0,23,18,1778,1836,draw
3977,March 5,2014,Botswana,South Sudan,3,0,Friendly,in Botswana,4,-4,1309,1057,1,0,130,182,1305,1061,T1
3978,March 5,2014,Belarus,Bulgaria,1,2,Friendly,in Bulgaria,-6,6,1584,1648,-2,3,62,49,1590,1642,T1
3979,March 5,2014,Burkina Faso,Comoros,1,1,Friendly,in France,-10,10,1540,879,-3,1,74,202,1550,869,draw
3980,March 5,2014,Burundi,Rwanda,1,1,Friendly,in Burundi,-3,3,1302,1302,-1,2,132,132,1305,1299,draw
3981,March 5,2014,Colombia,Tunisia,1,1,Friendly,in Spain,-8,8,1926,1516,-2,2,8,83,1934,1508,draw
3982,March 5,2014,Paraguay,Costa Rica,1,2,Friendly,in Costa Rica,-7,7,1695,1725,-3,4,42,29,1702,1718,T1
3983,March 5,2014,Cyprus,Northern Ireland,0,0,Friendly,in Cyprus,-2,2,1387,1413,-2,-1,113,110,1389,1411,draw
3984,March 5,2014,Czechia,Norway,2,2,Friendly,in Czechia,-6,6,1755,1620,-1,0,27,55,1761,1614,draw
3985,March 5,2014,Ecuador,Australia,4,3,Friendly,in England,7,-7,1844,1722,1,-3,16,33,1837,1729,T1
3986,March 5,2014,Bosnia and Herzegovina,Egypt,0,2,Friendly,in Austria,-19,19,1765,1714,-3,7,26,35,1784,1695,T1
3987,March 5,2014,England,Denmark,1,0,Friendly,in England,3,-3,1937,1744,0,0,6,28,1934,1747,T1
3988,March 5,2014,Netherlands,France,0,2,Friendly,in France,-16,16,1988,1897,0,0,5,12,2004,1881,T1
3989,March 5,2014,Liechtenstein,Georgia,0,2,Friendly,in Georgia,-2,2,1178,1500,-1,1,162,88,1180,1498,T1
3990,March 5,2014,Chile,Germany,0,1,Friendly,in Germany,-4,4,1916,2090,0,0,9,3,1920,2086,T1
3991,March 5,2014,Gibraltar,Estonia,0,2,Friendly,in Gibraltar,-6,6,1125,1475,-1,0,173,94,1131,1469,T2
3992,March 5,2014,Greece,South Korea,0,2,Friendly,in Greece,-25,25,1816,1704,-4,7,20,38,1841,1679,T2
3993,March 5,2014,Honduras,Venezuela,2,1,Friendly,in Honduras,8,-8,1694,1697,0,-4,43,41,1686,1705,T1
3994,March 5,2014,Hungary,Finland,1,2,Friendly,in Hungary,-13,13,1669,1686,-2,1,46,45,1682,1673,T2
3995,March 5,2014,India,Bangladesh,2,2,Friendly,in India,-6,6,1076,949,-1,2,179,193,1082,943,draw
3996,March 5,2014,Guinea,Iran,2,1,Friendly,in Iran,17,-17,1532,1720,6,-5,75,34,1515,1737,T2
3997,March 5,2014,China,Iraq,1,3,Asian Cup qualifier,in the United Arab Emirates,-35,35,1556,1570,-11,9,70,66,1591,1535,T1
3998,March 5,2014,Serbia,Ireland,2,1,Friendly,in Ireland,12,-12,1766,1701,2,-5,25,39,1754,1713,T2
3999,March 5,2014,Israel,Slovakia,1,3,Friendly,in Israel,-21,21,1620,1627,-2,3,55,53,1641,1606,T2
4000,March 5,2014,New Zealand,Japan,2,4,Friendly,in Japan,-4,4,1546,1769,-2,1,73,24,1550,1765,T1
4001,March 5,2014,Syria,Jordan,1,2,Asian Cup qualifier,in Jordan,-9,9,1458,1585,0,4,95,61,1467,1576,T1
4002,March 5,2014,Lithuania,Kazakhstan,1,1,Friendly,in Turkey,-3,3,1458,1361,1,0,95,123,1461,1358,draw
4003,March 5,2014,Haiti,Kosovo,0,0,Friendly,in Kosovo,1,-1,1433,1378,0,-1,105,119,1432,1379,draw
4004,March 5,2014,Luxembourg,Cape Verde,0,0,Friendly,in Luxembourg,5,-5,1213,1505,0,-3,154,87,1208,1510,draw
4005,March 5,2014,Latvia,Macedonia,1,2,Friendly,in Macedonia,-6,6,1449,1520,-3,0,100,82,1455,1514,T1
4006,March 5,2014,Malawi,Zimbabwe,1,4,Friendly,in Malawi,-21,21,1315,1381,0,4,127,118,1336,1360,T2
4007,March 5,2014,Malaysia,Yemen,2,1,Asian Cup qualifier,in the United Arab Emirates,20,-20,1187,1149,6,-4,160,169,1167,1169,T1
4008,March 5,2014,Senegal,Mali,1,1,Friendly,in France,0,0,1568,1559,0,0,67,69,1568,1559,draw
4009,March 5,2014,Niger,Mauritania,1,1,Friendly,in Mauritania,0,0,1291,1182,0,-1,135,161,1291,1182,draw
4010,March 5,2014,Nigeria,Mexico,0,0,Friendly,in the United States,3,-3,1725,1808,2,-1,29,22,1722,1811,draw
4011,March 5,2014,Montenegro,Ghana,1,0,Friendly,in Montenegro,10,-10,1611,1693,1,-6,57,44,1601,1703,T1
4012,March 5,2014,Morocco,Gabon,1,1,Friendly,in Morocco,-4,4,1528,1506,-1,3,77,85,1532,1502,draw
4013,March 5,2014,Angola,Mozambique,1,1,Friendly,in Mozambique,1,-1,1440,1366,0,-1,103,120,1439,1367,draw
4014,March 5,2014,Tanzania,Namibia,1,1,Friendly,in Namibia,0,0,1385,1291,0,0,114,135,1385,1291,draw
4015,March 5,2014,Singapore,Oman,1,3,Asian Cup qualifier,in Oman,-5,5,1244,1575,-1,1,146,65,1249,1570,T1
4016,March 5,2014,Poland,Scotland,0,1,Friendly,in Poland,-11,11,1635,1710,-1,4,52,37,1646,1699,T2
4017,March 5,2014,Portugal,Cameroon,5,1,Friendly,in Portugal,3,-3,1934,1600,1,-1,7,58,1931,1603,T1
4018,March 5,2014,Qatar,Bahrain,0,0,Asian Cup qualifier,in Qatar,-9,9,1494,1453,-2,2,89,98,1503,1444,draw
4019,March 5,2014,Romania,Argentina,0,0,Friendly,in Romania,5,-5,1724,2016,1,0,31,4,1719,2021,draw
4020,March 5,2014,Russia,Armenia,2,0,Friendly,in Russia,3,-3,1848,1578,1,0,14,64,1845,1581,T1
4021,March 5,2014,Indonesia,Saudi Arabia,0,1,Asian Cup qualifier,in Saudi Arabia,-4,4,1223,1531,-2,1,152,76,1227,1527,T1
4022,March 5,2014,Brazil,South Africa,5,0,Friendly,in South Africa,3,-3,2135,1580,0,0,1,63,2132,1583,T2
4023,March 5,2014,Italy,Spain,0,1,Friendly,in Spain,-3,3,1904,2107,0,0,11,2,1907,2104,T1
4024,March 5,2014,Saint Lucia,Jamaica,0,5,Friendly,in Saint Lucia,-4,4,1050,1528,-2,1,185,77,1054,1524,T2
4025,March 5,2014,Switzerland,Croatia,2,2,Friendly,in Switzerland,-4,4,1848,1810,0,1,14,21,1852,1806,draw
4026,March 5,2014,Lebanon,Thailand,5,2,Asian Cup qualifier,in Thailand,40,-40,1426,1298,7,-8,106,134,1386,1338,T2
4027,March 5,2014,Sweden,Turkey,1,2,Friendly,in Turkey,-11,11,1822,1724,0,3,19,31,1833,1713,T1
4028,March 5,2014,Ukraine,United States,2,0,Friendly,in Cyprus,17,-17,1839,1851,3,0,17,13,1822,1868,T1
4029,March 5,2014,United Arab Emirates,Uzbekistan,1,1,Asian Cup qualifier,in Uzbekistan,6,-6,1655,1643,1,-2,48,51,1649,1649,draw
4030,March 5,2014,Vietnam,Hong Kong,3,1,Asian Cup qualifier,in Vietnam,18,-18,1236,1159,5,-4,148,166,1218,1177,T1
4031,March 5,2014,Wales,Iceland,3,1,Friendly,in Wales,9,-9,1595,1528,1,-3,60,77,1586,1537,T1
4032,March 5,2014,Zambia,Uganda,2,1,Friendly,in Zambia,8,-8,1487,1506,1,-3,91,85,1479,1514,T1
4033,March 7,2014,Swaziland,Lesotho,1,0,Friendly,in Lesotho,16,-16,1097,1222,1,-5,177,152,1081,1238,T2
4034,March 9,2014,Lesotho,Swaziland,0,0,Friendly,in Lesotho,-6,6,1216,1103,-1,0,153,177,1222,1097,draw
4035,March 19,2014,Saint Lucia,Martinique,0,0,Friendly,in Saint Lucia,6,-6,1056,1413,2,-1,183,109,1050,1419,draw
4036,March 25,2014,Nepal,Yemen,0,2,Friendly,in Qatar,-6,6,897,1155,-1,2,201,167,903,1149,T1
4037,March 26,2014,Andorra,Indonesia,0,1,Friendly,in Spain,-4,4,985,1227,0,1,191,150,989,1223,T1
4038,March 27,2014,Guam,Aruba,2,2,Friendly,in Aruba,7,-7,744,942,0,-2,212,195,737,949,draw
4039,March 29,2014,Cuba,Indonesia,1,0,Friendly,in Spain,5,-5,1422,1222,0,-1,108,151,1417,1227,T1
4040,March 30,2014,Aruba,Guam,2,0,Friendly,in Aruba,5,-5,947,739,1,0,194,212,942,744,T1
4041,April 2,2014,United States,Mexico,2,2,Friendly,in the United States,-4,4,1847,1812,-2,1,15,21,1851,1808,draw
4042,April 11,2014,Nepal,Philippines,0,3,Friendly,in Qatar,-5,5,892,1197,0,0,201,159,897,1192,T1
4043,April 12,2014,Mauritius,Mauritania,0,1,African Nations Cup qualifier,in Mauritania,-8,8,1046,1190,-1,1,185,160,1054,1182,T1
4044,April 13,2014,Kyrgyzstan,Afghanistan,0,0,Friendly,in the United Arab Emirates,-2,2,1132,1055,0,0,171,184,1134,1053,draw
4045,April 15,2014,Chad,Yemen,0,0,Friendly,in Qatar,-2,2,1231,1157,0,0,148,167,1233,1155,draw
4046,April 17,2014,Guadeloupe,French Guiana,3,2,Friendly tournament,in Guadeloupe,6,-6,1391,1241,2,-1,112,146,1385,1247,T1
4047,April 19,2014,Guadeloupe,Martinique,0,1,Friendly tournament,in Guadeloupe,-18,18,1373,1431,-7,3,119,106,1391,1413,T2
4048,April 20,2014,Mauritania,Mauritius,2,0,African Nations Cup qualifier,in Mauritius,26,-26,1216,1020,7,0,153,185,1190,1046,T2
4049,April 26,2014,Burundi,Tanzania,3,0,Friendly,in Tanzania,26,-26,1328,1359,5,-9,127,123,1302,1385,T2
4050,April 27,2014,Philippines,Malaysia,0,0,Friendly,in the Philippines,-3,3,1194,1190,0,0,160,161,1197,1187,draw
4051,April 30,2014,Saint Lucia,Dominica,2,0,Windward Islands Championship,in Dominica,26,-26,1082,991,4,-4,179,190,1056,1017,T2
4052,April 30,2014,Grenada,Saint Vincent and the Grenadines,0,0,Windward Islands Championship,in Dominica,-2,2,1196,1142,0,0,159,170,1198,1140,draw
4053,May 2,2014,Saint Vincent and the Grenadines,Dominica,3,2,Windward Islands Championship,in Dominica,13,-13,1155,978,2,-1,168,191,1142,991,T2
4054,May 2,2014,Saint Lucia,Grenada,1,0,Windward Islands Championship,in Dominica,20,-20,1102,1176,1,-3,178,162,1082,1196,T1
4055,May 4,2014,Grenada,Dominica,5,3,Windward Islands Championship,in Dominica,16,-16,1192,962,2,-1,160,192,1176,978,T2
4056,May 4,2014,Saint Vincent and the Grenadines,Saint Lucia,0,0,Windward Islands Championship,in Dominica,-2,2,1153,1104,0,2,168,176,1155,1102,draw
4057,May 4,2014,Tajikistan,Afghanistan,1,0,Friendly,in Tajikistan,3,-3,1263,1052,0,0,143,184,1260,1055,T1
4058,May 4,2014,Malawi,Tanzania,0,0,Friendly,in Tanzania,4,-4,1319,1355,0,-1,128,124,1315,1359,draw
4059,May 10,2014,Monaco,Vatican,2,0,Friendly,in Italy,7,-7,909,686,0,0,200,217,902,693,T1
4060,May 11,2014,Botswana,Swaziland,1,4,Friendly,in Botswana,-30,30,1279,1133,-6,7,137,171,1309,1103,T2
4061,May 12,2014,Afghanistan,Kyrgyzstan,1,0,Friendly,in Kuwait,12,-12,1064,1120,1,-2,183,174,1052,1132,T1
4062,May 13,2014,Poland,Germany,0,0,Friendly,in Germany,9,-9,1644,2081,1,0,51,3,1635,2090,draw
4063,May 13,2014,Laos,Maldives,1,7,Friendly,in the Maldives,-6,6,849,1080,0,1,205,180,855,1074,T1
4064,May 14,2014,Kuwait,Afghanistan,3,2,Friendly,in Kuwait,1,-1,1551,1063,0,0,72,183,1550,1064,T1
4065,May 16,2014,Kyrgyzstan,Kuwait,2,2,Friendly,in Kuwait,9,-9,1129,1542,1,-1,173,73,1120,1551,draw
4066,May 17,2014,Malawi,Chad,2,0,African Nations Cup qualifier,in Malawi,15,-15,1334,1216,2,-5,126,153,1319,1231,T1
4067,May 17,2014,Mauritania,Equatorial Guinea,1,0,African Nations Cup qualifier,in Mauritania,19,-19,1235,1285,5,-4,148,135,1216,1304,T1
4068,May 17,2014,Namibia,Congo,1,0,African Nations Cup qualifier,in Namibia,20,-20,1311,1375,4,-6,130,117,1291,1395,T1
4069,May 17,2014,Ecuador,Netherlands,1,1,Friendly,in the Netherlands,6,-6,1850,1982,3,0,13,5,1844,1988,draw
4070,May 17,2014,São Tomé and Príncipe,Benin,0,2,African Nations Cup qualifier,in São Tomé and Príncipe,-15,15,1089,1403,-1,1,178,111,1104,1388,T2
4071,May 18,2014,Belarus,Iran,0,0,Friendly,in Austria,4,-4,1588,1716,1,0,61,34,1584,1720,draw
4072,May 18,2014,Botswana,Burundi,0,0,African Nations Cup qualifier,in Burundi,8,-8,1287,1320,2,-1,135,129,1279,1328,draw
4073,May 18,2014,Guinea-Bissau,Central African Republic,0,0,African Nations Cup qualifier,in Congo,3,-3,1225,1267,0,-1,151,141,1222,1270,draw
4074,May 18,2014,Kenya,Comoros,1,0,African Nations Cup qualifier,in Kenya,1,-1,1443,878,0,0,102,202,1442,879,T1
4075,May 18,2014,Lesotho,Liberia,0,1,African Nations Cup qualifier,in Liberia,-10,10,1206,1324,-2,1,155,128,1216,1314,T1
4076,May 18,2014,Libya,Rwanda,0,0,African Nations Cup qualifier,in Tunisia,-12,12,1542,1314,-1,2,72,130,1554,1302,draw
4077,May 18,2014,Madagascar,Uganda,2,1,African Nations Cup qualifier,in Madagascar,32,-32,1196,1474,6,-9,159,94,1164,1506,T1
4078,May 18,2014,South Sudan,Mozambique,0,5,African Nations Cup qualifier,in Mozambique,-7,7,1050,1373,0,2,184,117,1057,1366,T1
4079,May 18,2014,Sierra Leone,Swaziland,1,1,African Nations Cup qualifier,in Swaziland,-7,7,1358,1140,-3,0,123,171,1365,1133,draw
4080,May 18,2014,Tanzania,Zimbabwe,1,0,African Nations Cup qualifier,in Tanzania,16,-16,1371,1365,5,-5,119,120,1355,1381,T1
4081,May 19,2014,Maldives,Myanmar,2,3,Asian Cup qual &amp; Asian Challenge Cup,in the Maldives,-29,29,1051,1036,-3,1,183,185,1080,1007,T2
4082,May 19,2014,Kyrgyzstan,Palestine,0,1,Asian Cup qual &amp; Asian Challenge Cup,in the Maldives,-12,12,1117,1291,-1,4,174,134,1129,1279,T1
4083,May 20,2014,Afghanistan,Philippines,0,0,Asian Cup qual &amp; Asian Challenge Cup,in the Maldives,7,-7,1070,1187,1,-2,181,162,1063,1194,draw
4084,May 20,2014,Suriname,French Guiana,0,0,Friendly,in French Guiana,3,-3,1232,1238,0,0,149,146,1229,1241,draw
4085,May 20,2014,Laos,Turkmenistan,1,5,Asian Cup qual &amp; Asian Challenge Cup,in the Maldives,-4,4,845,1351,-1,0,206,125,849,1347,T1
4086,May 21,2014,Senegal,Burkina Faso,1,1,Friendly,in Burkina Faso,2,-2,1570,1538,1,0,66,74,1568,1540,draw
4087,May 21,2014,Finland,Czechia,2,2,Friendly,in Finland,-1,1,1685,1756,0,0,45,27,1686,1755,draw
4088,May 21,2014,Kosovo,Turkey,1,6,Friendly,in Kosovo,-8,8,1370,1732,-4,2,119,29,1378,1724,T2
4089,May 21,2014,Belarus,Liechtenstein,5,1,Friendly,in Liechtenstein,5,-5,1593,1173,0,-2,61,165,1588,1178,T2
4090,May 21,2014,Maldives,Kyrgyzstan,2,0,Asian Cup qual &amp; Asian Challenge Cup,in the Maldives,27,-27,1078,1090,3,-3,180,177,1051,1117,T1
4091,May 21,2014,Palestine,Myanmar,2,0,Asian Cup qual &amp; Asian Challenge Cup,in the Maldives,11,-11,1302,1025,1,0,133,185,1291,1036,T1
4092,May 22,2014,Afghanistan,Turkmenistan,3,1,Asian Cup qual &amp; Asian Challenge Cup,in the Maldives,50,-50,1120,1301,8,-8,174,133,1070,1351,T1
4093,May 22,2014,Hungary,Denmark,2,2,Friendly,in Hungary,-1,1,1668,1745,0,0,46,28,1669,1744,draw
4094,May 22,2014,Laos,Philippines,0,2,Asian Cup qual &amp; Asian Challenge Cup,in the Maldives,-7,7,838,1194,-1,2,207,160,845,1187,T1
4095,May 22,2014,Niger,Ukraine,1,2,Friendly,in Ukraine,0,0,1291,1839,0,0,135,17,1291,1839,T1
4096,May 23,2014,Bulgaria,Canada,1,1,Friendly,in Austria,-4,4,1644,1492,-1,0,50,89,1648,1488,draw
4097,May 23,2014,Kyrgyzstan,Myanmar,1,0,Asian Cup qual &amp; Asian Challenge Cup,in the Maldives,16,-16,1106,1009,1,-1,177,186,1090,1025,T1
4098,May 23,2014,Maldives,Palestine,0,0,Asian Cup qual &amp; Asian Challenge Cup,in the Maldives,7,-7,1085,1295,0,-2,181,134,1078,1302,draw
4099,May 23,2014,Mozambique,Morocco,0,4,Friendly,in Portugal,-11,11,1362,1539,-4,3,120,74,1373,1528,T1
4100,May 23,2014,Montenegro,Slovakia,0,2,Friendly,in Slovakia,-10,10,1601,1637,0,0,57,53,1611,1627,T1
4101,May 24,2014,Afghanistan,Laos,0,0,Asian Cup qual &amp; Asian Challenge Cup,in the Maldives,-13,13,1107,851,-2,2,176,205,1120,838,draw
4102,May 24,2014,Moldova,Saudi Arabia,4,0,Friendly,in Spain,24,-24,1461,1507,9,-6,95,83,1437,1531,T1
4103,May 24,2014,Turkmenistan,Philippines,0,2,Asian Cup qual &amp; Asian Challenge Cup,in the Maldives,-39,39,1262,1233,-11,11,143,149,1301,1194,T1
4104,May 25,2014,Mali,Guinea,1,2,Friendly,in France,-11,11,1548,1543,-1,4,70,72,1559,1532,T1
4105,May 25,2014,Ireland,Turkey,1,2,Friendly,in Ireland,-12,12,1689,1744,-5,0,44,29,1701,1732,T2
4106,May 25,2014,Senegal,Kosovo,3,1,Friendly,in Switzerland,7,-7,1577,1363,1,-1,65,119,1570,1370,T1
4107,May 26,2014,Australia,South Africa,1,1,Friendly,in Australia,-6,6,1716,1586,0,1,33,62,1722,1580,draw
4108,May 26,2014,Luxembourg,Belgium,1,5,Friendly,in Belgium,-1,1,1212,1833,0,0,155,18,1213,1832,T1
4109,May 26,2014,Macedonia,Cameroon,0,2,Friendly,in Austria,-12,12,1508,1612,-1,1,82,57,1520,1600,T1
4110,May 26,2014,Estonia,Gibraltar,1,1,Friendly,in Estonia,-9,9,1466,1134,-1,1,94,172,1475,1125,draw
4111,May 26,2014,Iran,Montenegro,0,0,Friendly,in Austria,-3,3,1713,1604,-1,-1,35,58,1716,1601,draw
4112,May 26,2014,Russia,Slovakia,1,0,Friendly,in Russia,3,-3,1851,1634,1,0,13,53,1848,1637,T1
4113,May 26,2014,Jamaica,Serbia,1,2,Friendly,in the United States,-4,4,1524,1770,-1,1,78,24,1528,1766,T1
4114,May 27,2014,Armenia,United Arab Emirates,4,3,Friendly,in Switzerland,12,-12,1590,1643,2,-3,62,51,1578,1655,T1
4115,May 27,2014,Canada,Moldova,1,1,Friendly,in Austria,-1,1,1491,1462,0,0,89,95,1492,1461,draw
4116,May 27,2014,France,Norway,4,0,Friendly,in France,4,-4,1901,1616,0,-1,12,56,1897,1620,T1
4117,May 27,2014,Cyprus,Japan,0,1,Friendly,in Japan,-1,1,1386,1770,0,1,112,24,1387,1769,T1
4118,May 27,2014,Philippines,Maldives,3,2,Asian Cup qual &amp; Asian Challenge Cup,in the Maldives,17,-17,1250,1068,5,-1,144,182,1233,1085,T2
4119,May 27,2014,Afghanistan,Palestine,0,2,Asian Cup qual &amp; Asian Challenge Cup,in the Maldives,-15,15,1092,1310,-2,1,178,132,1107,1295,T1
4120,May 27,2014,Suriname,French Guiana,1,0,Friendly,in Suriname,7,-7,1239,1231,3,-4,147,150,1232,1238,T1
4121,May 27,2014,Malawi,Tanzania,0,1,Friendly,in Tanzania,-6,6,1328,1377,-1,2,126,115,1334,1371,T1
4122,May 27,2014,United States,Azerbaijan,2,0,Friendly,in the United States,2,-2,1849,1443,1,0,15,102,1847,1445,T1
4123,May 27,2014,Oman,Uzbekistan,1,0,Friendly,in Uzbekistan,14,-14,1589,1629,3,-1,63,53,1575,1643,T2
4124,May 28,2014,Morocco,Angola,0,2,Friendly,in Portugal,-19,19,1520,1459,-6,8,81,96,1539,1440,T1
4125,May 28,2014,Denmark,Sweden,1,0,Friendly,in Denmark,9,-9,1754,1813,0,-2,28,21,1745,1822,T1
4126,May 28,2014,Mexico,Israel,3,0,Friendly,in Mexico,5,-5,1817,1615,2,-1,19,56,1812,1620,T1
4127,May 28,2014,Nigeria,Scotland,2,2,Friendly,in England,0,0,1725,1710,0,0,30,37,1725,1710,draw
4128,May 28,2014,South Korea,Tunisia,0,1,Friendly,in South Korea,-17,17,1687,1533,-6,5,44,76,1704,1516,T2
4129,May 29,2014,Georgia,Saudi Arabia,2,0,Friendly,in Spain,15,-15,1515,1492,5,-5,82,88,1500,1507,T1
4130,May 29,2014,Latvia,Estonia,0,0,Baltic Cup,in Latvia,-4,4,1445,1470,0,-1,102,95,1449,1466,draw
4131,May 29,2014,Lithuania,Finland,1,0,Baltic Cup,in Latvia,24,-24,1482,1661,6,-2,91,47,1458,1685,T1
4132,May 29,2014,Afghanistan,Maldives,1,1,Asian Cup qual &amp; Asian Challenge Cup,in the Maldives,4,-4,1096,1064,0,-1,178,183,1092,1068,draw
4133,May 29,2014,Cameroon,Paraguay,1,2,Friendly,in Austria,-8,8,1604,1703,0,2,57,38,1612,1695,T1
4134,May 29,2014,Honduras,Turkey,0,2,Friendly,in the United States,-13,13,1681,1757,-3,2,44,27,1694,1744,T1
4135,May 29,2014,Uzbekistan,Oman,0,1,Friendly,in Uzbekistan,-14,14,1615,1603,-2,4,55,59,1629,1589,T2
4136,May 30,2014,Angola,Iran,1,1,Friendly,in Austria,6,-6,1465,1707,1,-1,96,36,1459,1713,draw
4137,May 30,2014,Turks and Caicos,Aruba,0,1,CONCACAF Champ &amp; Carib Champ qual,in Aruba,-7,7,759,954,0,1,211,193,766,947,T1
4138,May 30,2014,Austria,Iceland,1,1,Friendly,in Austria,-6,6,1661,1534,0,1,46,76,1667,1528,draw
4139,May 30,2014,Ivory Coast,Bosnia and Herzegovina,1,2,Friendly,in the United States,-10,10,1772,1775,-1,3,24,23,1782,1765,T1
4140,May 30,2014,Egypt,Chile,2,3,Friendly,in Chile,-3,3,1711,1919,0,0,34,9,1714,1916,T1
4141,May 30,2014,Comoros,Kenya,1,1,African Nations Cup qualifier,in the Comoros,17,-17,895,1426,1,-3,201,106,878,1443,draw
4142,May 30,2014,Peru,England,0,3,Friendly,in England,-5,5,1706,1942,-1,0,37,6,1711,1937,T1
4143,May 30,2014,French Guiana,British Virgin Islands,6,0,CONCACAF Champ &amp; Carib Champ qual,in Aruba,4,-4,1235,681,2,-2,148,220,1231,685,T1
4144,May 30,2014,Qatar,Macedonia,0,0,Friendly,in Italy,0,0,1494,1508,0,0,87,83,1494,1508,draw
4145,May 30,2014,Montserrat,US Virgin Islands,1,0,CONCACAF Champ &amp; Carib Champ qual,in Montserrat,21,-21,605,686,1,-2,228,216,584,707,T1
4146,May 30,2014,Mozambique,South Sudan,0,0,African Nations Cup qualifier,in Sudan,-14,14,1348,1064,-4,1,124,183,1362,1050,draw
4147,May 30,2014,New Zealand,South Africa,0,0,Friendly,in New Zealand,-2,2,1544,1588,0,0,71,64,1546,1586,draw
4148,May 30,2014,Palestine,Philippines,1,0,Asian Cup qual &amp; Asian Challenge Cup,in the Maldives,17,-17,1327,1233,5,-6,127,150,1310,1250,T1
4149,May 30,2014,Spain,Bolivia,2,0,Friendly,in Spain,1,-1,2108,1626,0,0,2,53,2107,1627,T1
4150,May 30,2014,Jamaica,Switzerland,0,1,Friendly,in Switzerland,-2,2,1522,1850,-1,2,79,14,1524,1848,T1
4151,May 30,2014,Northern Ireland,Uruguay,0,1,Friendly,in Uruguay,-1,1,1412,1916,0,0,110,10,1413,1915,T1
4152,May 31,2014,Armenia,Algeria,1,3,Friendly,in Switzerland,-15,15,1575,1615,-3,5,66,55,1590,1600,T1
4153,May 31,2014,Chad,Malawi,3,1,African Nations Cup qualifier,in Chad,31,-31,1247,1297,9,-7,145,133,1216,1328,T1
4154,May 31,2014,Senegal,Colombia,2,2,Friendly,in Argentina,8,-8,1585,1918,2,-1,64,9,1577,1926,draw
4155,May 31,2014,Croatia,Mali,2,1,Friendly,in Croatia,2,-2,1812,1546,0,0,22,70,1810,1548,T1
4156,May 31,2014,Estonia,Finland,0,2,Baltic Cup,in Latvia,-11,11,1459,1672,-2,1,97,45,1470,1661,T1
4157,May 31,2014,Central African Republic,Guinea-Bissau,1,3,African Nations Cup qualifier,in Guinea-Bissau,-25,25,1242,1250,-7,9,147,143,1267,1225,T1
4158,May 31,2014,Ireland,Italy,0,0,Friendly,in England,6,-6,1695,1898,1,-1,41,12,1689,1904,draw
4159,May 31,2014,Latvia,Lithuania,1,0,Baltic Cup,in Latvia,12,-12,1457,1470,3,-3,99,94,1445,1482,T1
4160,May 31,2014,Mexico,Ecuador,3,1,Friendly,in the United States,16,-16,1833,1834,1,-3,18,17,1817,1850,T1
4161,May 31,2014,Netherlands,Ghana,1,0,Friendly,in the Netherlands,2,-2,1984,1691,0,-1,5,42,1982,1693,T1
4162,May 31,2014,Russia,Norway,1,1,Friendly,in Norway,-4,4,1847,1620,-2,0,15,54,1851,1616,draw
4163,May 31,2014,Serbia,Panama,1,1,Friendly,in the United States,-2,2,1768,1703,-1,1,26,38,1770,1701,draw
4164,May 31,2014,Portugal,Greece,0,0,Friendly,in Portugal,-6,6,1928,1822,0,0,7,20,1934,1816,draw
4165,May 31,2014,Albania,Romania,0,1,Friendly,in Switzerland,-5,5,1516,1729,0,2,80,30,1521,1724,T1
4166,May 31,2014,Rwanda,Libya,3,0,African Nations Cup qualifier,in Rwanda,47,-47,1361,1495,8,-13,122,86,1314,1542,T1
4167,May 31,2014,Swaziland,Sierra Leone,0,1,African Nations Cup qualifier,in Sierra Leone,-6,6,1134,1364,0,3,171,119,1140,1358,T1
4168,May 31,2014,Madagascar,Uganda,0,1,African Nations Cup qualifier,in Uganda,-4,4,1192,1478,0,1,160,93,1196,1474,T1
4169,June 1,2014,Aruba,British Virgin Islands,7,0,CONCACAF Champ &amp; Carib Champ qual,in Aruba,9,-9,963,672,1,-3,192,223,954,681,T1
4170,June 1,2014,São Tomé and Príncipe,Benin,0,2,African Nations Cup qualifier,in Benin,-5,5,1084,1408,-1,0,180,111,1089,1403,T1
4171,June 1,2014,Bonaire,US Virgin Islands,2,1,CONCACAF Champ &amp; Carib Champ qual,in Montserrat,7,-7,976,679,0,-3,191,219,969,686,T1
4172,June 1,2014,Burundi,Botswana,0,1,African Nations Cup qualifier,in Botswana,-16,16,1304,1303,-1,4,130,131,1320,1287,T1
4173,June 1,2014,Namibia,Congo,0,3,African Nations Cup qualifier,in Congo,-20,20,1291,1395,-5,4,135,112,1311,1375,T1
4174,June 1,2014,Equatorial Guinea,Mauritania,3,0,African Nations Cup qualifier,in Equatorial Guinea,21,-21,1306,1214,7,-5,129,155,1285,1235,T1
4175,June 1,2014,Paraguay,France,1,1,Friendly,in France,7,-7,1710,1894,3,-1,35,12,1703,1901,draw
4176,June 1,2014,Turks and Caicos,French Guiana,0,6,CONCACAF Champ &amp; Carib Champ qual,in Aruba,-5,5,754,1240,0,2,211,148,759,1235,T1
4177,June 1,2014,Cameroon,Germany,2,2,Friendly,in Germany,9,-9,1613,2072,0,0,58,3,1604,2081,draw
4178,June 1,2014,Israel,Honduras,4,2,Friendly,in the United States,18,-18,1633,1663,2,-2,53,46,1615,1681,T1
4179,June 1,2014,Liberia,Lesotho,0,2,African Nations Cup qualifier,in Lesotho,-32,32,1292,1238,-6,6,134,150,1324,1206,T1
4180,June 1,2014,Sweden,Belgium,0,2,Friendly,in Sweden,-18,18,1795,1851,-1,4,22,14,1813,1833,T2
4181,June 1,2014,Turkey,United States,1,2,Friendly,in the United States,-5,5,1752,1854,-2,1,29,13,1757,1849,T1
4182,June 1,2014,Tanzania,Zimbabwe,2,2,African Nations Cup qualifier,in Zimbabwe,5,-5,1382,1360,-1,-5,116,123,1377,1365,draw
4183,June 2,2014,Costa Rica,Japan,1,3,Friendly,in the United States,-13,13,1712,1783,-2,2,33,23,1725,1770,T1
4184,June 3,2014,Aruba,French Guiana,0,2,CONCACAF Champ &amp; Carib Champ qual,in Aruba,-16,16,947,1256,-2,5,194,143,963,1240,T2
4185,June 3,2014,Mexico,Bosnia and Herzegovina,0,1,Friendly,in the United States,-12,12,1821,1787,0,1,19,23,1833,1775,T1
4186,June 3,2014,Panama,Brazil,0,4,Friendly,in Brazil,-2,2,1701,2137,1,0,38,1,1703,2135,T1
4187,June 3,2014,Czechia,Austria,1,2,Friendly,in Czechia,-15,15,1741,1676,-2,3,29,44,1756,1661,T2
4188,June 3,2014,Nigeria,Greece,0,0,Friendly,in the United States,3,-3,1728,1819,0,0,31,20,1725,1822,draw
4189,June 3,2014,Montserrat,Bonaire,0,0,CONCACAF Champ &amp; Carib Champ qual,in Montserrat,13,-13,618,963,2,0,226,191,605,976,draw
4190,June 3,2014,Switzerland,Peru,2,0,Friendly,in Switzerland,6,-6,1856,1700,2,-1,13,39,1850,1706,T1
4191,June 3,2014,British Virgin Islands,Turks and Caicos,0,2,CONCACAF Champ &amp; Carib Champ qual,in Aruba,-23,23,649,777,-1,0,224,211,672,754,T1
4192,June 3,2014,Georgia,United Arab Emirates,0,1,Friendly,in Switzerland,-6,6,1509,1649,0,3,81,48,1515,1643,T1
4193,June 4,2014,Algeria,Romania,2,1,Friendly,in Switzerland,13,-13,1628,1716,2,-1,54,31,1615,1729,T1
4194,June 4,2014,Argentina,Trinidad and Tobago,3,0,Friendly,in Argentina,1,-1,2017,1506,0,0,4,83,2016,1507,T1
4195,June 4,2014,Northern Ireland,Chile,0,2,Friendly,in Chile,-1,1,1411,1920,0,0,110,8,1412,1919,T1
4196,June 4,2014,Ecuador,England,2,2,Friendly,in the United States,3,-3,1837,1939,0,0,18,6,1834,1942,draw
4197,June 4,2014,Jamaica,Egypt,2,2,Friendly,in England,5,-5,1527,1706,1,-3,77,37,1522,1711,draw
4198,June 4,2014,São Tomé and Príncipe,Equatorial Guinea,2,3,Friendly,in Equatorial Guinea,-3,3,1081,1309,0,0,180,129,1084,1306,T1
4199,June 4,2014,Gibraltar,Malta,1,0,Friendly,in Portugal,13,-13,1147,1237,0,-6,171,150,1134,1250,T1
4200,June 4,2014,Hungary,Albania,1,0,Friendly,in Hungary,4,-4,1672,1512,1,0,45,80,1668,1516,T1
4201,June 4,2014,Estonia,Iceland,0,1,Friendly,in Iceland,-5,5,1454,1539,-3,1,100,74,1459,1534,T1
4202,June 4,2014,Luxembourg,Italy,1,1,Friendly,in Italy,10,-10,1222,1888,2,-1,154,12,1212,1898,draw
4203,June 4,2014,El Salvador,Ivory Coast,1,2,Friendly,in the United States,-4,4,1520,1776,-1,0,78,25,1524,1772,T1
4204,June 4,2014,Wales,Netherlands,0,2,Friendly,in the Netherlands,-2,2,1593,1986,0,0,61,5,1595,1984,T1
4205,June 4,2014,Uruguay,Slovenia,2,0,Friendly,in Uruguay,3,-3,1919,1644,1,0,9,49,1916,1647,T1
4206,June 6,2014,Brazil,Serbia,1,0,Friendly,in Brazil,1,-1,2138,1767,0,0,1,26,2137,1768,T1
4207,June 6,2014,Jordan,Colombia,0,3,Friendly,in Argentina,-4,4,1581,1922,-1,2,65,8,1585,1918,T1
4208,June 6,2014,Ireland,Costa Rica,1,1,Friendly,in the United States,0,0,1695,1712,0,1,41,32,1695,1712,draw
4209,June 6,2014,Australia,Croatia,0,1,Friendly,in Brazil,-7,7,1709,1819,-4,1,35,20,1716,1812,T1
4210,June 6,2014,Armenia,Germany,1,6,Friendly,in Germany,-1,1,1574,2073,0,0,66,3,1575,2072,T1
4211,June 6,2014,Greece,Bolivia,2,1,Friendly,in the United States,5,-5,1824,1621,1,0,19,55,1819,1626,T1
4212,June 6,2014,Zambia,Japan,3,4,Friendly,in the United States,-3,3,1484,1786,0,0,90,24,1487,1783,T1
4213,June 6,2014,Lithuania,Poland,1,2,Friendly,in Poland,-3,3,1467,1647,0,0,94,49,1470,1644,T1
4214,June 6,2014,Portugal,Mexico,1,0,Friendly,in the United States,7,-7,1935,1814,0,-2,7,21,1928,1821,T1
4215,June 6,2014,Russia,Morocco,2,0,Friendly,in Russia,2,-2,1849,1518,0,-1,16,79,1847,1520,T1
4216,June 7,2014,Argentina,Slovenia,2,0,Friendly,in Argentina,2,-2,2019,1642,0,-1,4,51,2017,1644,T1
4217,June 7,2014,Tunisia,Belgium,0,1,Friendly,in Belgium,-2,2,1531,1853,0,0,76,15,1533,1851,T1
4218,June 7,2014,Moldova,Cameroon,0,1,Friendly,in Cameroon,-4,4,1458,1617,0,1,96,57,1462,1613,T1
4219,June 7,2014,Honduras,England,0,0,Friendly,in the United States,7,-7,1670,1932,0,-1,47,7,1663,1939,draw
4220,June 7,2014,Estonia,Tajikistan,2,1,Friendly,in Estonia,3,-3,1457,1260,2,-1,98,142,1454,1263,T1
4221,June 7,2014,Hungary,Kazakhstan,3,0,Friendly,in Hungary,3,-3,1675,1358,0,-2,45,123,1672,1361,T1
4222,June 7,2014,El Salvador,Spain,0,2,Friendly,in the United States,-1,1,1519,2109,0,0,78,2,1520,2108,T1
4223,June 7,2014,Nigeria,United States,1,2,Friendly,in the United States,-4,4,1724,1858,0,1,30,13,1728,1854,T1
4224,June 8,2014,France,Jamaica,8,0,Friendly,in France,3,-3,1897,1524,0,0,11,77,1894,1527,T1
4225,June 8,2014,Trinidad and Tobago,Iran,0,2,Friendly,in Brazil,-7,7,1499,1714,-2,4,85,32,1506,1707,T1
4226,June 8,2014,Albania,San Marino,3,0,Friendly,in San Marino,2,-2,1514,876,0,0,80,203,1512,878,T2
4227,June 9,2014,South Korea,Ghana,0,4,Friendly,in the United States,-19,19,1668,1710,-4,8,47,34,1687,1691,T1
4228,June 10,2014,Portugal,Ireland,5,1,Friendly,in the United States,8,-8,1943,1687,0,0,6,42,1935,1695,T1
4229,June 12,2014,Croatia,Brazil,1,3,World Cup,in Brazil,-7,7,1812,2145,-1,0,21,1,1819,2138,T1
4230,June 13,2014,Australia,Chile,1,3,World Cup,in Brazil,-21,21,1688,1941,-4,2,41,7,1709,1920,T1
4231,June 13,2014,Mexico,Cameroon,1,0,World Cup,in Brazil,15,-15,1829,1602,1,-3,19,60,1814,1617,T1
4232,June 13,2014,Spain,Netherlands,1,5,World Cup,in Brazil,-75,75,2034,2061,-2,2,4,3,2109,1986,T1
4233,June 14,2014,Greece,Colombia,0,3,World Cup,in Brazil,-38,38,1786,1960,-4,3,24,6,1824,1922,T1
4234,June 14,2014,Costa Rica,Uruguay,3,1,World Cup,in Brazil,69,-69,1781,1850,8,-5,25,15,1712,1919,T1
4235,June 14,2014,England,Italy,1,2,World Cup,in Brazil,-34,34,1898,1922,-2,3,10,9,1932,1888,T1
4236,June 14,2014,Japan,Ivory Coast,1,2,World Cup,in Brazil,-31,31,1755,1807,-3,4,27,21,1786,1776,T1
4237,June 15,2014,Argentina,Bosnia and Herzegovina,2,1,World Cup,in Brazil,12,-12,2031,1775,0,-2,5,25,2019,1787,T1
4238,June 15,2014,Honduras,France,0,3,World Cup,in Brazil,-22,22,1648,1919,-2,1,48,10,1670,1897,T1
4239,June 15,2014,Ecuador,Switzerland,1,2,World Cup,in Brazil,-28,28,1809,1884,-2,1,20,12,1837,1856,T1
4240,June 16,2014,Germany,Portugal,4,0,World Cup,in Brazil,36,-36,2109,1907,0,-3,2,10,2073,1943,T1
4241,June 16,2014,Nigeria,Iran,0,0,World Cup,in Brazil,-1,1,1723,1715,0,0,31,33,1724,1714,draw
4242,June 16,2014,United States,Ghana,2,1,World Cup,in Brazil,18,-18,1876,1692,0,-6,13,40,1858,1710,T1
4243,June 17,2014,Algeria,Belgium,1,2,World Cup,in Brazil,-13,13,1615,1866,-2,0,56,14,1628,1853,T1
4244,June 17,2014,Mexico,Brazil,0,0,World Cup,in Brazil,25,-25,1854,2120,3,0,15,1,1829,2145,draw
4245,June 17,2014,Russia,South Korea,1,1,World Cup,in Brazil,-14,14,1835,1682,-2,3,18,43,1849,1668,draw
4246,June 18,2014,Chile,Spain,2,0,World Cup,in Brazil,57,-57,1998,1977,2,-2,5,6,1941,2034,T1
4247,June 18,2014,China,Macedonia,2,0,Friendly,in China,9,-9,1565,1499,0,-2,69,84,1556,1508,T1
4248,June 18,2014,Cameroon,Croatia,0,4,World Cup,in Brazil,-26,26,1576,1838,-5,1,65,18,1602,1812,T1
4249,June 18,2014,Netherlands,Australia,3,2,World Cup,in Brazil,6,-6,2067,1682,0,-1,3,42,2061,1688,T1
4250,June 19,2014,Colombia,Ivory Coast,2,1,World Cup,in Brazil,18,-18,1978,1789,1,-1,6,22,1960,1807,T1
4251,June 19,2014,Greece,Japan,0,0,World Cup,in Brazil,-3,3,1783,1758,0,0,23,27,1786,1755,draw
4252,June 19,2014,England,Uruguay,1,2,World Cup,in Brazil,-34,34,1864,1884,-4,5,15,11,1898,1850,T1
4253,June 20,2014,Italy,Costa Rica,0,1,World Cup,in Brazil,-42,42,1880,1823,-3,3,11,21,1922,1781,T1
4254,June 20,2014,Ecuador,Honduras,2,1,World Cup,in Brazil,17,-17,1826,1631,0,-5,20,53,1809,1648,T1
4255,June 20,2014,France,Switzerland,5,2,World Cup,in Brazil,47,-47,1966,1837,1,-7,8,18,1919,1884,T1
4256,June 21,2014,Argentina,Iran,1,0,World Cup,in Brazil,8,-8,2039,1707,0,-3,4,36,2031,1715,T1
4257,June 21,2014,Germany,Ghana,2,2,World Cup,in Brazil,-25,25,2084,1717,0,8,2,32,2109,1692,draw
4258,June 21,2014,Pakistan,Indonesia,0,4,Friendly,in Indonesia,-4,4,938,1226,0,1,196,153,942,1222,T1
4259,June 21,2014,Bosnia and Herzegovina,Nigeria,0,1,World Cup,in Brazil,-34,34,1741,1757,-5,4,30,27,1775,1723,T1
4260,June 22,2014,South Korea,Algeria,2,4,World Cup,in Brazil,-54,54,1628,1669,-12,10,54,46,1682,1615,T1
4261,June 22,2014,Belgium,Russia,1,0,World Cup,in Brazil,27,-27,1893,1808,3,-2,10,21,1866,1835,T1
4262,June 22,2014,Macedonia,China,0,0,Friendly,in China,4,-4,1503,1561,0,0,84,69,1499,1565,draw
4263,June 22,2014,Portugal,United States,2,2,World Cup,in Brazil,-3,3,1904,1879,0,-1,9,13,1907,1876,draw
4264,June 23,2014,Brazil,Cameroon,4,1,World Cup,in Brazil,3,-3,2123,1573,0,-1,1,66,2120,1576,T1
4265,June 23,2014,Mexico,Croatia,3,1,World Cup,in Brazil,43,-43,1897,1795,5,-4,10,21,1854,1838,T1
4266,June 23,2014,Netherlands,Chile,2,0,World Cup,in Brazil,36,-36,2103,1962,1,-3,2,8,2067,1998,T1
4267,June 23,2014,Spain,Australia,3,0,World Cup,in Brazil,16,-16,1993,1666,2,-4,5,46,1977,1682,T1
4268,June 24,2014,Japan,Colombia,1,4,World Cup,in Brazil,-23,23,1735,2001,-5,1,31,5,1758,1978,T1
4269,June 24,2014,England,Costa Rica,0,0,World Cup,in Brazil,-4,4,1860,1827,1,1,14,18,1864,1823,draw
4270,June 24,2014,Ivory Coast,Greece,1,2,World Cup,in Brazil,-31,31,1758,1814,-2,4,25,20,1789,1783,T1
4271,June 24,2014,Uruguay,Italy,1,0,World Cup,in Brazil,30,-30,1914,1850,3,-2,9,15,1884,1880,T1
4272,June 25,2014,Nigeria,Argentina,2,3,World Cup,in Brazil,-10,10,1747,2049,-3,0,29,4,1757,2039,T1
4273,June 25,2014,Iran,Bosnia and Herzegovina,1,3,World Cup,in Brazil,-41,41,1666,1782,-9,5,45,24,1707,1741,T1
4274,June 25,2014,Ecuador,France,0,0,World Cup,in Brazil,11,-11,1837,1955,1,-1,18,8,1826,1966,draw
4275,June 25,2014,Nepal,Indonesia,0,2,Friendly,in Indonesia,-2,2,890,1228,0,0,202,153,892,1226,T1
4276,June 25,2014,Honduras,Switzerland,0,3,World Cup,in Brazil,-25,25,1606,1862,-4,3,57,14,1631,1837,T1
4277,June 26,2014,Russia,Algeria,1,1,World Cup,in Brazil,-11,11,1797,1680,0,3,21,41,1808,1669,draw
4278,June 26,2014,South Korea,Belgium,0,1,World Cup,in Brazil,-11,11,1617,1904,-2,1,55,11,1628,1893,T1
4279,June 26,2014,United States,Germany,0,1,World Cup,in Brazil,-14,14,1865,2098,0,0,13,3,1879,2084,T1
4280,June 26,2014,Ghana,Portugal,1,2,World Cup,in Brazil,-15,15,1702,1919,-4,1,36,9,1717,1904,T1
4281,June 28,2014,Brazil,Chile,1,1,World Cup,in Brazil,-19,19,2104,1981,0,0,1,7,2123,1962,draw
4282,June 28,2014,Colombia,Uruguay,2,0,World Cup,in Brazil,34,-34,2035,1880,0,-2,5,12,2001,1914,T1
4283,June 29,2014,China,Mali,1,3,Friendly,in China,-20,20,1541,1566,-4,2,73,68,1561,1546,T2
4284,June 29,2014,Greece,Costa Rica,1,1,World Cup,in Brazil,1,-1,1815,1826,0,0,20,19,1814,1827,draw
4285,June 29,2014,Mexico,Netherlands,1,2,World Cup,in Brazil,-14,14,1883,2117,0,1,11,1,1897,2103,T1
4286,June 30,2014,Nigeria,France,0,2,World Cup,in Brazil,-21,21,1726,1976,-2,0,31,8,1747,1955,T1
4287,June 30,2014,Algeria,Germany,1,2,World Cup,in Brazil,-5,5,1675,2103,-1,0,42,3,1680,2098,T1
4288,July 1,2014,Switzerland,Argentina,0,1,World Cup,in Brazil,-15,15,1847,2064,-1,0,15,4,1862,2049,T1
4289,July 1,2014,United States,Belgium,1,2,World Cup,in Brazil,-27,27,1838,1931,-4,1,17,9,1865,1904,T1
4290,July 1,2014,Tanzania,Botswana,2,4,Friendly,in Botswana,-14,14,1368,1317,-1,3,117,128,1382,1303,T1
4291,July 2,2014,Myanmar,Vietnam,0,6,Friendly,in Vietnam,-6,6,1003,1242,-1,4,187,147,1009,1236,T1
4292,July 4,2014,Colombia,Brazil,1,2,World Cup,in Brazil,-16,16,2019,2120,0,0,5,2,2035,2104,T1
4293,July 4,2014,France,Germany,0,1,World Cup,in Brazil,-19,19,1957,2122,0,2,8,1,1976,2103,T1
4294,July 5,2014,Belgium,Argentina,0,1,World Cup,in Brazil,-19,19,1912,2083,-1,0,10,4,1931,2064,T1
4295,July 5,2014,Costa Rica,Netherlands,0,0,World Cup,in Brazil,21,-21,1847,2096,4,0,15,3,1826,2117,draw
4296,July 6,2014,Malawi,Mozambique,1,1,Friendly,in Malawi,-1,1,1296,1349,0,0,133,125,1297,1348,draw
4297,July 8,2014,Germany,Brazil,7,1,World Cup,in Brazil,81,-81,2203,2039,0,-2,1,4,2122,2120,T2
4298,July 9,2014,Netherlands,Argentina,0,0,World Cup,in Brazil,-1,1,2095,2084,0,0,2,3,2096,2083,draw
4299,July 11,2014,Seychelles,Uganda,0,1,Friendly,in Uganda,-1,1,992,1479,0,1,189,92,993,1478,T1
4300,July 12,2014,Brazil,Netherlands,0,3,World Cup,in Brazil,-59,59,1980,2154,-3,0,7,2,2039,2095,T2
4301,July 12,2014,Gabon,Rwanda,0,1,Friendly,in Rwanda,-11,11,1495,1372,-3,4,85,117,1506,1361,T1
4302,July 13,2014,Germany,Argentina,1,0,World Cup,in Brazil,20,-20,2223,2064,0,0,1,3,2203,2084,T1
4303,July 14,2014,Lesotho,Botswana,0,2,Friendly,in Botswana,-8,8,1230,1325,-3,0,153,128,1238,1317,T1
4304,July 14,2014,Indonesia,Qatar,2,2,Friendly,in Qatar,8,-8,1236,1486,2,-2,151,89,1228,1494,draw
4305,July 15,2014,Kenya,Burundi,0,0,Friendly,in Kenya,-6,6,1420,1310,-3,1,109,130,1426,1304,draw
4306,July 15,2014,Uganda,Malawi,0,0,Friendly,in Uganda,-7,7,1472,1303,-1,1,93,132,1479,1296,draw
4307,July 19,2014,Guinea-Bissau,Botswana,0,2,African Nations Cup qualifier,in Botswana,-16,16,1234,1341,-7,2,151,126,1250,1325,T1
4308,July 19,2014,Sierra Leone,Seychelles,2,0,African Nations Cup qualifier,in Sierra Leone,4,-4,1368,988,1,0,118,189,1364,992,T1
4309,July 19,2014,Mauritania,Uganda,0,2,African Nations Cup qualifier,in Uganda,-7,7,1207,1479,0,1,156,92,1214,1472,T1
4310,July 20,2014,Benin,Malawi,1,0,African Nations Cup qualifier,in Benin,9,-9,1417,1294,2,-1,109,133,1408,1303,T1
4311,July 20,2014,Congo,Rwanda,2,0,African Nations Cup qualifier,in Congo,20,-20,1415,1352,2,-8,110,125,1395,1372,T1
4312,July 20,2014,Kenya,Lesotho,0,1,African Nations Cup qualifier,in Lesotho,-25,25,1395,1255,-3,9,112,144,1420,1230,T1
4313,July 20,2014,Tanzania,Mozambique,2,2,African Nations Cup qualifier,in Tanzania,-7,7,1361,1356,-2,1,120,124,1368,1349,draw
4314,July 21,2014,Guam,Macao,0,0,East Asian Cup qualifier,in Guam,-11,11,728,629,0,0,212,226,739,618,draw
4315,July 21,2014,Mongolia,Northern Mariana Islands,4,0,East Asian Cup qualifier,in Guam,10,-10,790,440,1,0,209,234,780,450,T1
4316,July 23,2014,Guam,Mongolia,2,0,East Asian Cup qualifier,in Guam,27,-27,755,763,0,-2,212,211,728,790,T1
4317,July 23,2014,Macao,Northern Mariana Islands,1,2,East Asian Cup qualifier,in Guam,-30,30,599,470,-2,0,228,234,629,440,T1
4318,July 25,2014,Guam,Northern Mariana Islands,5,0,East Asian Cup qualifier,in Guam,8,-8,763,462,1,0,211,234,755,470,T1
4319,July 25,2014,Mongolia,Macao,2,3,East Asian Cup qualifier,in Guam,-29,29,734,628,-1,2,212,226,763,599,T1
4320,July 27,2014,Gabon,Rwanda,0,1,Friendly,in Gabon,-16,16,1479,1368,-6,8,91,117,1495,1352,T2
4321,August 2,2014,Guinea-Bissau,Botswana,1,1,African Nations Cup qualifier,in Guinea-Bissau,0,0,1234,1341,0,0,152,126,1234,1341,draw
4322,August 2,2014,Benin,Malawi,0,1,African Nations Cup qualifier,in Malawi,-21,21,1396,1315,-1,4,110,129,1417,1294,T1
4323,August 2,2014,Congo,Rwanda,0,2,African Nations Cup qualifier,in Rwanda,-25,25,1390,1393,-3,5,113,112,1415,1368,T1
4324,August 3,2014,Angola,Ethiopia,1,0,Friendly,in Angola,5,-5,1470,1379,1,-1,94,116,1465,1384,T1
4325,August 3,2014,Kenya,Lesotho,0,0,African Nations Cup qualifier,in Kenya,-12,12,1383,1267,-4,4,115,140,1395,1255,draw
4326,August 3,2014,Uganda,Mauritania,1,0,African Nations Cup qualifier,in Mauritania,11,-11,1490,1196,3,-3,88,159,1479,1207,T2
4327,August 3,2014,Tanzania,Mozambique,1,2,African Nations Cup qualifier,in Mozambique,-15,15,1346,1371,-4,7,125,118,1361,1356,T1
4328,August 6,2014,Peru,Panama,3,0,Friendly,in Peru,13,-13,1713,1688,5,-2,33,39,1700,1701,T1
4329,August 8,2014,Tajikistan,Malaysia,4,1,Friendly,in Tajikistan,10,-10,1270,1180,4,0,139,162,1260,1190,T1
4330,August 12,2014,Kazakhstan,Tajikistan,2,1,Friendly,in Kazakhstan,5,-5,1363,1265,3,-2,120,141,1358,1270,T1
4331,August 13,2014,Botswana,Angola,0,0,Friendly,in Angola,6,-6,1347,1464,1,-1,125,95,1341,1470,draw
4332,August 14,2014,Nicaragua,Guatemala,0,3,Friendly,in Guatemala,-2,2,1115,1481,0,1,174,91,1117,1479,T1
4333,August 16,2014,Saint Martin,British Virgin Islands,4,2,Friendly,in the British Virgin Islands,11,-11,860,638,1,0,205,224,849,649,T2
4334,August 20,2014,Azerbaijan,Uzbekistan,0,0,Friendly,in Azerbaijan,2,-2,1445,1613,0,0,103,56,1443,1615,draw
4335,August 20,2014,Cuba,Panama,0,4,Friendly,in Panama,-4,4,1418,1692,0,0,108,39,1422,1688,T1
4336,August 23,2014,Cuba,Guatemala,0,1,Friendly,in Guatemala,-6,6,1412,1487,0,2,108,89,1418,1481,T1
4337,August 24,2014,Suriname,French Guiana,1,0,Friendly,in French Guiana,13,-13,1252,1243,5,-3,144,147,1239,1256,T2
4338,August 26,2014,Seychelles,Sri Lanka,1,2,Friendly,in the Seychelles,-16,16,972,843,-1,1,190,207,988,827,T2
4339,August 27,2014,Norway,United Arab Emirates,0,0,Friendly,in Norway,-2,2,1618,1651,0,0,54,47,1620,1649,draw
4340,August 28,2014,Sri Lanka,Seychelles,0,3,Friendly,in the Seychelles,-7,7,836,979,-1,0,208,190,843,972,T1
4341,August 30,2014,Kenya,Egypt,0,1,Friendly,in Egypt,-2,2,1381,1708,0,0,115,36,1383,1706,T1
4342,August 30,2014,El Salvador,Dominican Republic,2,0,Friendly,in El Salvador,3,-3,1522,1262,0,-1,78,142,1519,1265,T1
4343,August 31,2014,Zambia,Sudan,3,1,Friendly,in Zambia,7,-7,1491,1377,4,-2,87,116,1484,1384,T1
4344,September 2,2014,Uganda,Niger,0,2,Friendly,in Niger,-19,19,1471,1310,-4,4,93,131,1490,1291,T1
4345,September 3,2014,Anguilla,Antigua and Barbuda,0,6,CONCACAF Champ &amp; Carib Champ qual,in Antigua and Barbuda,-1,1,562,1270,0,0,231,139,563,1269,T1
4346,September 3,2014,Barbados,Suriname,1,1,CONCACAF Champ &amp; Carib Champ qual,in Martinique,7,-7,1137,1245,1,0,172,144,1130,1252,draw
4347,September 3,2014,Nicaragua,Costa Rica,0,3,CONCACAF Champ q &amp; Central Am Cup,in the United States,-1,1,1114,1848,0,0,174,15,1115,1847,T1
4348,September 3,2014,United States,Czechia,1,0,Friendly,in Czechia,10,-10,1848,1731,3,-1,15,30,1838,1741,T2
4349,September 3,2014,Turkey,Denmark,2,1,Friendly,in Denmark,13,-13,1765,1741,2,-1,26,28,1752,1754,T2
4350,September 3,2014,Dominica,Guyana,0,0,CONCACAF Champ &amp; Carib Champ qual,in Saint Kitts and Nevis,15,-15,977,1296,1,-3,191,133,962,1311,draw
4351,September 3,2014,England,Norway,1,0,Friendly,in England,2,-2,1862,1616,0,-1,13,55,1860,1618,T1
4352,September 3,2014,Grenada,French Guiana,1,1,CONCACAF Champ &amp; Carib Champ qual,in Puerto Rico,3,-3,1195,1240,0,-1,160,148,1192,1243,draw
4353,September 3,2014,Germany,Argentina,2,4,Friendly,in Germany,-24,24,2199,2088,0,0,1,3,2223,2064,T2
4354,September 3,2014,El Salvador,Guatemala,1,2,CONCACAF Champ q &amp; Central Am Cup,in the United States,-22,22,1500,1509,-6,9,84,80,1522,1487,T1
4355,September 3,2014,Belize,Honduras,0,2,CONCACAF Champ q &amp; Central Am Cup,in the United States,-4,4,1146,1610,-1,0,170,57,1150,1606,T1
4356,September 3,2014,Ireland,Oman,2,0,Friendly,in Ireland,8,-8,1695,1595,1,0,39,59,1687,1603,T1
4357,September 3,2014,Latvia,Armenia,2,0,Friendly,in Latvia,16,-16,1473,1558,5,-4,93,69,1457,1574,T1
4358,September 3,2014,United Arab Emirates,Lithuania,1,1,Friendly,in Austria,-5,5,1646,1472,-1,0,48,94,1651,1467,draw
4359,September 3,2014,Bonaire,Martinique,0,6,CONCACAF Champ &amp; Carib Champ qual,in Martinique,-3,3,960,1434,-1,1,192,104,963,1431,T1
4360,September 3,2014,Morocco,Qatar,0,0,Friendly,in Morocco,-4,4,1514,1490,1,0,78,90,1518,1486,draw
4361,September 3,2014,Palestine,Myanmar,1,4,Friendly tournament,in the Philippines,-45,45,1282,1048,-8,2,136,185,1327,1003,T1
4362,September 3,2014,Taiwan,Philippines,1,5,Friendly tournament,in the Philippines,-3,3,840,1236,0,3,207,150,843,1233,T1
4363,September 3,2014,Curaçao,Puerto Rico,2,2,CONCACAF Champ &amp; Carib Champ qual,in Puerto Rico,9,-9,1016,1077,-1,-1,187,180,1007,1086,draw
4364,September 3,2014,Azerbaijan,Russia,0,4,Friendly,in Russia,-3,3,1442,1800,0,0,103,21,1445,1797,T1
4365,September 3,2014,Saint Lucia,Saint Kitts and Nevis,0,0,CONCACAF Champ &amp; Carib Champ qual,in Saint Kitts and Nevis,8,-8,1112,1142,2,-2,175,171,1104,1150,draw
4366,September 3,2014,Saint Vincent and the Grenadines,Dominican Republic,1,0,CONCACAF Champ &amp; Carib Champ qual,in Antigua and Barbuda,26,-26,1179,1236,5,-8,163,150,1153,1262,T1
4367,September 3,2014,Moldova,Ukraine,0,1,Friendly,in Ukraine,-1,1,1457,1840,-2,-1,98,18,1458,1839,T1
4368,September 4,2014,Tajikistan,Belarus,1,6,Friendly,in Belarus,-3,3,1262,1596,0,1,141,59,1265,1593,T1
4369,September 4,2014,Belgium,Australia,2,0,Friendly,in Belgium,4,-4,1916,1662,0,-1,10,46,1912,1666,T1
4370,September 4,2014,Bosnia and Herzegovina,Liechtenstein,3,0,Friendly,in Bosnia and Herzegovina,1,-1,1783,1172,0,0,24,166,1782,1173,T1
4371,September 4,2014,China,Kuwait,3,1,Friendly,in China,11,-11,1552,1531,3,-3,70,75,1541,1542,T1
4372,September 4,2014,Croatia,Cyprus,2,0,Friendly,in Croatia,2,-2,1797,1384,0,0,22,113,1795,1386,T1
4373,September 4,2014,Spain,France,0,1,Friendly,in France,-8,8,1985,1965,0,0,5,8,1993,1957,T1
4374,September 4,2014,Netherlands,Italy,0,2,Friendly,in Italy,-23,23,2131,1873,0,1,2,13,2154,1850,T1
4375,September 4,2014,Peru,Iraq,2,0,Friendly,in the United Arab Emirates,9,-9,1722,1561,1,-2,32,68,1713,1570,T1
4376,September 4,2014,Slovakia,Malta,1,0,Friendly,in Slovakia,1,-1,1635,1236,0,0,51,149,1634,1237,T1
4377,September 4,2014,Sweden,Estonia,2,0,Friendly,in Sweden,2,-2,1797,1455,0,-1,22,99,1795,1457,T1
4378,September 4,2014,Uzbekistan,Jordan,2,0,Friendly,in Uzbekistan,10,-10,1623,1571,3,-1,53,65,1613,1581,T1
4379,September 5,2014,Antigua and Barbuda,Dominican Republic,2,1,CONCACAF Champ &amp; Carib Champ qual,in Antigua and Barbuda,13,-13,1283,1223,4,-4,135,153,1270,1236,T1
4380,September 5,2014,Suriname,Bonaire,2,3,CONCACAF Champ &amp; Carib Champ qual,in Martinique,-34,34,1211,994,-11,3,155,189,1245,960,T1
4381,September 5,2014,Brazil,Colombia,1,0,Friendly,in the United States,11,-11,1991,2008,2,0,5,4,1980,2019,T1
4382,September 5,2014,Curaçao,Grenada,2,1,CONCACAF Champ &amp; Carib Champ qual,in Puerto Rico,29,-29,1045,1166,1,-6,186,166,1016,1195,T1
4383,September 5,2014,Togo,Guinea,1,2,African Nations Cup qualifier,in Morocco,-16,16,1464,1559,-4,3,95,69,1480,1543,T1
4384,September 5,2014,Japan,Uruguay,0,2,Friendly,in Japan,-13,13,1722,1893,-2,1,31,11,1735,1880,T2
4385,September 5,2014,Kyrgyzstan,Kazakhstan,1,7,Friendly,in Kazakhstan,-5,5,1101,1368,0,2,177,118,1106,1363,T1
4386,September 5,2014,Barbados,Martinique,2,3,CONCACAF Champ &amp; Carib Champ qual,in Martinique,-4,4,1133,1438,-2,0,174,104,1137,1434,T1
4387,September 5,2014,French Guiana,Puerto Rico,2,1,CONCACAF Champ &amp; Carib Champ qual,in Puerto Rico,16,-16,1256,1061,6,-4,142,184,1240,1077,T2
4388,September 5,2014,Egypt,Senegal,0,2,African Nations Cup qualifier,in Senegal,-32,32,1676,1617,-4,7,40,56,1708,1585,T1
4389,September 5,2014,Venezuela,South Korea,1,3,Friendly,in South Korea,-14,14,1683,1631,-1,2,39,53,1697,1617,T1
4390,September 5,2014,Saint Kitts and Nevis,Dominica,5,0,CONCACAF Champ &amp; Carib Champ qual,in Saint Kitts and Nevis,14,-14,1156,963,1,-1,170,192,1142,977,T1
4391,September 5,2014,Guyana,Saint Lucia,0,2,CONCACAF Champ &amp; Carib Champ qual,in Saint Kitts and Nevis,-45,45,1251,1157,-10,7,143,168,1296,1112,T1
4392,September 5,2014,Saint Vincent and the Grenadines,Anguilla,4,0,CONCACAF Champ &amp; Carib Champ qual,in Antigua and Barbuda,2,-2,1181,560,2,0,161,231,1179,562,T1
4393,September 5,2014,Sudan,South Africa,0,3,African Nations Cup qualifier,in Sudan,-24,24,1353,1612,-8,4,124,58,1377,1588,T2
4394,September 6,2014,Lesotho,Burkina Faso,0,2,African Nations Cup qualifier,in Burkina Faso,-6,6,1261,1544,-2,2,141,72,1267,1538,T1
4395,September 6,2014,Chile,Mexico,0,0,Friendly,in the United States,-3,3,1978,1886,0,0,7,12,1981,1883,draw
4396,September 6,2014,Democratic Republic of Congo,Cameroon,0,2,African Nations Cup qualifier,in the Democratic Republic of the Congo,-28,28,1424,1601,-5,3,107,61,1452,1573,T2
4397,September 6,2014,Bolivia,Ecuador,0,4,Friendly,in the United States,-8,8,1613,1845,-2,1,57,18,1621,1837,T1
4398,September 6,2014,Ethiopia,Algeria,1,2,African Nations Cup qualifier,in Ethiopia,-10,10,1369,1685,-2,3,117,39,1379,1675,T2
4399,September 6,2014,Gabon,Angola,1,0,African Nations Cup qualifier,in Gabon,14,-14,1493,1450,5,-6,86,101,1479,1464,T1
4400,September 6,2014,Uganda,Ghana,1,1,African Nations Cup qualifier,in Ghana,15,-15,1486,1687,3,-2,91,38,1471,1702,draw
4401,September 6,2014,Sierra Leone,Ivory Coast,1,2,African Nations Cup qualifier,in Ivory Coast,-2,2,1366,1760,-1,0,119,27,1368,1758,T1
4402,September 6,2014,Cape Verde,Niger,3,1,African Nations Cup qualifier,in Niger,22,-22,1527,1288,5,-5,77,134,1505,1310,T2
4403,September 6,2014,Nigeria,Congo,2,3,African Nations Cup qualifier,in Nigeria,-37,37,1689,1427,-7,7,37,105,1726,1390,T2
4404,September 6,2014,Taiwan,Palestine,3,7,Friendly tournament,in the Philippines,-4,4,836,1286,0,1,207,135,840,1282,T1
4405,September 6,2014,Myanmar,Philippines,3,2,Friendly tournament,in the Philippines,25,-25,1073,1211,4,-6,181,154,1048,1236,T2
4406,September 6,2014,Papua New Guinea,Singapore,1,2,Friendly,in Singapore,-3,3,1062,1247,-3,0,184,145,1065,1244,T1
4407,September 6,2014,Trinidad and Tobago,Guadeloupe,1,1,Friendly,in Trinidad and Tobago,-6,6,1493,1379,-1,0,86,116,1499,1373,draw
4408,September 6,2014,Tunisia,Botswana,2,1,African Nations Cup qualifier,in Tunisia,7,-7,1538,1340,0,-1,75,126,1531,1347,T1
4409,September 6,2014,Hong Kong,Vietnam,1,3,Friendly,in Vietnam,-8,8,1151,1250,-3,2,170,144,1159,1242,T1
4410,September 6,2014,Zambia,Mozambique,0,0,African Nations Cup qualifier,in Zambia,-11,11,1480,1382,-4,3,92,114,1491,1371,draw
4411,September 7,2014,Antigua and Barbuda,Saint Vincent and the Grenadines,2,1,CONCACAF Champ &amp; Carib Champ qual,in Antigua and Barbuda,10,-10,1293,1171,4,-5,132,166,1283,1181,T1
4412,September 7,2014,Bonaire,Barbados,1,4,CONCACAF Champ &amp; Carib Champ qual,in Martinique,-22,22,972,1155,-2,4,191,170,994,1133,T1
4413,September 7,2014,Tanzania,Burundi,0,2,Friendly,in Burundi,-12,12,1334,1322,-1,1,126,128,1346,1310,T1
4414,September 7,2014,Costa Rica,Panama,2,2,CONCACAF Champ q &amp; Central Am Cup,in the United States,-8,8,1840,1700,-3,0,18,36,1848,1692,draw
4415,September 7,2014,Curaçao,French Guiana,0,0,CONCACAF Champ &amp; Carib Champ qual,in Puerto Rico,11,-11,1056,1245,0,-3,186,145,1045,1256,draw
4416,September 7,2014,Denmark,Armenia,2,1,European Championship qualifier,in Denmark,7,-7,1748,1551,0,-2,28,72,1741,1558,T1
4417,September 7,2014,Dominican Republic,Anguilla,10,0,CONCACAF Champ &amp; Carib Champ qual,in Antigua and Barbuda,2,-2,1225,558,0,0,152,231,1223,560,T1
4418,September 7,2014,Honduras,El Salvador,0,1,CONCACAF Champ q &amp; Central Am Cup,in the United States,-26,26,1584,1526,-4,5,63,79,1610,1500,T1
4419,September 7,2014,Finland,Faroe Islands,3,1,European Championship qualifier,in the Faroe Islands,6,-6,1678,1198,3,-2,41,158,1672,1204,T2
4420,September 7,2014,Georgia,Ireland,1,2,European Championship qualifier,in Georgia,-15,15,1494,1710,-3,2,84,33,1509,1695,T2
4421,September 7,2014,Germany,Scotland,2,1,European Championship qualifier,in Germany,1,-1,2200,1709,0,-1,1,34,2199,1710,T1
4422,September 7,2014,Romania,Greece,1,0,European Championship qualifier,in Greece,30,-30,1746,1785,3,-3,29,23,1716,1815,T2
4423,September 7,2014,Guatemala,Belize,2,1,CONCACAF Champ q &amp; Central Am Cup,in the United States,4,-4,1513,1142,-1,0,82,172,1509,1146,T1
4424,September 7,2014,Hungary,Northern Ireland,1,2,European Championship qualifier,in Hungary,-36,36,1639,1447,-7,8,50,102,1675,1411,T2
4425,September 7,2014,Oman,Kosovo,0,1,Friendly,in Kosovo,-14,14,1581,1377,-1,3,64,117,1595,1363,T1
4426,September 7,2014,Mali,Malawi,2,0,African Nations Cup qualifier,in Mali,7,-7,1573,1308,1,-2,65,130,1566,1315,T1
4427,September 7,2014,Suriname,Martinique,0,0,CONCACAF Champ &amp; Carib Champ qual,in Martinique,15,-15,1226,1423,4,-6,150,109,1211,1438,draw
4428,September 7,2014,Morocco,Libya,3,0,Friendly,in Morocco,12,-12,1526,1483,0,-6,79,91,1514,1495,T1
4429,September 7,2014,Paraguay,United Arab Emirates,0,0,Friendly,in Austria,-2,2,1708,1648,-2,1,35,47,1710,1646,draw
4430,September 7,2014,Poland,Gibraltar,7,0,European Championship qualifier,in Portugal,5,-5,1652,1142,1,-1,46,172,1647,1147,T1
4431,September 7,2014,Albania,Portugal,1,0,European Championship qualifier,in Portugal,38,-38,1552,1881,9,-3,70,12,1514,1919,T2
4432,September 7,2014,Puerto Rico,Grenada,2,2,CONCACAF Champ &amp; Carib Champ qual,in Puerto Rico,0,0,1061,1166,0,-2,185,168,1061,1166,draw
4433,September 7,2014,Serbia,France,1,1,Friendly,in Serbia,3,-3,1770,1962,0,0,25,8,1767,1965,draw
4434,September 7,2014,Saint Kitts and Nevis,Guyana,2,0,CONCACAF Champ &amp; Carib Champ qual,in Saint Kitts and Nevis,30,-30,1186,1221,8,-11,161,154,1156,1251,T1
4435,September 7,2014,Dominica,Saint Lucia,1,2,CONCACAF Champ &amp; Carib Champ qual,in Saint Kitts and Nevis,-10,10,953,1167,0,0,192,167,963,1157,T1
4436,September 8,2014,Saudi Arabia,Australia,2,3,Friendly,in England,-5,5,1487,1667,-2,0,89,45,1492,1662,T1
4437,September 8,2014,Sweden,Austria,1,1,European Championship qualifier,in Austria,-1,1,1796,1677,-1,0,22,42,1797,1676,draw
4438,September 8,2014,Slovenia,Estonia,0,1,European Championship qualifier,in Estonia,-25,25,1617,1480,-5,6,54,92,1642,1455,T1
4439,September 8,2014,Belarus,Luxembourg,1,1,European Championship qualifier,in Luxembourg,-13,13,1583,1235,-2,4,63,149,1596,1222,draw
4440,September 8,2014,Moldova,Montenegro,0,2,European Championship qualifier,in Montenegro,-12,12,1445,1616,-5,3,102,56,1457,1604,T1
4441,September 8,2014,Russia,Liechtenstein,4,0,European Championship qualifier,in Russia,1,-1,1801,1171,0,0,20,165,1800,1172,T1
4442,September 8,2014,Lithuania,San Marino,2,0,European Championship qualifier,in San Marino,3,-3,1475,873,0,0,94,203,1472,876,T2
4443,September 8,2014,South Korea,Uruguay,0,1,Friendly,in South Korea,-6,6,1625,1899,0,0,53,10,1631,1893,T2
4444,September 8,2014,Macedonia,Spain,1,5,European Championship qualifier,in Spain,-3,3,1500,1988,0,0,83,6,1503,1985,T1
4445,September 8,2014,England,Switzerland,2,0,European Championship qualifier,in Switzerland,37,-37,1899,1810,4,-2,10,18,1862,1847,T2
4446,September 8,2014,Slovakia,Ukraine,1,0,European Championship qualifier,in Ukraine,34,-34,1669,1806,7,-1,44,19,1635,1840,T2
4447,September 8,2014,Uzbekistan,New Zealand,3,1,Friendly,in Uzbekistan,8,-8,1631,1536,2,-3,52,76,1623,1544,T1
4448,September 9,2014,Andorra,Wales,1,2,European Championship qualifier,in Andorra,-2,2,983,1595,0,0,189,61,985,1593,T2
4449,September 9,2014,Azerbaijan,Bulgaria,1,2,European Championship qualifier,in Azerbaijan,-14,14,1428,1658,-1,2,104,47,1442,1644,T2
4450,September 9,2014,Cyprus,Bosnia and Herzegovina,2,1,European Championship qualifier,in Bosnia and Herzegovina,38,-38,1422,1745,3,-5,110,29,1384,1783,T2
4451,September 9,2014,Ecuador,Brazil,0,1,Friendly,in the United States,-6,6,1839,1997,-1,0,17,5,1845,1991,T1
4452,September 9,2014,Canada,Jamaica,3,1,Friendly,in Canada,12,-12,1503,1512,4,-1,83,82,1491,1524,T1
4453,September 9,2014,Chile,Haiti,1,0,Friendly,in the United States,1,-1,1979,1432,0,1,7,103,1978,1433,T1
4454,September 9,2014,Jordan,China,1,1,Friendly,in China,2,-2,1573,1550,0,-3,66,73,1571,1552,draw
4455,September 9,2014,Malta,Croatia,0,2,European Championship qualifier,in Croatia,-1,1,1235,1798,0,0,147,21,1236,1797,T1
4456,September 9,2014,Netherlands,Czechia,1,2,European Championship qualifier,in Czechia,-34,34,2097,1765,0,5,2,25,2131,1731,T1
4457,September 9,2014,Iceland,Turkey,3,0,European Championship qualifier,in Iceland,47,-47,1586,1718,12,-5,62,31,1539,1765,T1
4458,September 9,2014,Indonesia,Yemen,0,0,Friendly,in Indonesia,-5,5,1231,1162,-3,0,150,169,1236,1157,draw
4459,September 9,2014,Venezuela,Japan,2,2,Friendly,in Japan,4,-4,1687,1718,2,0,38,31,1683,1722,draw
4460,September 9,2014,Latvia,Kazakhstan,0,0,European Championship qualifier,in Kazakhstan,0,0,1473,1368,0,0,95,119,1473,1368,draw
4461,September 9,2014,Bahrain,Kuwait,1,0,Friendly,in Kuwait,15,-15,1468,1516,3,-3,96,80,1453,1531,T2
4462,September 9,2014,Mexico,Bolivia,1,0,Friendly,in the United States,3,-3,1889,1610,-1,0,13,58,1886,1613,T1
4463,September 9,2014,Norway,Italy,0,2,European Championship qualifier,in Norway,-17,17,1599,1890,-4,2,60,12,1616,1873,T2
4464,September 9,2014,Qatar,Peru,0,2,Friendly,in Qatar,-10,10,1480,1732,-3,1,91,30,1490,1722,T2
4465,September 9,2014,Singapore,Hong Kong,0,0,Friendly,in Singapore,-5,5,1242,1156,-2,1,145,170,1247,1151,draw
4466,September 10,2014,Algeria,Mali,1,0,African Nations Cup qualifier,in Algeria,9,-9,1694,1564,2,-3,38,69,1685,1573,T1
4467,September 10,2014,Angola,Burkina Faso,0,3,African Nations Cup qualifier,in Angola,-36,36,1414,1580,-10,9,110,65,1450,1544,T2
4468,September 10,2014,Senegal,Botswana,2,0,African Nations Cup qualifier,in Botswana,16,-16,1633,1324,2,-3,52,128,1617,1340,T2
4469,September 10,2014,Ivory Coast,Cameroon,1,4,African Nations Cup qualifier,in Cameroon,-41,41,1719,1642,-4,9,30,50,1760,1601,T1
4470,September 10,2014,Cape Verde,Zambia,2,1,African Nations Cup qualifier,in Cape Verde,12,-12,1539,1468,1,-4,76,95,1527,1480,T1
4471,September 10,2014,Sudan,Congo,0,2,African Nations Cup qualifier,in Congo,-16,16,1337,1443,0,3,124,102,1353,1427,T1
4472,September 10,2014,Democratic Republic of Congo,Sierra Leone,2,0,African Nations Cup qualifier,in the Democratic Republic of the Congo,17,-17,1441,1349,4,-3,103,123,1424,1366,T1
4473,September 10,2014,Tunisia,Egypt,1,0,African Nations Cup qualifier,in Egypt,32,-32,1570,1644,8,-6,67,49,1538,1676,T2
4474,September 10,2014,Belize,El Salvador,0,2,CONCACAF Champ q &amp; Central Am Cup,in the United States,-6,6,1136,1532,-2,0,174,78,1142,1526,T1
4475,September 10,2014,Honduras,Guatemala,0,2,CONCACAF Champ q &amp; Central Am Cup,in the United States,-36,36,1548,1549,-12,7,75,74,1584,1513,T1
4476,September 10,2014,Lesotho,Gabon,1,1,African Nations Cup qualifier,in Lesotho,7,-7,1268,1486,2,-3,139,89,1261,1493,draw
4477,September 10,2014,Ethiopia,Malawi,2,3,African Nations Cup qualifier,in Malawi,-18,18,1351,1326,-4,3,122,127,1369,1308,T1
4478,September 10,2014,Mozambique,Niger,1,1,African Nations Cup qualifier,in Mozambique,-10,10,1372,1298,-3,4,117,131,1382,1288,draw
4479,September 10,2014,Namibia,Swaziland,1,1,Friendly,in Namibia,-6,6,1285,1140,-2,1,136,173,1291,1134,draw
4480,September 10,2014,Panama,Nicaragua,2,0,CONCACAF Champ q &amp; Central Am Cup,in the United States,2,-2,1702,1112,0,0,36,175,1700,1114,T1
4481,September 10,2014,Nigeria,South Africa,0,0,African Nations Cup qualifier,in South Africa,1,-1,1690,1611,-2,-1,39,58,1689,1612,draw
4482,September 10,2014,Ghana,Togo,3,2,African Nations Cup qualifier,in Togo,13,-13,1700,1451,1,-2,37,99,1687,1464,T2
4483,September 10,2014,Uganda,Guinea,2,0,African Nations Cup qualifier,in Uganda,28,-28,1514,1531,7,-9,82,79,1486,1559,T1
4484,September 13,2014,Costa Rica,Guatemala,2,1,Central American Cup,in the United States,6,-6,1846,1543,0,-1,16,75,1840,1549,T1
4485,September 13,2014,Nicaragua,Honduras,0,1,CONCACAF Champ q &amp; Central Am Cup,in the United States,-3,3,1109,1551,0,3,175,72,1112,1548,T1
4486,September 13,2014,Panama,El Salvador,1,0,Central American Cup,in the United States,11,-11,1713,1521,3,-2,33,80,1702,1532,T1
4487,September 14,2014,Malaysia,Indonesia,0,2,Friendly,in Indonesia,-9,9,1171,1240,-2,3,164,147,1180,1231,T1
4488,September 20,2014,Cambodia,Malaysia,1,4,Friendly,in Malaysia,-1,1,672,1172,0,0,222,164,673,1171,T1
4489,September 21,2014,Saint Vincent and the Grenadines,British Virgin Islands,6,0,Friendly,in the British Virgin Islands,3,-3,1174,635,2,0,163,224,1171,638,T2
4490,September 25,2014,Indonesia,Cambodia,1,0,Friendly,in Indonesia,0,0,1240,672,0,0,147,222,1240,672,T1
4491,October 6,2014,Palestine,India,3,2,Friendly,in India,7,-7,1293,1069,2,-1,133,181,1286,1076,T2
4492,October 6,2014,Uzbekistan,Qatar,0,3,Friendly,in Qatar,-20,20,1611,1500,-3,6,57,85,1631,1480,T1
4493,October 8,2014,Saint Lucia,Antigua and Barbuda,1,2,CONCACAF Champ &amp; Carib Champ qual,in Trinidad and Tobago,-13,13,1154,1306,-4,2,171,131,1167,1293,T1
4494,October 8,2014,Barbados,Saint Kitts and Nevis,3,2,CONCACAF Champ &amp; Carib Champ qual,in Haiti,22,-22,1177,1164,10,-7,161,168,1155,1186,T1
4495,October 8,2014,Curaçao,Martinique,1,1,CONCACAF Champ &amp; Carib Champ qual,in Guadeloupe,16,-16,1072,1407,5,-3,181,111,1056,1423,draw
4496,October 8,2014,Guadeloupe,Saint Vincent and the Grenadines,3,1,CONCACAF Champ &amp; Carib Champ qual,in Guadeloupe,9,-9,1388,1165,1,-4,114,167,1379,1174,T1
4497,October 8,2014,French Guiana,Haiti,2,2,CONCACAF Champ &amp; Carib Champ qual,in Haiti,14,-14,1259,1418,2,-4,142,108,1245,1432,draw
4498,October 8,2014,Taiwan,Cambodia,0,2,Friendly,in Taiwan,-25,25,811,697,-1,7,208,215,836,672,T2
4499,October 8,2014,Dominican Republic,Trinidad and Tobago,1,6,CONCACAF Champ &amp; Carib Champ qual,in Trinidad and Tobago,-9,9,1216,1502,-1,3,154,85,1225,1493,T1
4500,October 9,2014,Ukraine,Belarus,2,0,European Championship qualifier,in Belarus,20,-20,1826,1563,1,-6,18,69,1806,1583,T2
4501,October 9,2014,England,San Marino,5,0,European Championship qualifier,in England,0,0,1899,873,0,0,10,203,1899,873,T1
4502,October 9,2014,Montenegro,Liechtenstein,0,0,European Championship qualifier,in Liechtenstein,-15,15,1601,1186,-3,4,59,161,1616,1171,draw
4503,October 9,2014,Estonia,Lithuania,0,1,European Championship qualifier,in Lithuania,-15,15,1465,1490,-4,4,96,89,1480,1475,T1
4504,October 9,2014,Macedonia,Luxembourg,3,2,European Championship qualifier,in Macedonia,4,-4,1504,1231,1,-2,85,150,1500,1235,T1
4505,October 9,2014,Mexico,Honduras,2,0,Friendly,in Mexico,2,-2,1891,1549,1,-2,12,74,1889,1551,T1
4506,October 9,2014,Moldova,Austria,1,2,European Championship qualifier,in Moldova,-13,13,1432,1690,-2,2,103,40,1445,1677,T2
4507,October 9,2014,Central African Republic,Morocco,0,4,Friendly,in Morocco,-4,4,1238,1530,-2,0,147,79,1242,1526,T1
4508,October 9,2014,Qatar,Lebanon,5,0,Friendly,in Qatar,11,-11,1511,1415,2,-3,84,108,1500,1426,T1
4509,October 9,2014,Slovakia,Spain,2,1,European Championship qualifier,in Slovakia,31,-31,1700,1957,6,-2,37,8,1669,1988,T1
4510,October 9,2014,Switzerland,Slovenia,0,1,European Championship qualifier,in Slovenia,-25,25,1785,1642,-4,5,22,50,1810,1617,T1
4511,October 9,2014,Sweden,Russia,1,1,European Championship qualifier,in Sweden,-5,5,1791,1806,1,1,21,19,1796,1801,draw
4512,October 10,2014,Antigua and Barbuda,Dominican Republic,0,0,CONCACAF Champ &amp; Carib Champ qual,in Trinidad and Tobago,-5,5,1301,1221,0,1,131,153,1306,1216,draw
4513,October 10,2014,Uzbekistan,Bahrain,0,0,Friendly,in the United Arab Emirates,-4,4,1607,1472,-4,1,60,93,1611,1468,draw
4514,October 10,2014,Andorra,Belgium,0,6,European Championship qualifier,in Belgium,0,0,983,1916,0,0,189,9,983,1916,T1
4515,October 10,2014,Egypt,Botswana,2,0,African Nations Cup qualifier,in Botswana,13,-13,1657,1311,3,-1,46,129,1644,1324,T2
4516,October 10,2014,Bulgaria,Croatia,0,1,European Championship qualifier,in Bulgaria,-18,18,1640,1816,-6,1,52,19,1658,1798,T2
4517,October 10,2014,Chile,Peru,3,0,Friendly,in Chile,4,-4,1983,1728,0,0,6,29,1979,1732,T1
4518,October 10,2014,China,Thailand,3,0,Friendly,in China,4,-4,1554,1294,3,-1,70,133,1550,1298,T1
4519,October 10,2014,Colombia,El Salvador,3,0,Friendly,in the United States,2,-2,2010,1519,0,-1,4,81,2008,1521,T1
4520,October 10,2014,Israel,Cyprus,2,1,European Championship qualifier,in Cyprus,14,-14,1647,1408,5,-5,48,111,1633,1422,T2
4521,October 10,2014,Martinique,Guadeloupe,2,1,CONCACAF Champ &amp; Carib Champ qual,in Guadeloupe,25,-25,1432,1363,8,-4,103,118,1407,1388,T2
4522,October 10,2014,Haiti,Barbados,4,2,CONCACAF Champ &amp; Carib Champ qual,in Haiti,7,-7,1425,1170,1,-5,106,167,1418,1177,T1
4523,October 10,2014,Singapore,Hong Kong,1,2,Friendly,in Hong Kong,-10,10,1232,1166,-3,1,148,169,1242,1156,T1
4524,October 10,2014,Yemen,Iraq,1,1,Friendly,in Bahrain,8,-8,1170,1553,2,-1,167,71,1162,1561,draw
4525,October 10,2014,Italy,Azerbaijan,2,1,European Championship qualifier,in Italy,2,-2,1892,1426,2,-1,11,105,1890,1428,T1
4526,October 10,2014,Japan,Jamaica,1,0,Friendly,in Japan,3,-3,1721,1509,1,-1,30,84,1718,1512,T1
4527,October 10,2014,Jordan,Kuwait,0,1,Friendly,in Jordan,-14,14,1559,1530,-4,2,69,79,1573,1516,T2
4528,October 10,2014,Latvia,Iceland,0,3,European Championship qualifier,in Latvia,-34,34,1439,1620,-9,6,102,56,1473,1586,T2
4529,October 10,2014,Lesotho,Angola,0,0,African Nations Cup qualifier,in Lesotho,3,-3,1271,1411,0,-1,139,110,1268,1414,draw
4530,October 10,2014,Norway,Malta,3,0,European Championship qualifier,in Malta,13,-13,1612,1222,3,-4,57,152,1599,1235,T2
4531,October 10,2014,Netherlands,Kazakhstan,3,1,European Championship qualifier,in the Netherlands,1,-1,2098,1367,0,1,2,117,2097,1368,T1
4532,October 10,2014,Costa Rica,Oman,4,3,Friendly,in Oman,6,-6,1852,1575,1,-2,15,65,1846,1581,T2
4533,October 10,2014,Uruguay,Saudi Arabia,1,1,Friendly,in Saudi Arabia,-7,7,1892,1494,-1,2,11,88,1899,1487,draw
4534,October 10,2014,Tunisia,Senegal,0,0,African Nations Cup qualifier,in Senegal,9,-9,1579,1624,2,-2,64,55,1570,1633,draw
4535,October 10,2014,South Korea,Paraguay,2,0,Friendly,in South Korea,14,-14,1639,1694,2,-2,53,38,1625,1708,T1
4536,October 10,2014,Saint Kitts and Nevis,French Guiana,2,1,CONCACAF Champ &amp; Carib Champ qual,in Haiti,25,-25,1189,1234,7,-4,161,146,1164,1259,T1
4537,October 10,2014,Saint Vincent and the Grenadines,Curaçao,1,0,CONCACAF Champ &amp; Carib Champ qual,in Guadeloupe,15,-15,1180,1057,4,-5,163,186,1165,1072,T1
4538,October 10,2014,Saint Lucia,Trinidad and Tobago,0,2,CONCACAF Champ &amp; Carib Champ qual,in Trinidad and Tobago,-4,4,1150,1506,0,2,171,85,1154,1502,T1
4539,October 10,2014,Czechia,Turkey,2,1,European Championship qualifier,in Turkey,23,-23,1788,1695,3,-6,22,37,1765,1718,T2
4540,October 10,2014,United Arab Emirates,Australia,0,0,Friendly,in the United Arab Emirates,-2,2,1646,1669,-1,0,49,44,1648,1667,draw
4541,October 10,2014,United States,Ecuador,1,1,Friendly,in the United States,-3,3,1845,1842,-1,0,16,17,1848,1839,draw
4542,October 10,2014,Wales,Bosnia and Herzegovina,0,0,European Championship qualifier,in Wales,3,-3,1598,1742,-1,0,62,28,1595,1745,draw
4543,October 11,2014,Denmark,Albania,1,1,European Championship qualifier,in Albania,-5,5,1743,1557,0,2,26,70,1748,1552,draw
4544,October 11,2014,Armenia,Serbia,1,1,European Championship qualifier,in Armenia,7,-7,1558,1763,4,0,69,25,1551,1770,draw
4545,October 11,2014,Brazil,Argentina,2,0,Friendly tournament,in China,28,-28,2025,2060,1,0,4,3,1997,2088,T1
4546,October 11,2014,Cameroon,Sierra Leone,0,0,African Nations Cup qualifier,in Cameroon,-16,16,1626,1365,-5,4,55,119,1642,1349,draw
4547,October 11,2014,South Africa,Congo,2,0,African Nations Cup qualifier,in Congo,24,-24,1635,1419,4,-7,54,107,1611,1443,T2
4548,October 11,2014,Ivory Coast,Democratic Republic of Congo,2,1,African Nations Cup qualifier,in the Democratic Republic of the Congo,11,-11,1730,1430,2,-2,29,103,1719,1441,T2
4549,October 11,2014,Mali,Ethiopia,2,0,African Nations Cup qualifier,in Ethiopia,21,-21,1585,1330,4,-4,63,126,1564,1351,T2
4550,October 11,2014,Greece,Finland,1,1,European Championship qualifier,in Finland,0,0,1785,1678,0,0,23,43,1785,1678,draw
4551,October 11,2014,France,Portugal,2,1,Friendly,in France,5,-5,1967,1876,0,0,7,14,1962,1881,T1
4552,October 11,2014,Burkina Faso,Gabon,0,2,African Nations Cup qualifier,in Gabon,-29,29,1551,1515,-10,10,73,81,1580,1486,T1
4553,October 11,2014,Ghana,Guinea,1,1,African Nations Cup qualifier,in Morocco,-9,9,1691,1540,-5,2,40,76,1700,1531,draw
4554,October 11,2014,Ireland,Gibraltar,7,0,European Championship qualifier,in Ireland,2,-2,1712,1140,-1,0,34,172,1710,1142,T1
4555,October 11,2014,Malawi,Algeria,0,2,African Nations Cup qualifier,in Malawi,-11,11,1315,1705,-1,2,128,36,1326,1694,T2
4556,October 11,2014,Mozambique,Cape Verde,2,0,African Nations Cup qualifier,in Mozambique,36,-36,1408,1503,5,-10,111,86,1372,1539,T1
4557,October 11,2014,Niger,Zambia,0,0,African Nations Cup qualifier,in Niger,4,-4,1302,1464,1,-2,131,96,1298,1468,draw
4558,October 11,2014,Faroe Islands,Northern Ireland,0,2,European Championship qualifier,in Northern Ireland,-7,7,1191,1454,-2,0,160,99,1198,1447,T1
4559,October 11,2014,Poland,Germany,2,0,European Championship qualifier,in Poland,56,-56,1708,2144,12,0,35,1,1652,2200,T1
4560,October 11,2014,Romania,Hungary,1,1,European Championship qualifier,in Romania,-11,11,1735,1650,-1,5,28,48,1746,1639,draw
4561,October 11,2014,Scotland,Georgia,1,0,European Championship qualifier,in Scotland,6,-6,1715,1488,2,-2,32,90,1709,1494,T1
4562,October 11,2014,Nigeria,Sudan,0,1,African Nations Cup qualifier,in Sudan,-32,32,1658,1369,-6,7,46,117,1690,1337,T1
4563,October 11,2014,Uganda,Togo,0,1,African Nations Cup qualifier,in Uganda,-29,29,1485,1480,-9,5,91,93,1514,1451,T2
4564,October 12,2014,Montenegro,Austria,0,1,European Championship qualifier,in Austria,-10,10,1591,1700,-1,3,62,38,1601,1690,T1
4565,October 12,2014,Belarus,Slovakia,1,3,European Championship qualifier,in Belarus,-27,27,1536,1727,-9,6,76,31,1563,1700,T2
4566,October 12,2014,Saint Lucia,Dominican Republic,2,3,CONCACAF Champ &amp; Carib Champ qual,in Trinidad and Tobago,-16,16,1134,1237,-3,6,174,147,1150,1221,T1
4567,October 12,2014,Brunei,East Timor,2,4,Southeast Asian Championship qualifier,in Laos,-35,35,635,650,-1,5,224,223,670,615,T1
4568,October 12,2014,Estonia,England,0,1,European Championship qualifier,in Estonia,-5,5,1460,1904,-1,0,96,10,1465,1899,T2
4569,October 12,2014,French Guiana,Barbados,2,0,CONCACAF Champ &amp; Carib Champ qual,in Haiti,25,-25,1259,1145,4,-3,142,170,1234,1170,T1
4570,October 12,2014,Guadeloupe,Curaçao,0,1,CONCACAF Champ &amp; Carib Champ qual,in Guadeloupe,-36,36,1327,1093,-6,7,126,179,1363,1057,T2
4571,October 12,2014,Saint Kitts and Nevis,Haiti,0,0,CONCACAF Champ &amp; Carib Champ qual,in Haiti,15,-15,1204,1410,5,-5,156,110,1189,1425,draw
4572,October 12,2014,Laos,Cambodia,3,2,Southeast Asian Championship qualifier,in Laos,8,-8,859,689,0,-1,206,216,851,697,T1
4573,October 12,2014,Slovenia,Lithuania,2,0,European Championship qualifier,in Lithuania,26,-26,1668,1464,6,-5,45,94,1642,1490,T2
4574,October 12,2014,Spain,Luxembourg,4,0,European Championship qualifier,in Luxembourg,2,-2,1959,1229,0,-1,8,150,1957,1231,T2
4575,October 12,2014,Martinique,Saint Vincent and the Grenadines,4,3,CONCACAF Champ &amp; Carib Champ qual,in Guadeloupe,8,-8,1440,1172,0,-2,101,165,1432,1180,T1
4576,October 12,2014,Panama,Mexico,0,1,Friendly,in Mexico,-3,3,1710,1894,-2,2,35,11,1713,1891,T1
4577,October 12,2014,Pakistan,Palestine,0,2,Friendly,in Pakistan,-6,6,932,1299,-1,2,197,132,938,1293,T2
4578,October 12,2014,Papua New Guinea,Philippines,0,5,Friendly,in the Philippines,-8,8,1054,1219,-2,0,186,155,1062,1211,T1
4579,October 12,2014,Russia,Moldova,1,1,European Championship qualifier,in Russia,-18,18,1788,1450,-1,1,21,100,1806,1432,draw
4580,October 12,2014,Sweden,Liechtenstein,2,0,European Championship qualifier,in Sweden,1,-1,1792,1185,1,0,20,162,1791,1186,T1
4581,October 12,2014,Benin,Tanzania,1,4,Friendly,in Tanzania,-16,16,1380,1350,-2,1,115,123,1396,1334,T1
4582,October 12,2014,Trinidad and Tobago,Antigua and Barbuda,1,0,CONCACAF Champ &amp; Carib Champ qual,in Trinidad and Tobago,6,-6,1512,1295,2,-1,82,133,1506,1301,T1
4583,October 12,2014,Macedonia,Ukraine,0,1,European Championship qualifier,in Ukraine,-3,3,1501,1829,-2,0,87,18,1504,1826,T1
4584,October 13,2014,Andorra,Israel,1,4,European Championship qualifier,in Andorra,-3,3,980,1650,0,0,189,50,983,1647,T2
4585,October 13,2014,Bosnia and Herzegovina,Belgium,1,1,European Championship qualifier,in Bosnia and Herzegovina,4,-4,1746,1912,1,0,26,9,1742,1916,draw
4586,October 13,2014,Azerbaijan,Croatia,0,6,European Championship qualifier,in Croatia,-5,5,1421,1821,-1,0,105,19,1426,1816,T1
4587,October 13,2014,Iceland,Netherlands,2,0,European Championship qualifier,in Iceland,54,-54,1674,2044,13,-1,44,3,1620,2098,T1
4588,October 13,2014,Kuwait,Jordan,1,1,Friendly,in Jordan,4,-4,1534,1555,-1,-2,79,69,1530,1559,draw
4589,October 13,2014,Czechia,Kazakhstan,4,2,European Championship qualifier,in Kazakhstan,8,-8,1796,1359,1,-3,20,121,1788,1367,T2
4590,October 13,2014,Turkey,Latvia,1,1,European Championship qualifier,in Latvia,-8,8,1687,1447,-2,1,41,101,1695,1439,draw
4591,October 13,2014,Malta,Italy,0,1,European Championship qualifier,in Malta,-1,1,1221,1893,0,-1,153,13,1222,1892,T2
4592,October 13,2014,Morocco,Kenya,3,0,Friendly,in Morocco,7,-7,1537,1374,2,-2,76,116,1530,1381,T1
4593,October 13,2014,Bulgaria,Norway,1,2,European Championship qualifier,in Norway,-16,16,1624,1628,-5,3,57,55,1640,1612,T1
4594,October 13,2014,Uruguay,Oman,3,0,Friendly,in Oman,8,-8,1900,1567,1,0,11,65,1892,1575,T2
4595,October 13,2014,Wales,Cyprus,2,1,European Championship qualifier,in Wales,6,-6,1604,1402,0,-1,61,112,1598,1408,T1
4596,October 14,2014,Armenia,France,0,3,Friendly,in Armenia,-5,5,1553,1972,-5,0,72,7,1558,1967,T2
4597,October 14,2014,Iraq,Bahrain,0,0,Friendly,in Bahrain,1,-1,1554,1471,0,-1,71,94,1553,1472,draw
4598,October 14,2014,Brazil,Japan,4,0,Friendly,in Singapore,6,-6,2031,1715,0,-2,4,34,2025,1721,T1
4599,October 14,2014,Chile,Bolivia,2,2,Friendly,in Chile,-9,9,1974,1619,0,-1,6,60,1983,1610,draw
4600,October 14,2014,Paraguay,China,1,2,Friendly,in China,-11,11,1683,1565,-3,2,42,68,1694,1554,T1
4601,October 14,2014,Colombia,Canada,1,0,Friendly,in the United States,1,-1,2011,1502,0,-2,5,87,2010,1503,T1
4602,October 14,2014,Denmark,Portugal,0,1,European Championship qualifier,in Denmark,-18,18,1725,1894,-5,2,32,12,1743,1876,T2
4603,October 14,2014,East Timor,Myanmar,0,0,Southeast Asian Championship qualifier,in Laos,17,-17,667,1056,0,-4,223,185,650,1073,draw
4604,October 14,2014,El Salvador,Ecuador,1,5,Friendly,in the United States,-5,5,1514,1847,-2,1,82,16,1519,1842,T1
4605,October 14,2014,Faroe Islands,Hungary,0,1,European Championship qualifier,in the Faroe Islands,-4,4,1187,1654,0,1,161,49,1191,1650,T2
4606,October 14,2014,Finland,Romania,0,2,European Championship qualifier,in Finland,-34,34,1644,1769,-8,4,51,24,1678,1735,T2
4607,October 14,2014,Georgia,Gibraltar,3,0,European Championship qualifier,in Portugal,8,-8,1496,1132,0,-3,89,174,1488,1140,T1
4608,October 14,2014,Germany,Ireland,1,1,European Championship qualifier,in Germany,-18,18,2126,1730,0,6,1,28,2144,1712,draw
4609,October 14,2014,Northern Ireland,Greece,2,0,European Championship qualifier,in Greece,55,-55,1509,1730,15,-5,84,28,1454,1785,T2
4610,October 14,2014,Hong Kong,Argentina,0,7,Friendly,in Hong Kong,0,0,1166,2060,0,0,168,2,1166,2060,T2
4611,October 14,2014,Brunei,Laos,2,4,Southeast Asian Championship qualifier,in Laos,-8,8,627,867,-3,1,227,205,635,859,T1
4612,October 14,2014,Singapore,Macao,2,2,Friendly,in Macao,-9,9,1223,637,-3,3,152,224,1232,628,draw
4613,October 14,2014,Peru,Guatemala,1,0,Friendly,in Peru,3,-3,1731,1540,3,0,27,74,1728,1543,T1
4614,October 14,2014,Scotland,Poland,2,2,European Championship qualifier,in Poland,5,-5,1720,1703,0,-1,33,37,1715,1708,draw
4615,October 14,2014,Qatar,Australia,1,0,Friendly,in Qatar,12,-12,1523,1657,3,-2,80,47,1511,1669,T1
4616,October 14,2014,San Marino,Switzerland,0,4,European Championship qualifier,in San Marino,-1,1,872,1786,0,0,203,23,873,1785,T2
4617,October 14,2014,Saudi Arabia,Lebanon,1,1,Friendly,in Saudi Arabia,-5,5,1489,1420,-2,1,90,106,1494,1415,draw
4618,October 14,2014,Serbia,Albania,0,0,European Championship qualifier,in Serbia,-14,14,1749,1571,0,3,25,65,1763,1557,draw
4619,October 14,2014,South Korea,Costa Rica,1,3,Friendly,in South Korea,-10,10,1629,1862,-1,0,54,15,1639,1852,T2
4620,October 14,2014,United Arab Emirates,Uzbekistan,0,4,Friendly,in the United Arab Emirates,-26,26,1620,1633,-7,7,59,53,1646,1607,T2
4621,October 14,2014,United States,Honduras,1,1,Friendly,in the United States,-8,8,1837,1557,-1,4,17,69,1845,1549,draw
4622,October 15,2014,Algeria,Malawi,3,0,African Nations Cup qualifier,in Algeria,4,-4,1709,1311,1,0,35,128,1705,1315,T1
4623,October 15,2014,Lesotho,Angola,0,4,African Nations Cup qualifier,in Angola,-15,15,1256,1426,-3,4,142,105,1271,1411,T1
4624,October 15,2014,Burkina Faso,Gabon,1,1,African Nations Cup qualifier,in Burkina Faso,-7,7,1544,1522,0,0,73,81,1551,1515,draw
4625,October 15,2014,Sierra Leone,Cameroon,0,2,African Nations Cup qualifier,in Cameroon,-7,7,1358,1633,-4,4,122,52,1365,1626,T1
4626,October 15,2014,Mozambique,Cape Verde,0,1,African Nations Cup qualifier,in Cape Verde,-10,10,1398,1513,-1,3,112,83,1408,1503,T1
4627,October 15,2014,Botswana,Egypt,0,2,African Nations Cup qualifier,in Egypt,-4,4,1307,1661,-1,0,130,47,1311,1657,T1
4628,October 15,2014,Ghana,Guinea,3,1,African Nations Cup qualifier,in Ghana,11,-11,1702,1529,2,-5,37,79,1691,1540,T1
4629,October 15,2014,Democratic Republic of Congo,Ivory Coast,4,3,African Nations Cup qualifier,in Ivory Coast,36,-36,1466,1694,7,-11,96,39,1430,1730,T2
4630,October 15,2014,Ethiopia,Mali,3,2,African Nations Cup qualifier,in Mali,35,-35,1365,1550,8,-9,117,72,1330,1585,T2
4631,October 15,2014,Sudan,Nigeria,1,3,African Nations Cup qualifier,in Nigeria,-6,6,1363,1664,-1,0,118,46,1369,1658,T1
4632,October 15,2014,Congo,South Africa,0,0,African Nations Cup qualifier,in South Africa,14,-14,1433,1621,3,-5,104,57,1419,1635,draw
4633,October 15,2014,Uganda,Togo,0,1,African Nations Cup qualifier,in Togo,-15,15,1470,1495,-4,3,95,90,1485,1480,T1
4634,October 15,2014,Senegal,Tunisia,0,1,African Nations Cup qualifier,in Tunisia,-17,17,1607,1596,-3,2,60,62,1624,1579,T1
4635,October 15,2014,Zambia,Niger,3,0,African Nations Cup qualifier,in Zambia,13,-13,1477,1289,2,-4,93,135,1464,1302,T1
4636,October 16,2014,East Timor,Cambodia,2,3,Southeast Asian Championship qualifier,in Laos,-19,19,648,708,0,2,223,214,667,689,T1
4637,October 16,2014,Myanmar,Brunei,3,1,Southeast Asian Championship qualifier,in Laos,5,-5,1061,622,1,0,184,227,1056,627,T1
4638,October 18,2014,Laos,East Timor,2,0,Southeast Asian Championship qualifier,in Laos,8,-8,875,640,2,0,203,223,867,648,T1
4639,October 18,2014,Myanmar,Cambodia,1,0,Southeast Asian Championship qualifier,in Laos,5,-5,1066,703,2,0,182,214,1061,708,T1
4640,October 20,2014,Cambodia,Brunei,1,0,Southeast Asian Championship qualifier,in Laos,15,-15,718,607,0,-1,214,228,703,622,T1
4641,October 20,2014,Myanmar,Laos,2,1,Southeast Asian Championship qualifier,in Laos,15,-15,1081,860,2,-2,180,205,1066,875,T2
4642,October 24,2014,Bangladesh,Sri Lanka,1,1,Friendly,in Bangladesh,-5,5,944,841,-2,0,195,207,949,836,draw
4643,October 27,2014,Sri Lanka,Bangladesh,0,1,Friendly,in Bangladesh,-5,5,836,949,0,2,207,193,841,944,T1
4644,October 31,2014,Chagos Islands,Somaliland,1,1,Friendly tournament,in England,8,-8,808,992,0,0,210,189,800,1000,draw
4645,October 31,2014,Kuwait,North Korea,1,0,Friendly,in the United Arab Emirates,11,-11,1545,1555,5,-2,73,68,1534,1566,T1
4646,October 31,2014,Philippines,Nepal,3,0,Friendly,in Qatar,5,-5,1224,885,3,-1,152,203,1219,890,T1
4647,November 2,2014,Bahrain,North Korea,2,2,Friendly,in Bahrain,0,0,1471,1555,0,0,94,68,1471,1555,draw
4648,November 4,2014,Yemen,Kuwait,1,1,Friendly,in the United Arab Emirates,8,-8,1178,1537,4,-2,163,75,1170,1545,draw
4649,November 6,2014,North Korea,Qatar,1,3,Friendly,in Qatar,-12,12,1543,1535,-5,1,73,79,1555,1523,T1
4650,November 6,2014,Saudi Arabia,Palestine,2,0,Friendly,in Saudi Arabia,5,-5,1494,1294,0,-1,91,132,1489,1299,T1
4651,November 6,2014,Lebanon,United Arab Emirates,2,3,Friendly,in Saudi Arabia,-5,5,1415,1625,0,2,108,56,1420,1620,T1
4652,November 7,2014,Singapore,Bahrain,0,2,Friendly,in Bahrain,-4,4,1219,1475,-2,0,155,94,1223,1471,T1
4653,November 7,2014,Oman,Yemen,2,0,Friendly,in Oman,2,-2,1569,1176,0,0,65,163,1567,1178,T1
4654,November 9,2014,Thailand,Philippines,3,0,Friendly,in Thailand,10,-10,1304,1214,0,-3,132,155,1294,1224,T1
4655,November 9,2014,Ethiopia,Uganda,0,3,Friendly,in Uganda,-8,8,1357,1478,-6,2,123,93,1365,1470,T1
4656,November 9,2014,Vietnam,Palestine,1,3,Friendly,in Vietnam,-17,17,1233,1311,-5,4,148,128,1250,1294,T2
4657,November 11,2014,Cuba,French Guiana,1,1,CONCACAF Champ qual &amp; Carib Champ,in Jamaica,-8,8,1404,1267,-1,2,110,139,1412,1259,draw
4658,November 11,2014,East Timor,Indonesia,0,4,Friendly,in Indonesia,-1,1,639,1241,0,0,225,144,640,1240,T1
4659,November 11,2014,Curaçao,Trinidad and Tobago,2,3,CONCACAF Champ qual &amp; Carib Champ,in Jamaica,-3,3,1090,1515,0,2,179,82,1093,1512,T1
4660,November 12,2014,Antigua and Barbuda,Haiti,2,2,CONCACAF Champ qual &amp; Carib Champ,in Jamaica,6,-6,1301,1404,0,0,133,109,1295,1410,draw
4661,November 12,2014,Argentina,Croatia,2,1,Friendly,in England,4,-4,2064,1817,0,0,2,19,2060,1821,T1
4662,November 12,2014,Belgium,Iceland,3,1,Friendly,in Belgium,4,-4,1916,1670,0,0,9,43,1912,1674,T1
4663,November 12,2014,Martinique,Jamaica,1,1,CONCACAF Champ qual &amp; Carib Champ,in Jamaica,9,-9,1449,1500,1,-3,102,88,1440,1509,draw
4664,November 12,2014,Syria,Malaysia,3,0,Friendly,in Malaysia,9,-9,1467,1163,2,-3,97,169,1458,1172,T2
4665,November 12,2014,Mexico,Netherlands,3,2,Friendly,in the Netherlands,16,-16,1910,2028,2,-1,10,4,1894,2044,T2
4666,November 12,2014,Estonia,Norway,1,0,Friendly,in Norway,16,-16,1476,1612,3,-4,95,59,1460,1628,T2
4667,November 12,2014,Turkey,Brazil,0,4,Friendly,in Turkey,-7,7,1680,2038,-2,1,42,3,1687,2031,T2
4668,November 13,2014,Yemen,Bahrain,0,0,Gulf Cup,in Saudi Arabia,14,-14,1190,1461,2,-3,161,99,1176,1475,draw
4669,November 13,2014,Cuba,Curaçao,3,2,CONCACAF Champ qual &amp; Carib Champ,in Jamaica,6,-6,1410,1084,0,0,109,179,1404,1090,T1
4670,November 13,2014,Morocco,Benin,6,1,Friendly,in Morocco,7,-7,1544,1373,2,-2,73,116,1537,1380,T1
4671,November 13,2014,Hong Kong,North Korea,1,2,East Asian Cup qualifier,in Taiwan,-4,4,1162,1547,-2,1,169,72,1166,1543,T1
4672,November 13,2014,Qatar,Saudi Arabia,1,1,Gulf Cup,in Saudi Arabia,3,-3,1538,1491,3,0,76,91,1535,1494,draw
4673,November 13,2014,Laos,Singapore,0,2,Friendly,in Singapore,-2,2,858,1221,-1,2,207,152,860,1219,T1
4674,November 13,2014,Taiwan,Guam,1,2,East Asian Cup qualifier,in Taiwan,-28,28,783,791,-3,3,212,210,811,763,T2
4675,November 13,2014,French Guiana,Trinidad and Tobago,2,4,CONCACAF Champ qual &amp; Carib Champ,in Jamaica,-12,12,1255,1527,-3,1,142,81,1267,1515,T1
4676,November 13,2014,Uruguay,Costa Rica,3,3,Friendly tournament,in Uruguay,-6,6,1894,1868,0,0,12,15,1900,1862,draw
4677,November 14,2014,Botswana,Tunisia,0,0,African Nations Cup qualifier,in Botswana,10,-10,1317,1586,3,-1,128,63,1307,1596,draw
4678,November 14,2014,Chile,Venezuela,5,0,Friendly,in Chile,4,-4,1978,1683,0,-1,6,41,1974,1687,T1
4679,November 14,2014,China,New Zealand,1,1,Friendly,in China,-4,4,1561,1540,0,3,66,75,1565,1536,draw
4680,November 14,2014,Colombia,United States,2,1,Friendly,in England,5,-5,2016,1832,0,0,5,17,2011,1837,T1
4681,November 14,2014,Panama,El Salvador,3,1,Friendly,in El Salvador,11,-11,1721,1503,2,-2,32,85,1710,1514,T2
4682,November 14,2014,Albania,France,1,1,Friendly,in France,9,-9,1580,1963,0,0,64,7,1571,1972,draw
4683,November 14,2014,Georgia,Poland,0,4,European Championship qualifier,in Georgia,-26,26,1470,1729,-6,8,95,28,1496,1703,T2
4684,November 14,2014,Germany,Gibraltar,4,0,European Championship qualifier,in Germany,0,0,2126,1132,0,0,1,174,2126,1132,T1
4685,November 14,2014,Faroe Islands,Greece,1,0,European Championship qualifier,in Greece,39,-39,1226,1691,12,-12,150,40,1187,1730,T2
4686,November 14,2014,Haiti,Martinique,3,0,CONCACAF Champ qual &amp; Carib Champ,in Jamaica,40,-40,1444,1409,7,-8,103,110,1404,1449,T1
4687,November 14,2014,Finland,Hungary,0,1,European Championship qualifier,in Hungary,-14,14,1630,1668,-3,5,54,44,1644,1654,T1
4688,November 14,2014,Sierra Leone,Ivory Coast,1,5,African Nations Cup qualifier,in Ivory Coast,-6,6,1352,1700,-2,2,123,37,1358,1694,T1
4689,November 14,2014,Antigua and Barbuda,Jamaica,0,3,CONCACAF Champ qual &amp; Carib Champ,in Jamaica,-11,11,1290,1511,-1,4,134,84,1301,1500,T1
4690,November 14,2014,Japan,Honduras,6,0,Friendly,in Japan,8,-8,1723,1549,3,-3,30,70,1715,1557,T1
4691,November 14,2014,Jordan,South Korea,0,1,Friendly,in Jordan,-11,11,1544,1640,-4,3,72,51,1555,1629,T2
4692,November 14,2014,Iraq,Kuwait,0,1,Gulf Cup,in Saudi Arabia,-21,21,1533,1558,-10,10,79,67,1554,1537,T1
4693,November 14,2014,Oman,United Arab Emirates,0,0,Gulf Cup,in Saudi Arabia,3,-3,1572,1622,0,-1,65,56,1569,1625,draw
4694,November 14,2014,Paraguay,Peru,2,1,Friendly,in Paraguay,9,-9,1692,1722,2,-4,39,31,1683,1731,T1
4695,November 14,2014,Philippines,Cambodia,3,0,Friendly,in the Philippines,1,-1,1215,717,-1,0,156,216,1214,718,T1
4696,November 14,2014,Portugal,Armenia,1,0,European Championship qualifier,in Portugal,3,-3,1897,1550,0,2,12,68,1894,1553,T1
4697,November 14,2014,Northern Ireland,Romania,0,2,European Championship qualifier,in Romania,-7,7,1502,1776,-1,0,86,24,1509,1769,T1
4698,November 14,2014,Ireland,Scotland,0,1,European Championship qualifier,in Scotland,-15,15,1715,1735,-5,5,33,27,1730,1720,T1
4699,November 14,2014,Denmark,Serbia,3,1,European Championship qualifier,in Serbia,40,-40,1765,1709,6,-9,25,34,1725,1749,T2
4700,November 15,2014,Ethiopia,Algeria,1,3,African Nations Cup qualifier,in Algeria,-4,4,1353,1713,0,-1,122,35,1357,1709,T1
4701,November 15,2014,Gabon,Angola,0,0,African Nations Cup qualifier,in Angola,0,0,1522,1426,2,2,80,103,1522,1426,draw
4702,November 15,2014,Austria,Russia,1,0,European Championship qualifier,in Austria,19,-19,1719,1769,4,-2,33,24,1700,1788,T1
4703,November 15,2014,Democratic Republic of Congo,Cameroon,0,1,African Nations Cup qualifier,in Cameroon,-7,7,1459,1640,1,2,96,50,1466,1633,T1
4704,November 15,2014,Niger,Cape Verde,1,3,African Nations Cup qualifier,in Cape Verde,-8,8,1281,1521,-1,2,136,81,1289,1513,T1
4705,November 15,2014,Congo,Nigeria,0,2,African Nations Cup qualifier,in Congo,-19,19,1414,1683,-4,7,108,40,1433,1664,T2
4706,November 15,2014,Trinidad and Tobago,Cuba,0,0,CONCACAF Champ qual &amp; Carib Champ,in Jamaica,-6,6,1521,1416,0,3,81,106,1527,1410,draw
4707,November 15,2014,Egypt,Senegal,0,1,African Nations Cup qualifier,in Egypt,-28,28,1633,1635,-5,8,53,52,1661,1607,T2
4708,November 15,2014,Slovenia,England,1,3,European Championship qualifier,in England,-8,8,1660,1912,-3,1,47,10,1668,1904,T1
4709,November 15,2014,Curaçao,French Guiana,1,4,CONCACAF Champ qual &amp; Carib Champ,in Jamaica,-19,19,1065,1274,-3,3,182,139,1084,1255,T1
4710,November 15,2014,Indonesia,Syria,0,2,Friendly,in Indonesia,-10,10,1231,1477,-4,3,148,93,1241,1467,T2
4711,November 15,2014,Burkina Faso,Lesotho,1,0,African Nations Cup qualifier,in Lesotho,10,-10,1554,1246,3,-2,69,143,1544,1256,T2
4712,November 15,2014,Ukraine,Luxembourg,3,0,European Championship qualifier,in Luxembourg,4,-4,1833,1225,1,-3,17,152,1829,1229,T2
4713,November 15,2014,Macedonia,Slovakia,0,2,European Championship qualifier,in Macedonia,-20,20,1481,1747,-4,3,92,26,1501,1727,T2
4714,November 15,2014,Malawi,Mali,2,0,African Nations Cup qualifier,in Malawi,41,-41,1352,1509,6,-16,123,84,1311,1550,T1
4715,November 15,2014,Moldova,Liechtenstein,0,1,European Championship qualifier,in Moldova,-36,36,1414,1221,-7,10,108,153,1450,1185,T2
4716,November 15,2014,Montenegro,Sweden,1,1,European Championship qualifier,in Montenegro,6,-6,1597,1786,0,-1,62,22,1591,1792,draw
4717,November 15,2014,Mozambique,Zambia,0,1,African Nations Cup qualifier,in Mozambique,-21,21,1377,1498,-1,4,113,89,1398,1477,T2
4718,November 15,2014,Estonia,San Marino,0,0,European Championship qualifier,in San Marino,-18,18,1458,890,-3,1,97,203,1476,872,draw
4719,November 15,2014,South Africa,Sudan,2,1,African Nations Cup qualifier,in South Africa,5,-5,1626,1358,1,-3,56,120,1621,1363,T1
4720,November 15,2014,Belarus,Spain,0,3,European Championship qualifier,in Spain,-3,3,1533,1962,0,0,78,8,1536,1959,T1
4721,November 15,2014,Switzerland,Lithuania,4,0,European Championship qualifier,in Switzerland,6,-6,1792,1458,2,1,21,97,1786,1464,T1
4722,November 15,2014,Guinea,Togo,4,1,African Nations Cup qualifier,in Togo,42,-42,1571,1453,14,-11,66,100,1529,1495,T2
4723,November 15,2014,Ghana,Uganda,0,1,African Nations Cup qualifier,in Uganda,-27,27,1675,1505,-7,7,43,85,1702,1478,T1
4724,November 16,2014,Azerbaijan,Norway,0,1,European Championship qualifier,in Azerbaijan,-15,15,1406,1627,-5,4,110,56,1421,1612,T2
4725,November 16,2014,Belgium,Wales,0,0,European Championship qualifier,in Belgium,-17,17,1899,1621,-2,2,11,59,1916,1604,draw
4726,November 16,2014,Bulgaria,Malta,1,1,European Championship qualifier,in Bulgaria,-18,18,1606,1239,-4,8,61,145,1624,1221,draw
4727,November 16,2014,Andorra,Cyprus,0,5,European Championship qualifier,in Cyprus,-4,4,976,1406,-1,1,191,110,980,1402,T1
4728,November 16,2014,Czechia,Iceland,2,1,European Championship qualifier,in Czechia,9,-9,1805,1661,0,-3,20,47,1796,1670,T1
4729,November 16,2014,Israel,Bosnia and Herzegovina,3,0,European Championship qualifier,in Israel,35,-35,1685,1711,9,-8,40,35,1650,1746,T1
4730,November 16,2014,Italy,Croatia,1,1,European Championship qualifier,in Italy,-9,9,1884,1826,0,0,14,19,1893,1817,draw
4731,November 16,2014,Haiti,Jamaica,0,2,CONCACAF Champ qual &amp; Carib Champ,in Jamaica,-17,17,1427,1528,-1,4,103,79,1444,1511,T1
4732,November 16,2014,Martinique,Antigua and Barbuda,2,0,CONCACAF Champ qual &amp; Carib Champ,in Jamaica,20,-20,1429,1270,8,-5,102,139,1409,1290,T1
4733,November 16,2014,Netherlands,Latvia,6,0,European Championship qualifier,in the Netherlands,2,-2,2030,1445,0,1,4,100,2028,1447,T1
4734,November 16,2014,Guam,North Korea,1,5,East Asian Cup qualifier,in Taiwan,-1,1,790,1548,0,0,210,72,791,1547,T1
4735,November 16,2014,Yemen,Qatar,0,0,Gulf Cup,in Saudi Arabia,15,-15,1205,1523,5,-3,158,80,1190,1538,draw
4736,November 16,2014,Bahrain,Saudi Arabia,0,3,Gulf Cup,in Saudi Arabia,-22,22,1439,1513,-6,6,101,84,1461,1491,T1
4737,November 16,2014,Tanzania,Swaziland,1,1,Friendly,in Swaziland,-3,3,1347,1143,0,0,125,171,1350,1140,draw
4738,November 16,2014,Hong Kong,Taiwan,1,0,East Asian Cup qualifier,in Taiwan,7,-7,1169,776,2,-1,167,213,1162,783,T2
4739,November 16,2014,Turkey,Kazakhstan,3,1,European Championship qualifier,in Turkey,5,-5,1685,1354,2,-2,40,121,1680,1359,T1
4740,November 16,2014,Malaysia,Vietnam,1,3,Friendly,in Vietnam,-8,8,1155,1241,-1,3,169,144,1163,1233,T1
4741,November 17,2014,Oman,Iraq,1,1,Gulf Cup,in Saudi Arabia,-2,2,1570,1535,-1,0,66,77,1572,1533,draw
4742,November 17,2014,Kuwait,United Arab Emirates,2,2,Gulf Cup,in Saudi Arabia,4,-4,1562,1618,1,-2,67,60,1558,1622,draw
4743,November 17,2014,Cambodia,Singapore,2,4,Friendly,in Singapore,-1,1,716,1222,0,0,216,154,717,1221,T1
4744,November 18,2014,Brazil,Austria,2,1,Friendly,in Austria,4,-4,2042,1715,0,-1,3,33,2038,1719,T2
4745,November 18,2014,Belarus,Mexico,3,2,Friendly,in Belarus,17,-17,1550,1893,7,-3,71,13,1533,1910,T1
4746,November 18,2014,Bolivia,Venezuela,3,2,Friendly,in Bolivia,9,-9,1628,1674,4,-1,55,43,1619,1683,T1
4747,November 18,2014,Chile,Uruguay,1,2,Friendly,in Chile,-15,15,1963,1909,-1,2,7,11,1978,1894,T2
4748,November 18,2014,China,Honduras,0,0,Friendly,in China,-3,3,1558,1552,0,1,68,70,1561,1549,draw
4749,November 18,2014,Jordan,Estonia,0,1,Friendly,in Estonia,-10,10,1534,1468,-4,1,77,95,1544,1458,T1
4750,November 18,2014,France,Sweden,1,0,Friendly,in France,3,-3,1966,1783,1,-1,6,23,1963,1786,T1
4751,November 18,2014,Serbia,Greece,2,0,Friendly,in Greece,18,-18,1727,1673,5,-5,31,44,1709,1691,T2
4752,November 18,2014,Cuba,Haiti,1,2,Caribbean Championship,in Jamaica,-19,19,1397,1446,-5,3,111,100,1416,1427,T1
4753,November 18,2014,Hungary,Russia,1,2,Friendly,in Hungary,-10,10,1658,1779,-2,0,47,24,1668,1769,T2
4754,November 18,2014,Iran,South Korea,1,0,Friendly,in Iran,7,-7,1673,1633,2,-2,44,52,1666,1640,T1
4755,November 18,2014,United States,Ireland,1,4,Friendly,in Ireland,-18,18,1814,1733,-1,6,19,27,1832,1715,T1
4756,November 18,2014,Albania,Italy,0,1,Friendly,in Italy,-2,2,1578,1886,0,0,64,14,1580,1884,T1
4757,November 18,2014,Jamaica,Trinidad and Tobago,0,0,Caribbean Championship,in Jamaica,-6,6,1522,1527,-1,4,80,78,1528,1521,draw
4758,November 18,2014,Japan,Australia,2,1,Friendly,in Japan,6,-6,1729,1651,1,0,28,49,1723,1657,T1
4759,November 18,2014,Nicaragua,El Salvador,0,2,Friendly,in Nicaragua,-5,5,1104,1508,-1,0,176,87,1109,1503,T2
4760,November 18,2014,Canada,Panama,0,0,Friendly,in Panama,7,-7,1509,1714,3,-3,85,34,1502,1721,draw
4761,November 18,2014,Peru,Paraguay,2,1,Friendly,in Peru,6,-6,1728,1686,1,0,29,38,1722,1692,T1
4762,November 18,2014,Switzerland,Poland,2,2,Friendly,in Poland,1,-1,1793,1728,0,-1,21,29,1792,1729,draw
4763,November 18,2014,Argentina,Portugal,0,1,Friendly,in England,-14,14,2050,1911,0,2,2,10,2064,1897,T1
4764,November 18,2014,Denmark,Romania,0,2,Friendly,in Romania,-10,10,1755,1786,0,1,25,22,1765,1776,T1
4765,November 18,2014,Scotland,England,1,3,Friendly,in Scotland,-12,12,1723,1924,-5,0,32,9,1735,1912,T2
4766,November 18,2014,Finland,Slovakia,1,2,Friendly,in Slovakia,-4,4,1626,1751,-2,0,57,26,1630,1747,T1
4767,November 18,2014,Colombia,Slovenia,1,0,Friendly,in Slovenia,4,-4,2020,1656,0,0,5,48,2016,1660,T2
4768,November 18,2014,Spain,Germany,0,1,Friendly,in Spain,-8,8,1954,2134,0,0,8,1,1962,2126,T2
4769,November 18,2014,Thailand,New Zealand,2,0,Friendly,in Thailand,21,-21,1325,1519,4,-8,128,83,1304,1540,T1
4770,November 18,2014,Ukraine,Lithuania,0,0,Friendly,in Ukraine,-9,9,1824,1467,-1,0,18,96,1833,1458,draw
4771,November 19,2014,Qatar,Bahrain,0,0,Gulf Cup,in Saudi Arabia,-5,5,1518,1444,-4,0,83,102,1523,1439,draw
4772,November 19,2014,Burkina Faso,Angola,1,1,African Nations Cup qualifier,in Burkina Faso,-12,12,1542,1438,-5,1,74,103,1554,1426,draw
4773,November 19,2014,Sierra Leone,Democratic Republic of Congo,1,3,African Nations Cup qualifier,in the Democratic Republic of the Congo,-14,14,1338,1473,-1,3,124,94,1352,1459,T1
4774,November 19,2014,Malawi,Ethiopia,0,0,African Nations Cup qualifier,in Ethiopia,6,-6,1358,1347,4,0,119,122,1352,1353,draw
4775,November 19,2014,Gabon,Lesotho,4,2,African Nations Cup qualifier,in Gabon,6,-6,1528,1240,1,-1,79,144,1522,1246,T1
4776,November 19,2014,Ghana,Togo,3,1,African Nations Cup qualifier,in Ghana,8,-8,1683,1445,2,-1,40,100,1675,1453,T1
4777,November 19,2014,Guam,Hong Kong,0,0,East Asian Cup qualifier,in Taiwan,16,-16,806,1153,0,-2,210,169,790,1169,draw
4778,November 19,2014,Guinea,Uganda,2,0,African Nations Cup qualifier,in Morocco,24,-24,1595,1481,1,-3,64,91,1571,1505,T1
4779,November 19,2014,Ivory Coast,Cameroon,0,0,African Nations Cup qualifier,in Ivory Coast,-9,9,1691,1649,1,0,36,50,1700,1640,draw
4780,November 19,2014,Algeria,Mali,0,2,African Nations Cup qualifier,in Mali,-39,39,1674,1548,-7,13,42,72,1713,1509,T1
4781,November 19,2014,Mozambique,Niger,1,1,African Nations Cup qualifier,in Niger,0,0,1377,1281,0,0,113,135,1377,1281,draw
4782,November 19,2014,South Africa,Nigeria,2,2,African Nations Cup qualifier,in Nigeria,8,-8,1634,1675,5,0,52,41,1626,1683,draw
4783,November 19,2014,Saudi Arabia,Yemen,1,0,Gulf Cup,in Saudi Arabia,3,-3,1516,1202,0,-1,84,159,1513,1205,T1
4784,November 19,2014,Botswana,Senegal,0,3,African Nations Cup qualifier,in Senegal,-6,6,1311,1641,0,0,130,51,1317,1635,T1
4785,November 19,2014,Congo,Sudan,1,0,African Nations Cup qualifier,in Sudan,23,-23,1437,1335,3,-6,104,125,1414,1358,T2
4786,November 19,2014,Taiwan,North Korea,0,0,East Asian Cup qualifier,in Taiwan,19,-19,795,1529,2,-5,211,78,776,1548,draw
4787,November 19,2014,Tunisia,Egypt,2,1,African Nations Cup qualifier,in Tunisia,17,-17,1603,1616,1,-8,62,60,1586,1633,T1
4788,November 19,2014,Zambia,Cape Verde,1,0,African Nations Cup qualifier,in Zambia,16,-16,1514,1505,5,-6,85,88,1498,1521,T1
4789,November 20,2014,Kuwait,Oman,0,5,Gulf Cup,in Saudi Arabia,-39,39,1523,1609,-12,5,79,61,1562,1570,T1
4790,November 20,2014,Iraq,United Arab Emirates,0,2,Gulf Cup,in Saudi Arabia,-23,23,1512,1641,-9,8,85,51,1535,1618,T1
4791,November 22,2014,Laos,Philippines,1,4,Southeast Asian Championship,in Vietnam,-8,8,850,1223,0,3,207,154,858,1215,T1
4792,November 22,2014,Indonesia,Vietnam,2,2,Southeast Asian Championship,in Vietnam,6,-6,1237,1235,3,-5,146,148,1231,1241,draw
4793,November 23,2014,Malaysia,Myanmar,0,0,Southeast Asian Championship,in Singapore,-4,4,1151,1085,-1,0,169,179,1155,1081,draw
4794,November 23,2014,Oman,Qatar,1,3,Gulf Cup,in Saudi Arabia,-38,38,1571,1556,-5,14,66,68,1609,1518,T1
4795,November 23,2014,Saudi Arabia,United Arab Emirates,3,2,Gulf Cup,in Saudi Arabia,21,-21,1537,1620,7,-8,76,59,1516,1641,T1
4796,November 23,2014,Thailand,Singapore,2,1,Southeast Asian Championship,in Singapore,20,-20,1345,1202,4,-3,124,158,1325,1222,T2
4797,November 25,2014,Philippines,Indonesia,4,0,Southeast Asian Championship,in Vietnam,39,-39,1262,1198,14,-15,140,161,1223,1237,T1
4798,November 25,2014,Oman,United Arab Emirates,0,1,Gulf Cup,in Saudi Arabia,-17,17,1554,1637,-2,7,68,52,1571,1620,T1
4799,November 25,2014,Laos,Vietnam,0,3,Southeast Asian Championship,in Vietnam,-4,4,846,1239,0,3,207,145,850,1235,T1
4800,November 26,2014,Qatar,Saudi Arabia,2,1,Gulf Cup,in Saudi Arabia,25,-25,1581,1512,2,-8,65,84,1556,1537,T2
4801,November 26,2014,Myanmar,Singapore,2,4,Southeast Asian Championship,in Singapore,-13,13,1072,1215,-1,1,180,156,1085,1202,T1
4802,November 26,2014,Thailand,Malaysia,3,2,Southeast Asian Championship,in Singapore,10,-10,1355,1141,3,-2,121,171,1345,1151,T1
4803,November 28,2014,Laos,Indonesia,1,5,Southeast Asian Championship,in Vietnam,-9,9,837,1207,0,4,207,157,846,1198,T1
4804,November 28,2014,Philippines,Vietnam,1,3,Southeast Asian Championship,in Vietnam,-23,23,1239,1262,-5,5,145,140,1262,1239,T1
4805,November 29,2014,Malaysia,Singapore,3,1,Southeast Asian Championship,in Singapore,44,-44,1185,1171,8,-11,163,167,1141,1215,T2
4806,November 29,2014,Thailand,Myanmar,2,0,Southeast Asian Championship,in Singapore,10,-10,1365,1062,4,-4,117,184,1355,1072,T1
4807,December 6,2014,Thailand,Philippines,0,0,Southeast Asian Championship,in the Philippines,-1,1,1364,1240,0,1,117,144,1365,1239,draw
4808,December 7,2014,Malaysia,Vietnam,1,2,Southeast Asian Championship,in Malaysia,-21,21,1164,1283,-5,5,168,135,1185,1262,T2
4809,December 10,2014,Thailand,Philippines,3,0,Southeast Asian Championship,in Thailand,15,-15,1379,1225,4,-8,113,152,1364,1240,T1
4810,December 11,2014,Malaysia,Vietnam,4,2,Southeast Asian Championship,in Vietnam,47,-47,1211,1236,12,-12,156,147,1164,1283,T2
4811,December 13,2014,Kyrgyzstan,China,0,4,Friendly,in China,-1,1,1100,1559,0,0,177,67,1101,1558,T1
4812,December 13,2014,Palestine,Uzbekistan,0,1,Friendly,in the United Arab Emirates,-3,3,1308,1636,-2,1,132,53,1311,1633,T1
4813,December 17,2014,Kyrgyzstan,China,0,2,Friendly,in China,-1,1,1099,1560,0,0,177,67,1100,1559,T1
4814,December 17,2014,Thailand,Malaysia,2,0,Southeast Asian Championship,in Thailand,11,-11,1390,1200,0,-4,113,160,1379,1211,T1
4815,December 20,2014,Thailand,Malaysia,2,3,Southeast Asian Championship,in Malaysia,-25,25,1365,1225,-4,8,117,152,1390,1200,T1
4816,December 21,2014,China,Palestine,0,0,Friendly,in China,-8,8,1552,1316,-1,2,68,130,1560,1308,draw
4817,December 21,2014,Jordan,Uzbekistan,1,2,Friendly,in the United Arab Emirates,-7,7,1527,1643,-2,2,78,51,1534,1636,T1
4818,December 22,2014,Kuwait,Iraq,1,1,Friendly,in the United Arab Emirates,0,0,1523,1512,0,0,80,84,1523,1512,draw
4819,December 25,2014,Uzbekistan,Iraq,1,0,Friendly,in the United Arab Emirates,6,-6,1649,1506,1,-3,50,87,1643,1512,T1
4820,December 27,2014,Estonia,Qatar,0,3,Friendly,in Qatar,-8,8,1460,1589,-1,0,97,65,1468,1581,T1
4821,December 28,2014,Uzbekistan,Iraq,0,0,Friendly,in the United Arab Emirates,-4,4,1645,1510,-1,2,51,85,1649,1506,draw
4822,December 30,2014,Saudi Arabia,Bahrain,1,4,Friendly,in Australia,-21,21,1491,1465,-5,5,89,97,1512,1444,T1
4823,December 30,2014,Jordan,United Arab Emirates,0,1,Friendly,in Australia,-7,7,1520,1644,-3,1,81,52,1527,1637,T1
4824,January 3,2015,Oman,China,1,4,Friendly,in Australia,-18,18,1537,1570,-8,1,75,67,1555,1552,T1
4825,January 4,2015,Jordan,Bahrain,0,1,Friendly,in Australia,-12,12,1508,1477,-3,4,84,93,1520,1465,T1
4826,January 4,2015,Iraq,Iran,0,1,Friendly,in Australia,-6,6,1504,1679,-3,3,87,41,1510,1673,T1
4827,January 4,2015,South Africa,Zambia,1,0,Friendly,in South Africa,4,-4,1638,1510,-1,1,55,82,1634,1514,T1
4828,January 4,2015,South Korea,Saudi Arabia,2,0,Friendly,in Australia,9,-9,1642,1482,2,-1,53,90,1633,1491,T1
4829,January 7,2015,Democratic Republic of Congo,Cameroon,1,1,Friendly,in Cameroon,7,-7,1480,1642,2,-2,93,52,1473,1649,draw
4830,January 7,2015,Equatorial Guinea,Cape Verde,1,1,Friendly,in Portugal,5,-5,1314,1500,1,-2,131,88,1309,1505,draw
4831,January 9,2015,Kuwait,Australia,1,4,Asian Cup,in Australia,-19,19,1504,1670,-6,3,85,46,1523,1651,T1
4832,January 9,2015,Gabon,Senegal,0,1,Friendly,in Morocco,-7,7,1521,1648,-2,4,79,50,1528,1641,T1
4833,January 10,2015,Burkina Faso,Swaziland,5,1,Friendly,in South Africa,3,-3,1545,1140,1,0,72,171,1542,1143,T1
4834,January 10,2015,South Africa,Cameroon,1,1,Friendly,in Gabon,0,0,1638,1642,0,-1,55,54,1638,1642,draw
4835,January 10,2015,Congo,Cape Verde,2,3,Friendly,in Senegal,-8,8,1429,1508,0,5,104,83,1437,1500,T1
4836,January 10,2015,China,Saudi Arabia,1,0,Asian Cup,in Australia,19,-19,1589,1463,2,-7,65,97,1570,1482,T1
4837,January 10,2015,Oman,South Korea,0,1,Asian Cup,in Australia,-18,18,1519,1660,-3,4,78,49,1537,1642,T1
4838,January 10,2015,Uzbekistan,North Korea,1,0,Asian Cup,in Australia,17,-17,1662,1512,4,-4,47,80,1645,1529,T1
4839,January 11,2015,Bahrain,Iran,0,2,Asian Cup,in Australia,-18,18,1459,1697,-5,5,98,36,1477,1679,T1
4840,January 11,2015,Algeria,Tunisia,1,1,Friendly,in Tunisia,1,-1,1675,1602,0,0,43,62,1674,1603,draw
4841,January 11,2015,United Arab Emirates,Qatar,4,1,Asian Cup,in Australia,37,-37,1681,1551,11,-2,42,68,1644,1588,T1
4842,January 12,2015,Iraq,Jordan,1,0,Asian Cup,in Australia,25,-25,1529,1483,11,-5,75,88,1504,1508,T1
4843,January 12,2015,Palestine,Japan,0,4,Asian Cup,in Australia,-8,8,1308,1737,-2,1,132,27,1316,1729,T1
4844,January 13,2015,Oman,Australia,0,4,Asian Cup,in Australia,-18,18,1501,1688,-7,9,86,38,1519,1670,T1
4845,January 13,2015,Guinea,Senegal,2,5,Friendly,in Morocco,-15,15,1580,1663,-1,4,65,49,1595,1648,T1
4846,January 13,2015,South Korea,Kuwait,1,0,Asian Cup,in Australia,14,-14,1674,1490,4,-1,46,87,1660,1504,T1
4847,January 14,2015,Uzbekistan,China,1,2,Asian Cup,in Australia,-30,30,1632,1619,-5,4,55,60,1662,1589,T1
4848,January 14,2015,North Korea,Saudi Arabia,1,4,Asian Cup,in Australia,-50,50,1462,1513,-16,16,96,80,1512,1463,T1
4849,January 14,2015,Mali,South Africa,0,3,Friendly,in Gabon,-13,13,1535,1651,-3,2,74,53,1548,1638,T1
4850,January 15,2015,Iran,Qatar,1,0,Asian Cup,in Australia,15,-15,1712,1536,1,-5,35,73,1697,1551,T1
4851,January 15,2015,Ivory Coast,Sweden,0,2,Friendly,in the United Arab Emirates,-11,11,1680,1794,-6,2,43,21,1691,1783,T1
4852,January 15,2015,Bahrain,United Arab Emirates,1,2,Asian Cup,in Australia,-11,11,1448,1692,-1,6,99,37,1459,1681,T1
4853,January 16,2015,Iceland,Canada,2,1,Friendly,in the United States,6,-6,1667,1503,1,-3,49,85,1661,1509,T1
4854,January 16,2015,Japan,Iraq,1,0,Asian Cup,in Australia,12,-12,1749,1517,0,-4,27,79,1737,1529,T1
4855,January 16,2015,Palestine,Jordan,1,5,Asian Cup,in Australia,-25,25,1283,1508,-2,6,134,82,1308,1483,T1
4856,January 17,2015,Australia,South Korea,0,1,Asian Cup,in Australia,-33,33,1655,1707,-14,9,52,37,1688,1674,T2
4857,January 17,2015,Congo,Equatorial Guinea,1,1,African Nations Cup,in Equatorial Guinea,-1,1,1428,1315,-1,0,105,130,1429,1314,draw
4858,January 17,2015,Gabon,Burkina Faso,2,0,African Nations Cup,in Equatorial Guinea,40,-40,1561,1505,10,-15,67,85,1521,1545,T1
4859,January 17,2015,Kuwait,Oman,0,1,Asian Cup,in Australia,-24,24,1466,1525,-7,11,95,76,1490,1501,T1
4860,January 18,2015,Cape Verde,Tunisia,1,1,African Nations Cup,in Equatorial Guinea,7,-7,1515,1595,2,-1,80,64,1508,1602,draw
4861,January 18,2015,China,North Korea,2,1,Asian Cup,in Australia,14,-14,1633,1448,4,-2,56,98,1619,1462,T1
4862,January 18,2015,Democratic Republic of Congo,Zambia,1,1,African Nations Cup,in Equatorial Guinea,2,-2,1482,1508,2,0,89,81,1480,1510,draw
4863,January 18,2015,Uzbekistan,Saudi Arabia,3,1,Asian Cup,in Australia,25,-25,1657,1488,4,-7,51,87,1632,1513,T1
4864,January 19,2015,South Africa,Algeria,1,3,African Nations Cup,in Equatorial Guinea,-35,35,1616,1710,-6,7,60,37,1651,1675,T1
4865,January 19,2015,Qatar,Bahrain,1,2,Asian Cup,in Australia,-31,31,1505,1479,-11,6,84,92,1536,1448,T1
4866,January 19,2015,Iceland,Canada,1,1,Friendly,in the United States,-4,4,1663,1507,0,2,48,83,1667,1503,draw
4867,January 19,2015,Finland,Sweden,1,0,Friendly,in the United Arab Emirates,14,-14,1640,1780,4,-2,55,23,1626,1794,T1
4868,January 19,2015,United Arab Emirates,Iran,0,1,Asian Cup,in Australia,-24,24,1668,1736,-9,7,47,28,1692,1712,T1
4869,January 19,2015,Ghana,Senegal,1,2,African Nations Cup,in Equatorial Guinea,-26,26,1657,1689,-8,10,50,39,1683,1663,T1
4870,January 20,2015,Cameroon,Mali,1,1,African Nations Cup,in Equatorial Guinea,-7,7,1635,1542,-1,1,55,72,1642,1535,draw
4871,January 20,2015,Ivory Coast,Guinea,1,1,African Nations Cup,in Equatorial Guinea,-7,7,1673,1587,-2,0,45,65,1680,1580,draw
4872,January 20,2015,Iraq,Palestine,2,0,Asian Cup,in Australia,15,-15,1532,1268,4,-5,74,139,1517,1283,T1
4873,January 20,2015,Japan,Jordan,2,0,Asian Cup,in Australia,15,-15,1764,1493,2,-6,25,86,1749,1508,T1
4874,January 21,2015,Congo,Gabon,1,0,African Nations Cup,in Equatorial Guinea,34,-34,1462,1527,8,-7,97,74,1428,1561,T1
4875,January 21,2015,Burkina Faso,Equatorial Guinea,0,0,African Nations Cup,in Equatorial Guinea,-6,6,1499,1321,-2,0,85,130,1505,1315,draw
4876,January 22,2015,Australia,China,2,0,Asian Cup,in Australia,25,-25,1680,1608,10,-6,43,62,1655,1633,T1
4877,January 22,2015,Democratic Republic of Congo,Cape Verde,0,0,African Nations Cup,in Equatorial Guinea,2,-2,1484,1513,1,0,88,79,1482,1515,draw
4878,January 22,2015,Yemen,Finland,0,0,Friendly,in the United Arab Emirates,9,-9,1211,1631,2,0,157,54,1202,1640,draw
4879,January 22,2015,South Korea,Uzbekistan,2,0,Asian Cup,in Australia,32,-32,1739,1625,10,-7,28,57,1707,1657,T1
4880,January 22,2015,Tunisia,Zambia,2,1,African Nations Cup,in Equatorial Guinea,19,-19,1614,1489,3,-6,61,86,1595,1508,T1
4881,January 23,2015,Algeria,Ghana,0,1,African Nations Cup,in Equatorial Guinea,-29,29,1681,1686,-5,13,43,38,1710,1657,T1
4882,January 23,2015,Iran,Iraq,3,3,Asian Cup,in Australia,-13,13,1723,1545,-4,3,33,70,1736,1532,draw
4883,January 23,2015,Japan,United Arab Emirates,1,1,Asian Cup,in Australia,-7,7,1757,1675,0,3,25,45,1764,1668,draw
4884,January 23,2015,South Africa,Senegal,1,1,African Nations Cup,in Equatorial Guinea,5,-5,1621,1684,1,-3,58,42,1616,1689,draw
4885,January 24,2015,Cameroon,Guinea,1,1,African Nations Cup,in Equatorial Guinea,-3,3,1632,1590,0,0,53,65,1635,1587,draw
4886,January 24,2015,Ivory Coast,Mali,1,1,African Nations Cup,in Equatorial Guinea,-9,9,1664,1551,-1,4,49,68,1673,1542,draw
4887,January 25,2015,Burkina Faso,Congo,1,2,African Nations Cup,in Equatorial Guinea,-28,28,1471,1490,-10,13,94,84,1499,1462,T1
4888,January 25,2015,Gabon,Equatorial Guinea,0,2,African Nations Cup,in Equatorial Guinea,-49,49,1478,1370,-18,13,92,117,1527,1321,T1
4889,January 26,2015,Zambia,Cape Verde,0,0,African Nations Cup,in Equatorial Guinea,2,-2,1491,1511,0,0,85,78,1489,1513,draw
4890,January 26,2015,Democratic Republic of Congo,Tunisia,1,1,African Nations Cup,in Equatorial Guinea,9,-9,1493,1605,4,-2,83,63,1484,1614,draw
4891,January 26,2015,South Korea,Iraq,2,0,Asian Cup,in Australia,18,-18,1757,1527,3,-2,25,73,1739,1545,T1
4892,January 27,2015,Algeria,Senegal,2,0,African Nations Cup,in Equatorial Guinea,38,-38,1719,1646,8,-10,35,52,1681,1684,T1
4893,January 27,2015,Australia,United Arab Emirates,2,0,Asian Cup,in Australia,26,-26,1706,1649,5,-6,39,51,1680,1675,T1
4894,January 27,2015,Ghana,South Africa,2,1,African Nations Cup,in Equatorial Guinea,20,-20,1706,1601,-1,-5,39,63,1686,1621,T1
4895,January 28,2015,United States,Chile,2,3,Friendly,in Chile,-4,4,1810,1967,0,1,19,6,1814,1963,T1
4896,January 28,2015,Mali,Guinea,1,1,African Nations Cup,in Equatorial Guinea,3,-3,1554,1587,1,0,67,65,1551,1590,draw
4897,January 28,2015,Ivory Coast,Cameroon,1,0,African Nations Cup,in Equatorial Guinea,23,-23,1687,1609,6,-6,41,59,1664,1632,T1
4898,January 30,2015,Curaçao,Aruba,0,0,Friendly tournament,in Suriname,-5,5,1060,952,-4,1,185,194,1065,947,draw
4899,January 30,2015,Suriname,Bonaire,3,0,Friendly tournament,in Suriname,6,-6,1232,966,0,0,149,192,1226,972,T1
4900,January 30,2015,United Arab Emirates,Iraq,3,2,Asian Cup,in Australia,17,-17,1666,1510,3,-5,48,78,1649,1527,T1
4901,January 31,2015,Australia,South Korea,2,1,Asian Cup,in Australia,21,-21,1727,1736,7,-3,32,28,1706,1757,T1
4902,January 31,2015,Democratic Republic of Congo,Congo,4,2,African Nations Cup,in Equatorial Guinea,37,-37,1530,1453,10,-13,73,99,1493,1490,T1
4903,January 31,2015,Tunisia,Equatorial Guinea,1,2,African Nations Cup,in Equatorial Guinea,-34,34,1571,1404,-4,6,66,111,1605,1370,T1
4904,February 1,2015,Barbados,Guyana,2,2,Friendly,in Barbados,-1,1,1144,1222,0,0,170,155,1145,1221,draw
4905,February 1,2015,Bonaire,Curaçao,1,4,Friendly tournament,in Suriname,-19,19,947,1079,-3,5,195,180,966,1060,T1
4906,February 1,2015,Ghana,Guinea,3,0,African Nations Cup,in Equatorial Guinea,29,-29,1735,1558,11,-2,29,66,1706,1587,T1
4907,February 1,2015,Algeria,Ivory Coast,1,3,African Nations Cup,in Equatorial Guinea,-41,41,1678,1728,-8,10,44,31,1719,1687,T1
4908,February 1,2015,Aruba,Suriname,0,1,Friendly tournament,in Suriname,-3,3,949,1235,1,1,193,148,952,1232,T1
4909,February 2,2015,Bangladesh,Sri Lanka,1,0,Friendly tournament,in Bangladesh,7,-7,956,829,1,0,192,208,949,836,T1
4910,February 4,2015,Venezuela,Honduras,3,2,Friendly,in Honduras,9,-9,1683,1543,2,-3,44,71,1674,1552,T2
4911,February 4,2015,Ivory Coast,Democratic Republic of Congo,3,1,African Nations Cup,in Equatorial Guinea,18,-18,1746,1512,3,-4,28,77,1728,1530,T1
4912,February 5,2015,Ghana,Equatorial Guinea,3,0,African Nations Cup,in Equatorial Guinea,18,-18,1753,1386,3,-2,27,113,1735,1404,T2
4913,February 6,2015,Afghanistan,Pakistan,1,2,Friendly,in Pakistan,-12,12,1084,944,0,1,178,197,1096,932,T1
4914,February 7,2015,Equatorial Guinea,Democratic Republic of Congo,0,0,African Nations Cup,in Equatorial Guinea,2,-2,1388,1510,0,-1,113,78,1386,1512,draw
4915,February 8,2015,Ghana,Ivory Coast,0,0,African Nations Cup,in Equatorial Guinea,-1,1,1752,1747,0,0,27,29,1753,1746,draw
4916,February 8,2015,Panama,United States,0,2,Friendly,in the United States,-7,7,1707,1817,-1,0,40,19,1714,1810,T1
4917,February 11,2015,Venezuela,Honduras,2,1,Friendly,in Venezuela,4,-4,1687,1539,3,-1,41,72,1683,1543,T1
4918,February 18,2015,Kazakhstan,Moldova,1,1,Friendly,in Turkey,2,-2,1356,1412,0,0,123,108,1354,1414,draw
4919,February 28,2015,British Virgin Islands,Anguilla,0,1,Friendly,in Anguilla,-9,9,626,567,-1,1,228,232,635,558,T1
4920,March 1,2015,Anguilla,British Virgin Islands,3,1,Friendly,in Anguilla,13,-13,580,613,0,-1,232,229,567,626,T1
4921,March 6,2015,Barbados,Saint Vincent and the Grenadines,3,1,Friendly,in Barbados,12,-12,1156,1160,1,-2,169,168,1144,1172,T1
4922,March 6,2015,Bermuda,Grenada,2,2,Friendly,in Bermuda,-4,4,1198,1170,-1,1,161,167,1202,1166,draw
4923,March 8,2015,US Virgin Islands,Antigua and Barbuda,0,2,Friendly,in Antigua and Barbuda,-1,1,678,1271,0,0,222,138,679,1270,T1
4924,March 8,2015,Saint Vincent and the Grenadines,Barbados,2,2,Friendly,in Barbados,3,-3,1163,1153,1,0,167,169,1160,1156,draw
4925,March 8,2015,Grenada,Bermuda,0,2,Friendly,in Bermuda,-10,10,1160,1208,-1,3,168,158,1170,1198,T1
4926,March 12,2015,Macao,Cambodia,0,3,World Cup and Asian Cup qualifier,in Cambodia,-18,18,619,734,-2,2,228,214,637,716,T1
4927,March 12,2015,Mongolia,East Timor,1,4,World Cup and Asian Cup qualifier,in East Timor,-34,34,700,673,-3,0,217,225,734,639,T1
4928,March 12,2015,India,Nepal,2,0,World Cup and Asian Cup qualifier,in India,10,-10,1079,875,1,0,180,204,1069,885,T1
4929,March 12,2015,Sri Lanka,Bhutan,0,1,World Cup and Asian Cup qualifier,in Sri Lanka,-36,36,793,559,-2,1,210,234,829,523,T2
4930,March 12,2015,Taiwan,Brunei,0,1,World Cup and Asian Cup qualifier,in Taiwan,-34,34,761,641,-2,4,213,226,795,607,T2
4931,March 12,2015,Pakistan,Yemen,1,3,World Cup and Asian Cup qualifier,in Qatar,-11,11,933,1222,-1,2,198,155,944,1211,T1
4932,March 15,2015,Dominica,Antigua and Barbuda,0,1,Friendly,in Antigua and Barbuda,-2,2,951,1273,0,0,193,138,953,1271,T1
4933,March 17,2015,Sri Lanka,Bhutan,1,2,World Cup and Asian Cup qualifier,in Bhutan,-27,27,766,586,-3,2,213,232,793,559,T1
4934,March 17,2015,Brunei,Taiwan,0,2,World Cup and Asian Cup qualifier,in Brunei,-28,28,613,789,-3,3,229,210,641,761,T2
4935,March 17,2015,Macao,Cambodia,1,1,World Cup and Asian Cup qualifier,in Macao,1,-1,620,733,1,0,227,214,619,734,draw
4936,March 17,2015,Mongolia,East Timor,0,1,World Cup and Asian Cup qualifier,in Mongolia,-27,27,673,700,-8,8,225,217,700,673,T2
4937,March 17,2015,India,Nepal,0,0,World Cup and Asian Cup qualifier,in Nepal,-6,6,1073,881,-1,0,181,204,1079,875,draw
4938,March 22,2015,British Virgin Islands,Antigua and Barbuda,0,1,Friendly,in Antigua and Barbuda,0,0,613,1273,0,0,229,138,613,1273,T1
4939,March 22,2015,US Virgin Islands,Barbados,1,0,World Cup qualifier,in Barbados,39,-39,717,1114,6,-5,216,174,678,1153,T2
4940,March 22,2015,Saint Lucia,Guyana,0,2,Friendly,in Guyana,-8,8,1126,1230,0,5,173,150,1134,1222,T1
4941,March 23,2015,Anguilla,Nicaragua,0,5,World Cup qualifier,in Nicaragua,-2,2,578,1106,0,0,233,176,580,1104,T1
4942,March 23,2015,Yemen,Pakistan,0,0,World Cup and Asian Cup qualifier,in Bahrain,-14,14,1208,947,-1,3,157,195,1222,933,draw
4943,March 23,2015,Saint Kitts and Nevis,Turks and Caicos,6,2,World Cup qualifier,in Saint Kitts and Nevis,3,-3,1207,774,1,0,159,212,1204,777,T1
4944,March 25,2015,Bermuda,Bahamas,5,0,World Cup qualifier,in the Bahamas,21,-21,1229,911,7,-1,150,200,1208,932,T2
4945,March 25,2015,Belize,Cayman Islands,0,0,World Cup qualifier,in Belize,-14,14,1122,951,-2,5,173,193,1136,937,draw
4946,March 25,2015,United States,Denmark,2,3,Friendly,in Denmark,-9,9,1808,1764,0,1,19,25,1817,1755,T1
4947,March 25,2015,Dominican Republic,Cuba,0,3,Friendly,in the Dominican Republic,-15,15,1222,1412,-10,3,156,108,1237,1397,T2
4948,March 25,2015,Honduras,French Guiana,1,3,CONCACAF Championship qualifier,in French Guiana,-43,43,1496,1317,-12,7,84,130,1539,1274,T1
4949,March 25,2015,Mali,Gabon,3,4,Friendly,in France,-12,12,1542,1490,-3,4,70,87,1554,1478,T1
4950,March 25,2015,Georgia,Malta,2,0,Friendly,in Georgia,4,-4,1474,1235,1,-2,93,146,1470,1239,T1
4951,March 25,2015,Germany,Australia,2,2,Friendly,in Germany,-9,9,2125,1736,0,4,1,30,2134,1727,draw
4952,March 25,2015,Cameroon,Indonesia,1,0,Friendly,in Indonesia,3,-3,1612,1204,0,-1,59,160,1609,1207,T2
4953,March 25,2015,Burundi,Mauritius,2,2,Friendly,in Mauritius,-5,5,1317,1025,0,0,130,187,1322,1020,draw
4954,March 25,2015,Uganda,Nigeria,1,0,Friendly,in Nigeria,17,-17,1498,1658,5,-3,83,49,1481,1675,T2
4955,March 25,2015,Northern Ireland,Scotland,0,1,Friendly,in Scotland,-3,3,1499,1726,1,0,82,36,1502,1723,T1
4956,March 25,2015,Swaziland,South Africa,1,3,Friendly,in Swaziland,-3,3,1137,1604,0,0,170,62,1140,1601,T2
4957,March 26,2015,Bahrain,Colombia,0,6,Friendly,in Bahrain,-3,3,1476,2023,-1,0,92,5,1479,2020,T2
4958,March 26,2015,Costa Rica,Paraguay,0,0,Friendly,in Costa Rica,-7,7,1861,1693,0,1,15,41,1868,1686,draw
4959,March 26,2015,British Virgin Islands,Dominica,2,3,World Cup qualifier,in Dominica,-3,3,610,954,-1,0,230,193,613,951,T1
4960,March 26,2015,Equatorial Guinea,Egypt,0,2,Friendly,in Egypt,-4,4,1384,1620,0,0,113,58,1388,1616,T1
4961,March 26,2015,Brazil,France,3,1,Friendly,in France,16,-16,2058,1950,1,0,2,7,2042,1966,T2
4962,March 26,2015,Iran,Chile,2,0,Friendly,in Austria,24,-24,1747,1943,7,-2,30,8,1723,1967,T1
4963,March 26,2015,Ivory Coast,Angola,2,0,Friendly,in Ivory Coast,3,-3,1750,1435,0,0,29,104,1747,1438,T1
4964,March 26,2015,Syria,Jordan,1,0,Friendly,in Jordan,13,-13,1490,1480,6,-6,86,91,1477,1493,T2
4965,March 26,2015,Tajikistan,Maldives,2,0,Friendly,in the Maldives,11,-11,1273,1053,2,-4,138,186,1262,1064,T2
4966,March 26,2015,Oman,Malaysia,6,0,Friendly,in Oman,4,-4,1529,1221,1,-3,72,156,1525,1225,T1
4967,March 26,2015,Algeria,Qatar,0,1,Friendly,in Qatar,-12,12,1666,1517,-1,5,46,76,1678,1505,T1
4968,March 26,2015,Thailand,Singapore,2,0,Friendly,in Thailand,5,-5,1370,1166,0,0,118,166,1365,1171,T1
4969,March 26,2015,Turks and Caicos,Saint Kitts and Nevis,2,6,World Cup qualifier,in Turks and Caicos,-10,10,764,1217,-1,1,213,158,774,1207,T2
4970,March 26,2015,US Virgin Islands,Barbados,0,4,World Cup qualifier,in the US Virgin Islands,-11,11,706,1125,0,1,216,173,717,1114,T2
4971,March 27,2015,Guatemala,Canada,0,1,Friendly,in the United States,-11,11,1529,1518,-1,5,72,76,1540,1507,T1
4972,March 27,2015,China,Haiti,2,2,Friendly,in China,-6,6,1602,1452,-2,1,62,100,1608,1446,draw
4973,March 27,2015,Curaçao,Montserrat,2,1,World Cup qualifier,in Curaçao,2,-2,1081,616,1,0,179,228,1079,618,T1
4974,March 27,2015,Lithuania,England,0,4,European Championship qualifier,in England,-3,3,1464,1927,0,0,95,9,1467,1924,T1
4975,March 27,2015,Gambia,Mauritania,1,0,Friendly,in The Gambia,4,-4,1338,1192,2,0,126,162,1334,1196,T1
4976,March 27,2015,Venezuela,Jamaica,1,2,Friendly,in Jamaica,-12,12,1675,1534,-2,3,44,71,1687,1522,T1
4977,March 27,2015,Tunisia,Japan,0,2,Friendly,in Japan,-5,5,1566,1762,-1,0,66,26,1571,1757,T1
4978,March 27,2015,Austria,Liechtenstein,5,0,European Championship qualifier,in Liechtenstein,8,-8,1723,1213,0,-2,38,158,1715,1221,T2
4979,March 27,2015,Macedonia,Belarus,1,2,European Championship qualifier,in Macedonia,-22,22,1459,1572,-6,2,96,65,1481,1550,T2
4980,March 27,2015,Moldova,Sweden,0,2,European Championship qualifier,in Moldova,-11,11,1401,1791,-3,1,111,22,1412,1780,T2
4981,March 27,2015,Russia,Montenegro,0,0,European Championship qualifier,in Montenegro,-5,5,1774,1602,0,1,24,62,1779,1597,draw
4982,March 27,2015,Slovakia,Luxembourg,3,0,European Championship qualifier,in Slovakia,2,-2,1753,1223,1,-1,27,154,1751,1225,T1
4983,March 27,2015,Slovenia,San Marino,6,0,European Championship qualifier,in Slovenia,1,-1,1657,889,0,0,51,203,1656,890,T1
4984,March 27,2015,South Korea,Uzbekistan,1,1,Friendly,in South Korea,-5,5,1731,1630,-2,2,33,54,1736,1625,draw
4985,March 27,2015,Spain,Ukraine,1,0,European Championship qualifier,in Spain,8,-8,1962,1816,0,0,6,18,1954,1824,T1
4986,March 27,2015,Estonia,Switzerland,0,3,European Championship qualifier,in Switzerland,-5,5,1455,1798,0,0,97,21,1460,1793,T1
4987,March 27,2015,Panama,Trinidad and Tobago,1,0,Friendly,in Trinidad and Tobago,8,-8,1715,1519,1,-1,39,74,1707,1527,T2
4988,March 28,2015,Bosnia and Herzegovina,Andorra,3,0,European Championship qualifier,in Andorra,2,-2,1713,974,0,0,40,191,1711,976,T2
4989,March 28,2015,Argentina,El Salvador,2,0,Friendly,in the United States,1,-1,2051,1507,0,1,3,80,2050,1508,T1
4990,March 28,2015,Malta,Azerbaijan,0,2,European Championship qualifier,in Azerbaijan,-10,10,1225,1416,-6,2,152,107,1235,1406,T1
4991,March 28,2015,Cyprus,Belgium,0,5,European Championship qualifier,in Belgium,-3,3,1403,1902,-1,0,110,12,1406,1899,T1
4992,March 28,2015,Italy,Bulgaria,2,2,European Championship qualifier,in Bulgaria,-10,10,1876,1616,0,2,14,58,1886,1606,draw
4993,March 28,2015,Norway,Croatia,1,5,European Championship qualifier,in Croatia,-11,11,1616,1837,-2,0,58,17,1627,1826,T1
4994,March 28,2015,Czechia,Latvia,1,1,European Championship qualifier,in Czechia,-17,17,1788,1462,-2,6,22,96,1805,1445,draw
4995,March 28,2015,Guam,Hong Kong,0,1,Friendly,in Hong Kong,-1,1,805,1154,0,0,209,169,806,1153,T1
4996,March 28,2015,Iraq,Democratic Republic of Congo,2,1,Friendly,in the United Arab Emirates,10,-10,1520,1500,5,-2,74,81,1510,1510,T1
4997,March 28,2015,Wales,Israel,3,0,European Championship qualifier,in Israel,50,-50,1671,1635,11,-11,46,53,1621,1685,T2
4998,March 28,2015,Kazakhstan,Iceland,0,3,European Championship qualifier,in Kazakhstan,-16,16,1340,1679,-2,5,125,43,1356,1663,T2
4999,March 28,2015,Mauritius,Togo,1,1,Friendly,in Mauritius,7,-7,1032,1438,0,-1,187,103,1025,1445,draw
5000,March 28,2015,Ecuador,Mexico,0,1,Friendly,in the United States,-9,9,1838,1902,0,1,16,12,1847,1893,T1
5001,March 28,2015,Morocco,Uruguay,0,1,Friendly,in Morocco,-4,4,1540,1913,-1,1,70,10,1544,1909,T2
5002,March 28,2015,Turkey,Netherlands,1,1,European Championship qualifier,in the Netherlands,17,-17,1702,2013,1,-1,41,5,1685,2030,draw
5003,March 28,2015,Senegal,Ghana,2,1,Friendly,in France,13,-13,1659,1739,3,-2,49,30,1646,1752,T1
5004,March 29,2015,Albania,Armenia,2,1,European Championship qualifier,in Albania,13,-13,1591,1537,0,-2,64,70,1578,1550,T1
5005,March 29,2015,Nicaragua,Anguilla,3,0,World Cup qualifier,in Anguilla,5,-5,1111,573,1,0,175,233,1106,578,T2
5006,March 29,2015,Bermuda,Bahamas,3,0,World Cup qualifier,in Bermuda,6,-6,1235,905,2,-1,147,201,1229,911,T1
5007,March 29,2015,Botswana,Mozambique,1,2,Friendly,in Botswana,-11,11,1300,1388,0,1,132,113,1311,1377,T2
5008,March 29,2015,Brazil,Chile,1,0,Friendly,in England,7,-7,2065,1936,0,0,2,8,2058,1943,T1
5009,March 29,2015,Cayman Islands,Belize,1,1,World Cup qualifier,in the Cayman Islands,4,-4,955,1118,1,0,193,174,951,1122,draw
5010,March 29,2015,Dominica,British Virgin Islands,0,0,World Cup qualifier,in Dominica,-17,17,937,627,-5,3,198,227,954,610,draw
5011,March 29,2015,Denmark,France,0,2,Friendly,in France,-5,5,1759,1955,-1,0,26,7,1764,1950,T1
5012,March 29,2015,Georgia,Germany,0,2,European Championship qualifier,in Georgia,-2,2,1472,2127,0,0,92,1,1474,2125,T2
5013,March 29,2015,Grenada,Guyana,0,2,Friendly,in Guyana,-8,8,1152,1238,-1,4,169,144,1160,1230,T1
5014,March 29,2015,French Guiana,Honduras,0,3,CONCACAF Championship qualifier,in Honduras,-12,12,1305,1508,-1,3,131,81,1317,1496,T1
5015,March 29,2015,Greece,Hungary,0,0,European Championship qualifier,in Hungary,5,-5,1678,1653,1,-2,44,52,1673,1658,draw
5016,March 29,2015,Ireland,Poland,1,1,European Championship qualifier,in Ireland,-6,6,1727,1734,-3,2,35,32,1733,1728,draw
5017,March 29,2015,Ivory Coast,Equatorial Guinea,1,1,Friendly,in Ivory Coast,-9,9,1741,1393,-1,1,29,112,1750,1384,draw
5018,March 29,2015,Northern Ireland,Finland,2,1,European Championship qualifier,in Northern Ireland,22,-22,1521,1609,8,-6,74,60,1499,1631,T1
5019,March 29,2015,Portugal,Serbia,2,1,European Championship qualifier,in Portugal,7,-7,1918,1720,1,-2,10,38,1911,1727,T1
5020,March 29,2015,Faroe Islands,Romania,0,1,European Championship qualifier,in Romania,-1,1,1225,1787,-1,0,151,23,1226,1786,T1
5021,March 29,2015,Gibraltar,Scotland,1,6,European Championship qualifier,in Scotland,-1,1,1131,1727,0,2,171,35,1132,1726,T1
5022,March 29,2015,South Africa,Nigeria,1,1,Friendly,in South Africa,-1,1,1603,1659,0,1,61,49,1604,1658,draw
5023,March 29,2015,Tanzania,Malawi,1,1,Friendly,in Tanzania,-3,3,1344,1361,-1,1,124,120,1347,1358,draw
5024,March 29,2015,Rwanda,Zambia,0,2,Friendly,in Zambia,-7,7,1386,1498,-2,1,114,84,1393,1491,T1
5025,March 30,2015,Oman,Algeria,1,4,Friendly,in Qatar,-11,11,1518,1677,-7,2,79,45,1529,1666,T1
5026,March 30,2015,Philippines,Bahrain,1,2,Friendly,in Bahrain,-2,2,1223,1478,-2,1,153,90,1225,1476,T1
5027,March 30,2015,Gabon,Belarus,0,0,Friendly,in Turkey,2,-2,1492,1570,-1,0,87,65,1490,1572,draw
5028,March 30,2015,Kuwait,Colombia,1,3,Friendly,in the United Arab Emirates,-1,1,1465,2024,0,0,94,4,1466,2023,T1
5029,March 30,2015,Indonesia,Myanmar,2,1,Friendly,in Indonesia,4,-4,1208,1058,1,0,159,183,1204,1062,T1
5030,March 30,2015,Jamaica,Cuba,3,0,Friendly,in Jamaica,8,-8,1542,1404,3,0,68,109,1534,1412,T1
5031,March 30,2015,Australia,Macedonia,0,0,Friendly,in Macedonia,-5,5,1731,1464,-1,2,32,95,1736,1459,draw
5032,March 30,2015,Puerto Rico,Canada,0,3,Friendly,in Puerto Rico,-4,4,1057,1522,0,4,184,74,1061,1518,T2
5033,March 30,2015,Qatar,Slovenia,1,0,Friendly,in Qatar,11,-11,1528,1646,6,-1,73,52,1517,1657,T1
5034,March 30,2015,Saudi Arabia,Jordan,2,1,Friendly,in Saudi Arabia,7,-7,1495,1473,2,-1,86,91,1488,1480,T1
5035,March 30,2015,Thailand,Cameroon,2,3,Friendly,in Thailand,-6,6,1364,1618,0,2,118,57,1370,1612,T2
5036,March 31,2015,Argentina,Ecuador,2,1,Friendly,in the United States,5,-5,2056,1833,0,-1,3,17,2051,1838,T1
5037,March 31,2015,Austria,Bosnia and Herzegovina,1,1,Friendly,in Austria,-3,3,1720,1716,0,1,37,39,1723,1713,draw
5038,March 31,2015,Tunisia,China,1,1,Friendly,in China,4,-4,1570,1598,1,-1,65,63,1566,1602,draw
5039,March 31,2015,Guatemala,El Salvador,0,0,Friendly,in the United States,-1,1,1528,1508,-2,1,74,81,1529,1507,draw
5040,March 31,2015,Estonia,Iceland,1,1,Friendly,in Estonia,3,-3,1458,1676,0,-3,98,46,1455,1679,draw
5041,March 31,2015,Mali,Ghana,1,1,Friendly,in France,5,-5,1547,1734,0,0,68,30,1542,1739,draw
5042,March 31,2015,Democratic Republic of Congo,Iraq,0,1,Friendly,in the United Arab Emirates,-9,9,1491,1529,-5,3,88,73,1500,1520,T1
5043,March 31,2015,Belgium,Israel,1,0,European Championship qualifier,in Israel,11,-11,1913,1624,2,-1,10,54,1902,1635,T2
5044,March 31,2015,Italy,England,1,1,Friendly,in Italy,-1,1,1875,1928,0,0,14,9,1876,1927,draw
5045,March 31,2015,Japan,Uzbekistan,5,1,Friendly,in Japan,8,-8,1770,1622,1,-1,24,55,1762,1630,T1
5046,March 31,2015,Liechtenstein,San Marino,1,0,Friendly,in Liechtenstein,2,-2,1215,887,0,0,158,203,1213,889,T1
5047,March 31,2015,Luxembourg,Turkey,1,2,Friendly,in Luxembourg,-2,2,1221,1704,-2,0,155,41,1223,1702,T2
5048,March 31,2015,Niger,Mauritania,0,2,Friendly,in Mauritania,-15,15,1266,1207,-4,1,139,161,1281,1192,T1
5049,March 31,2015,Mexico,Paraguay,1,0,Friendly,in the United States,5,-5,1907,1688,0,0,12,42,1902,1693,T1
5050,March 31,2015,Montserrat,Curaçao,2,2,World Cup qualifier,in Montserrat,16,-16,632,1065,3,-2,226,181,616,1081,draw
5051,March 31,2015,Spain,Netherlands,0,2,Friendly,in the Netherlands,-9,9,1953,2022,-1,0,7,5,1962,2013,T1
5052,March 31,2015,Costa Rica,Panama,1,2,Friendly,in Panama,-11,11,1850,1726,0,3,15,36,1861,1715,T1
5053,March 31,2015,Cape Verde,Portugal,2,0,Friendly,in Portugal,28,-28,1539,1890,9,-3,71,13,1511,1918,T2
5054,March 31,2015,Kazakhstan,Russia,0,0,Friendly,in Russia,9,-9,1349,1765,2,-1,123,25,1340,1774,draw
5055,March 31,2015,Guam,Singapore,2,2,Friendly,in Singapore,9,-9,814,1157,1,-1,208,167,805,1166,draw
5056,March 31,2015,Czechia,Slovakia,0,1,Friendly,in Slovakia,-8,8,1780,1761,-1,1,23,26,1788,1753,T1
5057,March 31,2015,New Zealand,South Korea,0,1,Friendly,in South Korea,-3,3,1516,1734,-3,2,80,30,1519,1731,T1
5058,March 31,2015,Sweden,Iran,3,1,Friendly,in Sweden,9,-9,1800,1738,1,-1,20,29,1791,1747,T1
5059,March 31,2015,United States,Switzerland,1,1,Friendly,in Switzerland,3,-3,1811,1795,1,-1,18,21,1808,1798,draw
5060,March 31,2015,Tajikistan,Syria,2,3,Friendly,in Tajikistan,-7,7,1266,1497,-1,3,139,85,1273,1490,T2
5061,March 31,2015,Ukraine,Latvia,1,1,Friendly,in Ukraine,-9,9,1807,1471,-1,4,19,93,1816,1462,draw
5062,March 31,2015,Peru,Venezuela,0,1,Friendly,in the United States,-12,12,1716,1687,-5,3,39,43,1728,1675,T1
5063,April 15,2015,Mexico,United States,0,2,Friendly,in the United States,-15,15,1892,1826,0,0,12,18,1907,1811,T1
5064,April 30,2015,Guyana,Suriname,0,1,Friendly,in Suriname,-7,7,1231,1242,-5,4,149,143,1238,1235,T1
5065,May 10,2015,Saint Kitts and Nevis,Barbados,3,1,Friendly,in Barbados,15,-15,1232,1110,8,-2,149,175,1217,1125,T2
5066,May 10,2015,Zambia,Malawi,2,0,Friendly,in Zambia,6,-6,1504,1355,0,-2,83,122,1498,1361,T1
5067,May 12,2015,Kazakhstan,Burkina Faso,0,0,Friendly,in Kazakhstan,1,-1,1350,1470,0,-1,123,94,1349,1471,draw
5068,May 12,2015,Saint Lucia,Dominica,1,1,Windward Islands Championship,in Saint Lucia,-10,10,1116,947,-1,3,173,195,1126,937,draw
5069,May 12,2015,Grenada,Saint Vincent and the Grenadines,2,3,Windward Islands Championship,in Saint Lucia,-15,15,1137,1178,0,2,169,164,1152,1163,T1
5070,May 13,2015,Cayman Islands,Dominican Republic,0,6,Friendly,in the Dominican Republic,-5,5,950,1227,0,4,193,151,955,1222,T1
5071,May 14,2015,Dominica,Grenada,2,1,Windward Islands Championship,in Saint Lucia,22,-22,969,1115,3,-3,192,172,947,1137,T1
5072,May 14,2015,South Africa,Lesotho,0,0,Friendly,in Lesotho,-6,6,1597,1246,-2,1,63,143,1603,1240,draw
5073,May 14,2015,Saint Vincent and the Grenadines,Saint Lucia,2,1,Windward Islands Championship,in Saint Lucia,17,-17,1195,1099,1,-3,163,176,1178,1116,T2
5074,May 16,2015,South Africa,Lesotho,1,1,Friendly,in Lesotho,-6,6,1591,1252,0,1,63,142,1597,1246,draw
5075,May 16,2015,Grenada,Saint Lucia,2,0,Windward Islands Championship,in Saint Lucia,28,-28,1143,1071,3,-4,169,180,1115,1099,T2
5076,May 16,2015,Dominica,Saint Vincent and the Grenadines,0,1,Windward Islands Championship,in Saint Lucia,-6,6,963,1201,0,1,192,162,969,1195,T1
5077,May 17,2015,Namibia,Seychelles,0,0,COSAFA Cup,in South Africa,-14,14,1271,993,-3,1,137,189,1285,979,draw
5078,May 17,2015,North Korea,Vietnam,1,1,Friendly,in Vietnam,-3,3,1445,1239,0,1,102,145,1448,1236,draw
5079,May 17,2015,Zimbabwe,Mauritius,2,0,COSAFA Cup,in South Africa,8,-8,1368,1024,2,0,118,187,1360,1032,T1
5080,May 18,2015,Madagascar,Lesotho,2,1,COSAFA Cup,in South Africa,23,-23,1215,1229,6,-8,158,150,1192,1252,T1
5081,May 18,2015,Swaziland,Tanzania,1,0,COSAFA Cup,in South Africa,31,-31,1168,1313,3,-5,167,130,1137,1344,T1
5082,May 19,2015,Namibia,Mauritius,2,0,COSAFA Cup,in South Africa,12,-12,1283,1012,3,0,134,187,1271,1024,T1
5083,May 19,2015,Zimbabwe,Seychelles,1,0,COSAFA Cup,in South Africa,4,-4,1372,989,0,-1,118,190,1368,993,T1
5084,May 20,2015,Curaçao,Suriname,3,2,Friendly,in the Netherlands,15,-15,1080,1227,2,-7,179,150,1065,1242,T1
5085,May 20,2015,Tanzania,Madagascar,0,2,COSAFA Cup,in South Africa,-38,38,1275,1253,-6,16,136,142,1313,1215,T1
5086,May 20,2015,Lesotho,Swaziland,0,2,COSAFA Cup,in South Africa,-35,35,1194,1203,-15,5,165,162,1229,1168,T1
5087,May 20,2015,Thailand,North Korea,0,1,Friendly,in Thailand,-11,11,1353,1456,-3,3,122,99,1364,1445,T2
5088,May 21,2015,Seychelles,Mauritius,0,1,COSAFA Cup,in South Africa,-19,19,970,1031,-1,0,191,187,989,1012,T1
5089,May 21,2015,Zimbabwe,Namibia,1,4,COSAFA Cup,in South Africa,-44,44,1328,1327,-9,5,127,128,1372,1283,T1
5090,May 22,2015,Tanzania,Lesotho,0,1,COSAFA Cup,in South Africa,-25,25,1250,1219,-5,7,141,158,1275,1194,T1
5091,May 22,2015,Swaziland,Madagascar,1,1,COSAFA Cup,in South Africa,3,-3,1206,1250,-1,1,163,141,1203,1253,draw
5092,May 22,2015,Malawi,South Africa,1,2,Friendly,in South Africa,-3,3,1352,1594,-1,0,121,63,1355,1591,T1
5093,May 24,2015,Lebanon,Syria,2,2,Friendly,in Lebanon,-1,1,1414,1498,0,2,108,83,1415,1497,draw
5094,May 24,2015,Zambia,Namibia,0,0,COSAFA Cup,in South Africa,-9,9,1495,1336,-2,2,85,126,1504,1327,draw
5095,May 24,2015,Botswana,South Africa,0,0,COSAFA Cup,in South Africa,16,-16,1316,1578,1,-1,131,64,1300,1594,draw
5096,May 24,2015,Vietnam,Thailand,0,1,World Cup and Asian Cup qualifier,in Thailand,-9,9,1230,1362,-5,2,149,118,1239,1353,T1
5097,May 25,2015,Ghana,Madagascar,1,2,COSAFA Cup,in South Africa,-38,38,1696,1288,-11,7,41,134,1734,1250,T1
5098,May 25,2015,Malawi,Mozambique,2,2,COSAFA Cup,in South Africa,2,-2,1354,1386,0,0,121,113,1352,1388,draw
5099,May 27,2015,South Africa,Malawi,0,0,COSAFA Cup,in South Africa,-15,15,1563,1369,-2,3,66,118,1578,1354,draw
5100,May 27,2015,Ghana,Zambia,0,3,COSAFA Cup,in South Africa,-53,53,1643,1548,-11,17,52,68,1696,1495,T1
5101,May 28,2015,Mozambique,Botswana,2,1,COSAFA Cup,in South Africa,16,-16,1402,1300,2,-1,111,132,1386,1316,T1
5102,May 28,2015,Namibia,Madagascar,3,2,COSAFA Cup,in South Africa,17,-17,1353,1271,4,-3,122,137,1336,1288,T1
5103,May 29,2015,Afghanistan,Laos,2,0,Friendly,in Laos,9,-9,1093,828,0,0,177,207,1084,837,T2
5104,May 29,2015,Malawi,Zambia,1,0,COSAFA Cup,in South Africa,29,-29,1398,1519,5,-10,113,78,1369,1548,T1
5105,May 30,2015,Oman,Bahrain,0,0,Friendly,in Bahrain,2,-2,1520,1476,2,0,78,90,1518,1478,draw
5106,May 30,2015,Bangladesh,Singapore,1,2,Friendly,in Bangladesh,-7,7,949,1164,-1,0,194,168,956,1157,T2
5107,May 30,2015,Lebanon,Jordan,0,0,Friendly,in Jordan,4,-4,1418,1469,1,-3,107,94,1414,1473,draw
5108,May 30,2015,Madagascar,Botswana,2,1,COSAFA Cup,in South Africa,22,-22,1293,1278,5,-3,132,135,1271,1300,T1
5109,May 30,2015,Guatemala,Mexico,0,3,Friendly,in Mexico,-2,2,1526,1894,-1,0,75,12,1528,1892,T1
5110,May 30,2015,Mozambique,Namibia,0,2,COSAFA Cup,in South Africa,-34,34,1368,1387,-8,8,119,114,1402,1353,T1
5111,May 31,2015,Honduras,El Salvador,2,0,Friendly,in the United States,15,-15,1523,1493,6,-4,76,86,1508,1508,T1
5112,May 31,2015,Northern Ireland,Qatar,1,1,Friendly,in England,0,0,1521,1528,-1,0,78,74,1521,1528,draw
5113,June 2,2015,Bangladesh,Afghanistan,1,1,Friendly,in Bangladesh,1,-1,950,1092,1,0,193,177,949,1093,draw
5114,June 2,2015,Cambodia,Laos,1,1,Friendly,in Cambodia,0,0,733,828,0,0,214,207,733,828,draw
5115,June 3,2015,Ecuador,Panama,1,1,Friendly,in Panama,0,0,1833,1726,0,0,17,35,1833,1726,draw
5116,June 3,2015,Mexico,Peru,1,1,Friendly,in Peru,-2,2,1892,1718,0,0,12,38,1894,1716,draw
5117,June 4,2015,Northern Ireland,Ireland,0,0,Friendly,in Ireland,7,-7,1528,1720,4,-2,74,35,1521,1727,draw
5118,June 5,2015,Puerto Rico,Bermuda,1,1,Friendly,in Bermuda,7,-7,1064,1228,2,-4,182,149,1057,1235,draw
5119,June 5,2015,Myanmar,Cambodia,0,1,Friendly,in Thailand,-17,17,1041,750,-3,0,186,214,1058,733,T1
5120,June 5,2015,Chile,El Salvador,1,0,Friendly,in Chile,1,-1,1937,1492,0,0,8,86,1936,1493,T1
5121,June 5,2015,Trinidad and Tobago,Curaçao,0,1,Friendly,in Curaçao,-18,18,1501,1098,-3,2,83,177,1519,1080,T1
5122,June 5,2015,Lithuania,Hungary,0,4,Friendly,in Hungary,-6,6,1458,1659,-1,2,97,48,1464,1653,T1
5123,June 5,2015,Kuwait,Jordan,2,2,Friendly,in Turkey,0,0,1465,1469,0,0,95,94,1465,1469,draw
5124,June 5,2015,Netherlands,United States,3,4,Friendly,in the Netherlands,-17,17,2005,1843,0,2,5,16,2022,1826,T2
5125,June 5,2015,Syria,Oman,2,1,Friendly,in Oman,13,-13,1511,1507,2,-3,81,82,1498,1520,T2
5126,June 5,2015,Qatar,Scotland,0,1,Friendly,in Scotland,-3,3,1525,1730,-2,0,76,33,1528,1727,T1
5127,June 5,2015,Bahrain,Thailand,1,1,Friendly,in Thailand,0,0,1476,1362,0,0,90,120,1476,1362,draw
5128,June 6,2015,Equatorial Guinea,Andorra,1,0,Friendly,in Andorra,3,-3,1396,971,0,0,113,190,1393,974,T2
5129,June 6,2015,Argentina,Bolivia,5,0,Friendly tournament,in Argentina,3,-3,2059,1625,0,0,3,53,2056,1628,T1
5130,June 6,2015,Cameroon,Burkina Faso,3,2,Friendly,in France,6,-6,1624,1464,3,-2,54,95,1618,1470,T1
5131,June 6,2015,Guinea,Chad,1,2,Friendly,in France,-17,17,1541,1264,-2,2,69,141,1558,1247,T1
5132,June 6,2015,Costa Rica,Colombia,0,1,Friendly,in Argentina,-5,5,1845,2029,0,0,15,4,1850,2024,T1
5133,June 6,2015,Panama,Ecuador,0,4,Friendly,in Ecuador,-9,9,1717,1842,-4,1,38,17,1726,1833,T1
5134,June 6,2015,Mali,Libya,2,2,Friendly,in Morocco,-2,2,1545,1485,1,1,67,88,1547,1483,draw
5135,June 6,2015,Hong Kong,Malaysia,0,0,Friendly,in Malaysia,4,-4,1158,1217,0,-2,169,158,1154,1221,draw
5136,June 6,2015,Niger,Gabon,2,1,Friendly,in Niger,13,-13,1279,1479,4,-3,135,89,1266,1492,T1
5137,June 6,2015,Paraguay,Honduras,2,2,Friendly,in Paraguay,-6,6,1682,1529,-1,4,42,73,1688,1523,draw
5138,June 6,2015,Kenya,Rwanda,0,0,Friendly tournament,in Rwanda,5,-5,1379,1381,1,0,116,115,1374,1386,draw
5139,June 6,2015,Brunei,Singapore,1,5,Friendly,in Singapore,-1,1,612,1165,0,0,230,168,613,1164,T1
5140,June 6,2015,Uruguay,Guatemala,5,1,Friendly,in Uruguay,2,-2,1915,1524,0,-2,10,77,1913,1526,T1
5141,June 7,2015,Brazil,Mexico,2,0,Friendly,in Brazil,5,-5,2070,1887,0,-1,2,13,2065,1892,T1
5142,June 7,2015,Croatia,Gibraltar,4,0,Friendly,in Croatia,0,0,1837,1131,0,-1,18,172,1837,1131,T1
5143,June 7,2015,Ethiopia,Zambia,0,1,Friendly,in Ethiopia,-8,8,1339,1527,0,3,124,76,1347,1519,T2
5144,June 7,2015,Belgium,France,4,3,Friendly,in France,14,-14,1927,1941,2,-1,9,7,1913,1955,T2
5145,June 7,2015,Ireland,England,0,0,Friendly,in Ireland,3,-3,1723,1925,-1,-1,35,10,1720,1928,draw
5146,June 7,2015,Kenya,South Sudan,2,0,Friendly tournament,in Rwanda,6,-6,1385,1058,1,-1,115,183,1379,1064,T1
5147,June 7,2015,Nicaragua,Suriname,1,0,World Cup qualifier,in Nicaragua,21,-21,1132,1206,2,-12,171,162,1111,1227,T1
5148,June 7,2015,Russia,Belarus,4,2,Friendly,in Russia,5,-5,1770,1565,1,-1,24,65,1765,1570,T1
5149,June 7,2015,Serbia,Azerbaijan,4,1,Friendly,in Austria,5,-5,1725,1411,0,0,34,108,1720,1416,T1
5150,June 8,2015,Montenegro,Denmark,1,2,Friendly,in Denmark,-4,4,1598,1763,0,1,61,26,1602,1759,T1
5151,June 8,2015,Egypt,Malawi,2,1,Friendly,in Egypt,3,-3,1623,1395,1,-1,56,113,1620,1398,T1
5152,June 8,2015,Ghana,Togo,1,0,Friendly,in Ghana,3,-3,1646,1435,1,0,51,103,1643,1438,T1
5153,June 8,2015,Lithuania,Malta,0,2,Friendly,in Malta,-20,20,1438,1245,-5,8,102,144,1458,1225,T1
5154,June 8,2015,Norway,Sweden,0,0,Friendly,in Norway,2,-2,1618,1798,0,0,58,20,1616,1800,draw
5155,June 8,2015,Bulgaria,Turkey,0,4,Friendly,in Turkey,-9,9,1607,1713,-2,0,60,40,1616,1704,T1
5156,June 9,2015,Democratic Republic of Congo,Cameroon,1,1,Friendly,in Belgium,4,-4,1495,1620,3,-3,84,57,1491,1624,draw
5157,June 9,2015,Estonia,Finland,2,0,Friendly,in Finland,24,-24,1482,1585,8,-4,89,63,1458,1609,T2
5158,June 9,2015,Moldova,Luxembourg,0,0,Friendly,in Luxembourg,-2,2,1399,1223,0,1,111,154,1401,1221,draw
5159,June 9,2015,Gambia,Uganda,1,1,Friendly,in Uganda,6,-6,1344,1492,1,-2,124,86,1338,1498,draw
5160,June 9,2015,Georgia,Ukraine,1,2,Friendly,in Austria,-3,3,1469,1810,-2,0,93,19,1472,1807,T1
5161,June 10,2015,Saint Lucia,Antigua and Barbuda,3,1,World Cup qualifier,in Antigua and Barbuda,51,-51,1122,1222,7,-17,174,155,1071,1273,T2
5162,June 10,2015,Barbados,Aruba,2,0,World Cup qualifier,in Aruba,25,-25,1135,924,3,-4,171,199,1110,949,T2
5163,June 10,2015,Honduras,Brazil,0,1,Friendly,in Brazil,0,0,1529,2070,0,0,73,2,1529,2070,T1
5164,June 10,2015,Curaçao,Cuba,0,0,World Cup qualifier,in Curaçao,11,-11,1109,1393,1,-4,176,113,1098,1404,draw
5165,June 10,2015,Germany,United States,1,2,Friendly,in Germany,-18,18,2109,1861,0,1,1,15,2127,1843,T2
5166,June 10,2015,Saint Vincent and the Grenadines,Guyana,2,2,World Cup qualifier,in Saint Vincent and the Grenadines,-4,4,1197,1235,-1,3,165,145,1201,1231,draw
5167,June 10,2015,Switzerland,Liechtenstein,3,0,Friendly,in Switzerland,1,-1,1796,1214,0,0,21,158,1795,1215,T1
5168,June 11,2015,Bangladesh,Kyrgyzstan,1,3,World Cup and Asian Cup qualifier,in Bangladesh,-26,26,924,1125,-5,3,198,175,950,1099,T2
5169,June 11,2015,Singapore,Cambodia,4,0,World Cup and Asian Cup qualifier,in Cambodia,11,-11,1176,739,2,0,166,214,1165,750,T2
5170,June 11,2015,Chile,Ecuador,2,0,Copa América,in Chile,18,-18,1955,1824,1,-1,7,18,1937,1842,T1
5171,June 11,2015,Canada,Dominica,2,0,World Cup qualifier,in Dominica,4,-4,1526,959,2,0,77,192,1522,963,T2
5172,June 11,2015,Dominican Republic,Belize,1,2,World Cup qualifier,in the Dominican Republic,-31,31,1196,1149,-15,5,165,170,1227,1118,T2
5173,June 11,2015,Guam,Turkmenistan,1,0,World Cup and Asian Cup qualifier,in Guam,35,-35,849,1227,1,-9,207,150,814,1262,T1
5174,June 11,2015,Bhutan,Hong Kong,0,7,World Cup and Asian Cup qualifier,in Hong Kong,-2,2,584,1160,0,0,232,169,586,1158,T1
5175,June 11,2015,India,Oman,1,2,World Cup and Asian Cup qualifier,in India,-5,5,1068,1512,0,0,181,82,1073,1507,T2
5176,June 11,2015,Japan,Iraq,4,0,Friendly,in Japan,5,-5,1775,1524,0,-5,24,78,1770,1529,T1
5177,June 11,2015,Laos,Myanmar,2,2,World Cup and Asian Cup qualifier,in Laos,6,-6,834,1035,-1,0,208,186,828,1041,draw
5178,June 11,2015,Lebanon,Kuwait,0,1,World Cup and Asian Cup qualifier,in Lebanon,-23,23,1395,1488,-4,7,111,88,1418,1465,T2
5179,June 11,2015,Malaysia,East Timor,1,1,World Cup and Asian Cup qualifier,in Malaysia,-19,19,1198,719,-6,2,163,216,1217,700,draw
5180,June 11,2015,Maldives,Qatar,0,1,World Cup and Asian Cup qualifier,in the Maldives,-4,4,1049,1529,0,4,185,73,1053,1525,T2
5181,June 11,2015,North Korea,Yemen,1,0,World Cup and Asian Cup qualifier,in Qatar,8,-8,1464,1200,3,-2,95,161,1456,1208,T1
5182,June 11,2015,Bahrain,Philippines,1,2,World Cup and Asian Cup qualifier,in the Philippines,-28,28,1448,1251,-10,13,101,140,1476,1223,T1
5183,June 11,2015,Palestine,Saudi Arabia,2,3,World Cup and Asian Cup qualifier,in Saudi Arabia,-5,5,1263,1500,-1,0,139,84,1268,1495,T1
5184,June 11,2015,United Arab Emirates,South Korea,0,3,Friendly,in Malaysia,-14,14,1652,1748,-3,2,50,28,1666,1734,T1
5185,June 11,2015,Spain,Costa Rica,2,1,Friendly,in Spain,5,-5,1958,1840,0,0,6,16,1953,1845,T1
5186,June 11,2015,Saint Kitts and Nevis,El Salvador,2,2,World Cup qualifier,in Saint Kitts and Nevis,9,-9,1241,1483,3,-4,144,90,1232,1492,draw
5187,June 11,2015,Afghanistan,Syria,0,6,World Cup and Asian Cup qualifier,in Iran,-7,7,1085,1518,0,1,179,80,1092,1511,T1
5188,June 11,2015,Jordan,Tajikistan,3,1,World Cup and Asian Cup qualifier,in Tajikistan,21,-21,1490,1245,6,-3,87,142,1469,1266,T2
5189,June 11,2015,Uzbekistan,Iran,0,1,Friendly,in Uzbekistan,-10,10,1612,1748,-2,1,58,28,1622,1738,T2
5190,June 12,2015,Andorra,Cyprus,1,3,European Championship qualifier,in Andorra,-8,8,963,1411,-1,0,191,108,971,1403,T2
5191,June 12,2015,Bolivia,Mexico,0,0,Copa América,in Chile,16,-16,1641,1871,0,-1,53,14,1625,1887,draw
5192,June 12,2015,Bosnia and Herzegovina,Israel,3,1,European Championship qualifier,in Bosnia and Herzegovina,15,-15,1731,1609,7,-4,32,58,1716,1624,T1
5193,June 12,2015,Italy,Croatia,1,1,European Championship qualifier,in Croatia,4,-4,1879,1833,1,0,13,17,1875,1837,draw
5194,June 12,2015,Guatemala,Bermuda,0,0,World Cup qualifier,in Guatemala,-16,16,1508,1244,-3,6,81,143,1524,1228,draw
5195,June 12,2015,Czechia,Iceland,1,2,European Championship qualifier,in Iceland,-20,20,1760,1696,-4,3,27,42,1780,1676,T1
5196,June 12,2015,Turkey,Kazakhstan,1,0,European Championship qualifier,in Kazakhstan,7,-7,1720,1343,3,-1,37,124,1713,1350,T2
5197,June 12,2015,Netherlands,Latvia,2,0,European Championship qualifier,in Latvia,5,-5,2010,1466,0,-1,5,94,2005,1471,T2
5198,June 12,2015,Bulgaria,Malta,1,0,European Championship qualifier,in Malta,7,-7,1614,1238,3,-4,56,146,1607,1245,T2
5199,June 12,2015,Libya,Morocco,0,1,African Nations Cup qualifier,in Morocco,-12,12,1473,1552,-3,3,92,67,1485,1540,T1
5200,June 12,2015,Norway,Azerbaijan,0,0,European Championship qualifier,in Norway,-14,14,1604,1425,-2,1,59,106,1618,1411,draw
5201,June 12,2015,Puerto Rico,Grenada,1,0,World Cup qualifier,in Puerto Rico,19,-19,1083,1124,2,-4,180,175,1064,1143,T1
5202,June 12,2015,Guinea,Swaziland,1,2,African Nations Cup qualifier,in Morocco,-35,35,1506,1241,-13,15,82,144,1541,1206,T1
5203,June 12,2015,Tunisia,Djibouti,8,1,African Nations Cup qualifier,in Tunisia,1,-1,1571,787,0,0,64,211,1570,788,T1
5204,June 12,2015,Wales,Belgium,1,0,European Championship qualifier,in Wales,28,-28,1699,1899,5,-2,41,11,1671,1927,T1
5205,June 13,2015,Albania,France,1,0,Friendly,in Albania,16,-16,1607,1925,3,0,59,8,1591,1941,T1
5206,June 13,2015,Algeria,Seychelles,4,0,African Nations Cup qualifier,in Algeria,1,-1,1678,969,0,0,46,190,1677,970,T1
5207,June 13,2015,Central African Republic,Angola,0,4,African Nations Cup qualifier,in Angola,-11,11,1227,1446,-5,1,151,102,1238,1435,T1
5208,June 13,2015,Argentina,Paraguay,2,2,Copa América,in Chile,-20,20,2039,1702,0,3,3,41,2059,1682,draw
5209,June 13,2015,Portugal,Armenia,3,2,European Championship qualifier,in Armenia,8,-8,1898,1529,0,-1,12,72,1890,1537,T2
5210,June 13,2015,Comoros,Burkina Faso,0,2,African Nations Cup qualifier,in Burkina Faso,-1,1,894,1465,0,1,202,94,895,1464,T1
5211,June 13,2015,Cape Verde,São Tomé and Príncipe,7,1,African Nations Cup qualifier,in Cape Verde,3,-3,1542,1078,1,0,69,181,1539,1081,T1
5212,June 13,2015,Denmark,Serbia,2,0,European Championship qualifier,in Denmark,19,-19,1782,1706,3,-5,22,40,1763,1725,T1
5213,June 13,2015,Faroe Islands,Greece,2,1,European Championship qualifier,in the Faroe Islands,35,-35,1260,1643,13,-7,140,52,1225,1678,T1
5214,June 13,2015,Finland,Hungary,0,1,European Championship qualifier,in Finland,-21,21,1564,1680,-2,2,65,45,1585,1659,T2
5215,June 13,2015,Gibraltar,Germany,0,7,European Championship qualifier,in Portugal,0,0,1131,2109,0,0,173,1,1131,2109,T1
5216,June 13,2015,Ireland,Scotland,1,1,European Championship qualifier,in Ireland,-5,5,1718,1735,-1,2,37,32,1723,1730,draw
5217,June 13,2015,Zimbabwe,Malawi,2,1,African Nations Cup qualifier,in Malawi,29,-29,1357,1366,4,-8,124,119,1328,1395,T2
5218,June 13,2015,South Sudan,Mali,0,2,African Nations Cup qualifier,in Mali,-2,2,1056,1547,0,0,183,68,1058,1545,T1
5219,June 13,2015,Chad,Nigeria,0,2,African Nations Cup qualifier,in Nigeria,-3,3,1261,1662,-1,-1,139,48,1264,1659,T1
5220,June 13,2015,Romania,Northern Ireland,0,0,European Championship qualifier,in Northern Ireland,-9,9,1778,1537,-1,4,23,70,1787,1528,draw
5221,June 13,2015,Georgia,Poland,0,4,European Championship qualifier,in Poland,-8,8,1461,1742,-4,1,97,30,1469,1734,T1
5222,June 13,2015,Senegal,Burundi,3,1,African Nations Cup qualifier,in Senegal,4,-4,1663,1313,0,0,47,130,1659,1317,T1
5223,June 13,2015,Gambia,South Africa,0,0,African Nations Cup qualifier,in South Africa,15,-15,1359,1548,1,-1,122,67,1344,1563,draw
5224,June 13,2015,Uganda,Botswana,2,0,African Nations Cup qualifier,in Uganda,8,-8,1500,1270,2,-1,84,137,1492,1278,T1
5225,June 13,2015,Uruguay,Jamaica,1,0,Copa América,in Chile,5,-5,1920,1537,0,-1,10,70,1915,1542,T1
5226,June 13,2015,Zambia,Guinea-Bissau,0,0,African Nations Cup qualifier,in Zambia,-16,16,1511,1250,-5,7,80,142,1527,1234,draw
5227,June 14,2015,Antigua and Barbuda,Saint Lucia,4,1,World Cup qualifier,in Antigua and Barbuda,17,-17,1239,1105,7,-2,148,178,1222,1122,T1
5228,June 14,2015,Aruba,Barbados,0,1,World Cup qualifier,in Barbados,-6,6,918,1141,-1,0,199,171,924,1135,T1
5229,June 14,2015,Spain,Belarus,1,0,European Championship qualifier,in Belarus,6,-6,1964,1559,0,-1,6,65,1958,1565,T2
5230,June 14,2015,Dominican Republic,Belize,0,3,World Cup qualifier,in Belize,-30,30,1166,1179,-4,5,169,165,1196,1149,T1
5231,June 14,2015,Peru,Brazil,1,2,Copa América,in Chile,-6,6,1712,2076,-3,0,40,2,1718,2070,T1
5232,June 14,2015,Mauritania,Cameroon,0,1,African Nations Cup qualifier,in Cameroon,-2,2,1205,1622,-1,0,160,55,1207,1620,T1
5233,June 14,2015,Kenya,Congo,1,1,African Nations Cup qualifier,in Congo,9,-9,1394,1444,3,-3,111,102,1385,1453,draw
5234,June 14,2015,Cuba,Curaçao,1,1,World Cup qualifier,in Cuba,-16,16,1377,1125,-3,3,115,174,1393,1109,draw
5235,June 14,2015,Madagascar,Democratic Republic of Congo,1,2,African Nations Cup qualifier,in the Democratic Republic of the Congo,-6,6,1287,1501,-1,3,133,83,1293,1495,T1
5236,June 14,2015,Egypt,Tanzania,3,0,African Nations Cup qualifier,in Egypt,4,-4,1627,1246,0,-1,54,143,1623,1250,T1
5237,June 14,2015,Benin,Equatorial Guinea,1,1,African Nations Cup qualifier,in Equatorial Guinea,7,-7,1380,1389,3,-3,114,113,1373,1396,draw
5238,June 14,2015,Estonia,San Marino,2,0,European Championship qualifier,in Estonia,1,-1,1483,886,1,0,89,203,1482,887,T1
5239,June 14,2015,Ethiopia,Lesotho,2,1,African Nations Cup qualifier,in Ethiopia,9,-9,1348,1210,1,-1,125,157,1339,1219,T1
5240,June 14,2015,Ivory Coast,Gabon,0,0,Friendly,in Gabon,-4,4,1737,1483,-1,2,32,89,1741,1479,draw
5241,June 14,2015,Ghana,Mauritius,7,1,African Nations Cup qualifier,in Ghana,1,-1,1647,1030,0,0,50,187,1646,1031,T1
5242,June 14,2015,Saint Vincent and the Grenadines,Guyana,4,4,World Cup qualifier,in Guyana,8,-8,1205,1227,4,-2,160,151,1197,1235,draw
5243,June 14,2015,Moldova,Liechtenstein,1,1,European Championship qualifier,in Liechtenstein,-5,5,1394,1219,-2,1,111,156,1399,1214,draw
5244,June 14,2015,Switzerland,Lithuania,2,1,European Championship qualifier,in Lithuania,7,-7,1803,1431,0,-1,21,104,1796,1438,T2
5245,June 14,2015,Mozambique,Rwanda,0,1,African Nations Cup qualifier,in Mozambique,-25,25,1343,1406,-8,6,126,109,1368,1381,T2
5246,June 14,2015,Niger,Namibia,1,0,African Nations Cup qualifier,in Niger,20,-20,1299,1367,3,-4,132,117,1279,1387,T1
5247,June 14,2015,Russia,Austria,0,1,European Championship qualifier,in Russia,-28,28,1742,1748,-5,8,30,27,1770,1720,T2
5248,June 14,2015,Slovakia,Macedonia,2,1,European Championship qualifier,in Slovakia,4,-4,1765,1460,1,-2,25,97,1761,1464,T1
5249,June 14,2015,Slovenia,England,2,3,European Championship qualifier,in Slovenia,-11,11,1635,1936,-3,0,53,8,1646,1925,T2
5250,June 14,2015,Sierra Leone,Sudan,0,1,African Nations Cup qualifier,in Sudan,-15,15,1323,1350,-2,4,129,124,1338,1335,T1
5251,June 14,2015,Montenegro,Sweden,1,3,European Championship qualifier,in Sweden,-9,9,1589,1807,-1,0,62,20,1598,1798,T1
5252,June 14,2015,Liberia,Togo,1,2,African Nations Cup qualifier,in Togo,-8,8,1284,1443,-1,1,134,103,1292,1435,T1
5253,June 14,2015,Luxembourg,Ukraine,0,3,European Championship qualifier,in Ukraine,-1,1,1222,1811,-1,0,155,19,1223,1810,T1
5254,June 14,2015,Colombia,Venezuela,0,1,Copa América,in Chile,-44,44,1985,1731,-1,10,5,34,2029,1687,T1
5255,June 15,2015,Bermuda,Guatemala,0,1,World Cup qualifier,in Bermuda,-11,11,1233,1519,-4,4,149,77,1244,1508,T2
5256,June 15,2015,Ecuador,Bolivia,2,3,Copa América,in Chile,-37,37,1787,1678,-3,6,21,46,1824,1641,T1
5257,June 15,2015,Chile,Mexico,3,3,Copa América,in Chile,-12,12,1943,1883,0,1,7,13,1955,1871,draw
5258,June 16,2015,Uruguay,Argentina,0,1,Copa América,in Chile,-17,17,1903,2056,-1,0,11,3,1920,2039,T1
5259,June 16,2015,Bangladesh,Tajikistan,1,1,World Cup and Asian Cup qualifier,in Bangladesh,11,-11,935,1234,1,-4,197,148,924,1245,draw
5260,June 16,2015,China,Bhutan,6,0,World Cup and Asian Cup qualifier,in Bhutan,0,0,1598,584,1,0,60,232,1598,584,T2
5261,June 16,2015,Cambodia,Afghanistan,0,1,World Cup and Asian Cup qualifier,in Cambodia,-8,8,731,1093,0,0,214,179,739,1085,T2
5262,June 16,2015,Dominica,Canada,0,4,World Cup qualifier,in Canada,-2,2,957,1528,0,1,192,74,959,1526,T1
5263,June 16,2015,East Timor,United Arab Emirates,0,1,World Cup and Asian Cup qualifier,in East Timor,0,0,719,1652,0,0,216,50,719,1652,T2
5264,June 16,2015,Saint Kitts and Nevis,El Salvador,1,4,World Cup qualifier,in El Salvador,-9,9,1232,1492,-5,1,150,88,1241,1483,T1
5265,June 16,2015,Grenada,Puerto Rico,2,0,World Cup qualifier,in Grenada,18,-18,1142,1065,4,-1,172,181,1124,1083,T1
5266,June 16,2015,Guam,India,2,1,World Cup and Asian Cup qualifier,in Guam,27,-27,876,1041,2,-2,205,184,849,1068,T1
5267,June 16,2015,Hong Kong,Maldives,2,0,World Cup and Asian Cup qualifier,in Hong Kong,14,-14,1174,1035,4,0,166,185,1160,1049,T1
5268,June 16,2015,Singapore,Japan,0,0,World Cup and Asian Cup qualifier,in Japan,19,-19,1195,1756,4,-2,162,26,1176,1775,draw
5269,June 16,2015,Trinidad and Tobago,Jordan,0,3,Friendly,in Jordan,-13,13,1488,1503,-6,4,89,83,1501,1490,T1
5270,June 16,2015,Australia,Kyrgyzstan,2,1,World Cup and Asian Cup qualifier,in Kyrgyzstan,2,-2,1733,1123,1,-2,33,176,1731,1125,T2
5271,June 16,2015,Laos,Lebanon,0,2,World Cup and Asian Cup qualifier,in Laos,-4,4,830,1399,0,0,208,110,834,1395,T2
5272,June 16,2015,Malaysia,Palestine,0,6,World Cup and Asian Cup qualifier,in Malaysia,-47,47,1151,1310,-7,7,171,131,1198,1263,T2
5273,June 16,2015,North Korea,Uzbekistan,4,2,World Cup and Asian Cup qualifier,in North Korea,34,-34,1498,1578,8,-5,87,62,1464,1612,T1
5274,June 16,2015,Jamaica,Paraguay,0,1,Copa América,in Chile,-14,14,1523,1716,-6,2,76,40,1537,1702,T1
5275,June 16,2015,Philippines,Yemen,2,0,World Cup and Asian Cup qualifier,in Qatar,26,-26,1277,1174,4,-4,137,166,1251,1200,T1
5276,June 16,2015,Greece,Poland,0,0,Friendly,in Poland,5,-5,1648,1737,1,0,51,30,1643,1742,draw
5277,June 16,2015,Italy,Portugal,0,1,Friendly,in Switzerland,-9,9,1870,1907,0,2,14,10,1879,1898,T1
5278,June 16,2015,South Africa,Angola,2,1,Friendly,in South Africa,5,-5,1553,1441,1,-2,66,103,1548,1446,T1
5279,June 16,2015,South Korea,Myanmar,2,0,World Cup and Asian Cup qualifier,in Thailand,1,-1,1749,1034,0,0,27,186,1748,1035,T1
5280,June 16,2015,Suriname,Nicaragua,1,3,World Cup qualifier,in Suriname,-44,44,1162,1176,-11,8,170,164,1206,1132,T2
5281,June 16,2015,Thailand,Taiwan,2,0,World Cup and Asian Cup qualifier,in Taiwan,4,-4,1366,785,1,-1,118,211,1362,789,T2
5282,June 16,2015,Iran,Turkmenistan,1,1,World Cup and Asian Cup qualifier,in Turkmenistan,-17,17,1731,1244,-7,7,34,144,1748,1227,draw
5283,June 17,2015,Brazil,Colombia,0,1,Copa América,in Chile,-31,31,2045,2016,-1,1,3,4,2076,1985,T1
5284,June 18,2015,Peru,Venezuela,1,0,Copa América,in Chile,26,-26,1738,1705,11,-8,30,42,1712,1731,T1
5285,June 19,2015,Bolivia,Chile,0,5,Copa América,in Chile,-11,11,1667,1954,-1,0,47,7,1678,1943,T1
5286,June 19,2015,Ecuador,Mexico,2,1,Copa América,in Chile,32,-32,1819,1851,3,-2,18,15,1787,1883,T1
5287,June 20,2015,Jamaica,Argentina,0,1,Copa América,in Chile,-2,2,1521,2058,0,0,76,2,1523,2056,T1
5288,June 20,2015,Uruguay,Paraguay,1,1,Copa América,in Chile,-12,12,1891,1728,-1,3,12,37,1903,1716,draw
5289,June 21,2015,Brazil,Venezuela,2,1,Copa América,in Chile,6,-6,2051,1699,0,0,3,42,2045,1705,T1
5290,June 21,2015,Colombia,Peru,0,0,Copa América,in Chile,-17,17,1999,1755,-1,3,5,27,2016,1738,draw
5291,June 24,2015,Chile,Uruguay,1,0,Copa América,in Chile,14,-14,1968,1877,1,0,6,12,1954,1891,T1
5292,June 25,2015,Bolivia,Peru,1,3,Copa América,in Chile,-28,28,1639,1783,-5,5,52,22,1667,1755,T1
5293,June 26,2015,Argentina,Colombia,0,0,Copa América,in Chile,-4,4,2054,2003,0,0,2,5,2058,1999,draw
5294,June 27,2015,Brazil,Paraguay,1,1,Copa América,in Chile,-18,18,2033,1746,0,7,3,30,2051,1728,draw
5295,June 27,2015,Mexico,Costa Rica,2,2,Friendly,in the United States,0,0,1851,1840,0,0,15,16,1851,1840,draw
5296,June 29,2015,Peru,Chile,1,2,Copa América,in Chile,-8,8,1775,1976,-2,0,24,6,1783,1968,T1
5297,June 30,2015,Argentina,Paraguay,6,1,Copa América,in Chile,15,-15,2069,1731,0,-5,2,35,2054,1746,T1
5298,July 1,2015,Honduras,Mexico,0,0,Friendly,in the United States,7,-7,1536,1844,0,0,71,15,1529,1851,draw
5299,July 3,2015,Paraguay,Peru,0,2,Copa América,in Chile,-33,33,1698,1808,-8,4,43,20,1731,1775,T1
5300,July 3,2015,Trinidad and Tobago,Haiti,1,0,Friendly,in the United States,9,-9,1497,1443,1,-2,88,101,1488,1452,T1
5301,July 3,2015,United States,Guatemala,4,0,Friendly,in the United States,3,-3,1864,1516,0,-1,14,78,1861,1519,T1
5302,July 4,2015,Argentina,Chile,0,0,Copa América,in Chile,1,-1,2070,1975,0,0,2,6,2069,1976,draw
5303,July 6,2015,Malawi,Uganda,1,0,Friendly,in Malawi,11,-11,1377,1489,3,-4,115,89,1366,1500,T1
5304,July 7,2015,Panama,Haiti,1,1,CONCACAF Championship,in the United States,-16,16,1701,1459,-1,3,40,98,1717,1443,draw
5305,July 7,2015,Honduras,United States,1,2,CONCACAF Championship,in the United States,-4,4,1532,1868,0,0,71,14,1536,1864,T1
5306,July 8,2015,Canada,El Salvador,0,0,CONCACAF Championship,in the United States,-3,3,1525,1495,-1,0,75,88,1528,1492,draw
5307,July 8,2015,Costa Rica,Jamaica,2,2,CONCACAF Championship,in the United States,-18,18,1822,1539,-1,6,17,70,1840,1521,draw
5308,July 9,2015,Mexico,Cuba,6,0,CONCACAF Championship,in the United States,7,-7,1851,1370,0,-2,15,117,1844,1377,T1
5309,July 9,2015,Trinidad and Tobago,Guatemala,3,1,CONCACAF Championship,in the United States,40,-40,1537,1476,16,-14,71,92,1497,1516,T1
5310,July 10,2015,Honduras,Panama,1,1,CONCACAF Championship,in the United States,11,-11,1543,1690,4,-4,69,44,1532,1701,draw
5311,July 10,2015,United States,Haiti,1,0,CONCACAF Championship,in the United States,3,-3,1871,1456,1,0,13,98,1868,1459,T1
5312,July 11,2015,Costa Rica,El Salvador,1,1,CONCACAF Championship,in the United States,-18,18,1804,1513,-4,8,21,79,1822,1495,draw
5313,July 11,2015,Canada,Jamaica,0,1,CONCACAF Championship,in the United States,-24,24,1501,1563,-8,6,84,65,1525,1539,T1
5314,July 12,2015,Mexico,Guatemala,0,0,CONCACAF Championship,in the United States,-20,20,1831,1496,-1,4,16,88,1851,1476,draw
5315,July 12,2015,Trinidad and Tobago,Cuba,2,0,CONCACAF Championship,in the United States,21,-21,1558,1349,5,-7,67,124,1537,1370,T1
5316,July 13,2015,Haiti,Honduras,1,0,CONCACAF Championship,in the United States,31,-31,1487,1512,7,-8,91,79,1456,1543,T1
5317,July 13,2015,Panama,United States,1,1,CONCACAF Championship,in the United States,17,-17,1707,1854,5,-1,39,14,1690,1871,draw
5318,July 14,2015,Canada,Costa Rica,0,0,CONCACAF Championship,in Canada,13,-13,1514,1791,6,-1,78,22,1501,1804,draw
5319,July 14,2015,El Salvador,Jamaica,0,1,CONCACAF Championship,in Canada,-21,21,1492,1584,-10,3,88,62,1513,1563,T1
5320,July 15,2015,Cuba,Guatemala,1,0,CONCACAF Championship,in the United States,35,-35,1384,1461,10,-9,114,96,1349,1496,T1
5321,July 15,2015,Mexico,Trinidad and Tobago,4,4,CONCACAF Championship,in the United States,-16,16,1815,1574,-1,3,17,64,1831,1558,draw
5322,July 18,2015,Jamaica,Haiti,1,0,CONCACAF Championship,in the United States,18,-18,1602,1469,2,-3,60,93,1584,1487,T1
5323,July 18,2015,United States,Cuba,6,0,CONCACAF Championship,in the United States,4,-4,1858,1380,0,0,14,114,1854,1384,T1
5324,July 19,2015,Mexico,Costa Rica,1,0,CONCACAF Championship,in the United States,23,-23,1838,1768,2,-2,15,24,1815,1791,T1
5325,July 19,2015,Panama,Trinidad and Tobago,1,1,CONCACAF Championship,in the United States,-9,9,1698,1583,-3,1,42,63,1707,1574,draw
5326,July 22,2015,Panama,Mexico,1,2,CONCACAF Championship,in the United States,-15,15,1683,1853,-2,1,44,14,1698,1838,T1
5327,July 22,2015,Jamaica,United States,2,1,CONCACAF Championship,in the United States,44,-44,1646,1814,8,-3,52,17,1602,1858,T2
5328,July 25,2015,United States,Panama,1,1,CONCACAF Championship,in the United States,-15,15,1799,1698,-4,2,21,42,1814,1683,draw
5329,July 26,2015,Jamaica,Mexico,1,3,CONCACAF Championship,in the United States,-17,17,1629,1870,-2,1,54,13,1646,1853,T1
5330,July 31,2015,Mayotte,Maldives,3,1,Indian Ocean Games,in Réunion,13,-13,1213,1022,4,-2,157,187,1200,1035,T1
5331,July 31,2015,Mauritius,Réunion,0,1,Indian Ocean Games,in Réunion,-2,2,1028,1364,1,0,186,120,1030,1362,T1
5332,August 2,2015,South Korea,China,2,0,East Asian Cup,in China,26,-26,1775,1572,4,-3,24,64,1749,1598,T2
5333,August 2,2015,Madagascar,Mayotte,1,1,Indian Ocean Games,in Réunion,-3,3,1284,1216,0,0,134,157,1287,1213,draw
5334,August 2,2015,Maldives,Seychelles,2,1,Indian Ocean Games,in Réunion,13,-13,1035,956,2,-2,185,192,1022,969,T1
5335,August 2,2015,North Korea,Japan,2,1,East Asian Cup,in China,33,-33,1531,1723,13,-9,73,36,1498,1756,T1
5336,August 4,2015,Madagascar,Maldives,4,0,Indian Ocean Games,in Réunion,11,-11,1295,1024,0,-2,134,187,1284,1035,T1
5337,August 4,2015,Mayotte,Seychelles,1,0,Indian Ocean Games,in Réunion,5,-5,1221,951,1,0,156,192,1216,956,T1
5338,August 5,2015,China,North Korea,2,0,East Asian Cup,in China,18,-18,1590,1513,3,-6,61,79,1572,1531,T1
5339,August 5,2015,Japan,South Korea,1,1,East Asian Cup,in China,3,-3,1726,1772,0,0,36,24,1723,1775,draw
5340,August 6,2015,Mauritius,Mayotte,1,2,Indian Ocean Games,in Réunion,-7,7,1021,1228,-1,4,187,152,1028,1221,T1
5341,August 6,2015,Réunion,Madagascar,1,0,Indian Ocean Games,in Réunion,8,-8,1372,1287,2,0,118,134,1364,1295,T1
5342,August 7,2015,Mauritius,Madagascar,3,1,Indian Ocean Games,in Réunion,37,-37,1058,1250,5,-7,182,141,1021,1287,T1
5343,August 8,2015,Réunion,Mayotte,3,1,Indian Ocean Games,in Réunion,9,-9,1381,1219,4,-4,114,156,1372,1228,T1
5344,August 9,2015,China,Japan,1,1,East Asian Cup,in China,2,-2,1592,1724,0,0,61,36,1590,1726,draw
5345,August 9,2015,North Korea,South Korea,0,0,East Asian Cup,in China,13,-13,1526,1759,4,-3,75,27,1513,1772,draw
5346,August 19,2015,Fiji,Tonga,5,0,Friendly,in Fiji,1,-1,1281,684,0,0,135,221,1280,685,T1
5347,August 20,2015,Cambodia,Bhutan,2,0,Friendly,in Cambodia,6,-6,737,578,0,0,214,232,731,584,T1
5348,August 26,2015,Lebanon,Iraq,2,3,Friendly,in Lebanon,-9,9,1390,1533,-2,3,112,73,1399,1524,T2
5349,August 27,2015,Fiji,Eastern Samoa,6,0,Friendly,in Fiji,0,0,1281,382,0,0,135,238,1281,382,T1
5350,August 28,2015,Libya,Tanzania,2,1,Friendly,in Turkey,4,-4,1477,1242,0,-1,92,144,1473,1246,T1
5351,August 28,2015,Yemen,Oman,0,1,Friendly,in Oman,-1,1,1173,1513,-2,0,168,80,1174,1512,T1
5352,August 28,2015,Singapore,Qatar,0,4,Friendly,in Qatar,-3,3,1192,1532,0,0,162,74,1195,1529,T1
5353,August 28,2015,Rwanda,Ethiopia,3,1,Friendly,in Rwanda,9,-9,1415,1339,1,-2,108,127,1406,1348,T1
5354,August 28,2015,Saint Vincent and the Grenadines,Barbados,2,2,Friendly,in Saint Vincent and the Grenadines,-4,4,1201,1145,-1,1,161,172,1205,1141,draw
5355,August 28,2015,United Arab Emirates,Myanmar,1,0,Friendly,in the United Arab Emirates,0,0,1652,1034,0,0,49,186,1652,1034,T1
5356,August 29,2015,Laos,Cambodia,2,1,Friendly,in Thailand,7,-7,837,730,0,0,208,214,830,737,T1
5357,August 29,2015,Bangladesh,Malaysia,0,0,Friendly,in Malaysia,7,-7,942,1144,0,-1,197,172,935,1151,draw
5358,August 31,2015,India,Nepal,0,0,Friendly,in India,-6,6,1035,887,0,1,185,203,1041,881,draw
5359,August 31,2015,Palestine,Lebanon,0,0,Friendly,in Lebanon,5,-5,1315,1385,1,-1,130,113,1310,1390,draw
5360,August 31,2015,Tonga,Cook Islands,0,3,World Cup and Oceania Cup qualifier,in Tonga,-46,46,638,721,-4,8,225,216,684,675,T2
5361,August 31,2015,Eastern Samoa,Samoa,2,3,World Cup and Oceania Cup qualifier,in Tonga,-6,6,376,688,0,1,238,221,382,682,T1
5362,September 1,2015,Congo,Ghana,2,3,Friendly,in Congo,-7,7,1437,1654,-2,2,103,49,1444,1647,T2
5363,September 2,2015,Samoa,Cook Islands,0,1,World Cup and Oceania Cup qualifier,in Tonga,-18,18,670,739,-3,2,224,214,688,721,T1
5364,September 2,2015,Tonga,Eastern Samoa,1,2,World Cup and Oceania Cup qualifier,in Tonga,-36,36,602,412,-5,1,230,237,638,376,T2
5365,September 3,2015,Australia,Bangladesh,5,0,World Cup and Asian Cup qualifier,in Australia,0,0,1733,942,0,0,33,197,1733,942,T1
5366,September 3,2015,Croatia,Azerbaijan,0,0,European Championship qualifier,in Azerbaijan,-14,14,1819,1439,0,4,15,102,1833,1425,draw
5367,September 3,2015,North Korea,Bahrain,1,0,World Cup and Asian Cup qualifier,in Bahrain,21,-21,1547,1427,6,-6,70,106,1526,1448,T2
5368,September 3,2015,Bosnia and Herzegovina,Belgium,1,3,European Championship qualifier,in Belgium,-11,11,1720,1910,-3,1,37,10,1731,1899,T1
5369,September 3,2015,Norway,Bulgaria,1,0,European Championship qualifier,in Bulgaria,26,-26,1630,1588,6,-4,54,61,1604,1614,T2
5370,September 3,2015,China,Hong Kong,0,0,World Cup and Asian Cup qualifier,in China,-18,18,1574,1192,-3,4,64,162,1592,1174,draw
5371,September 3,2015,Cyprus,Wales,0,1,European Championship qualifier,in Cyprus,-10,10,1401,1709,0,1,109,39,1411,1699,T2
5372,September 3,2015,Czechia,Kazakhstan,2,1,European Championship qualifier,in Czechia,2,-2,1762,1341,0,-1,26,126,1760,1343,T1
5373,September 3,2015,Iran,Guam,6,0,World Cup and Asian Cup qualifier,in Iran,0,0,1731,876,-1,0,35,205,1731,876,T1
5374,September 3,2015,Taiwan,Iraq,1,5,World Cup and Asian Cup qualifier,in Iran,-1,1,784,1534,0,-1,211,74,785,1533,T1
5375,September 3,2015,Andorra,Israel,0,4,European Championship qualifier,in Israel,-1,1,962,1610,0,0,190,58,963,1609,T1
5376,September 3,2015,Malta,Italy,0,1,European Championship qualifier,in Italy,-1,1,1237,1871,0,0,147,13,1238,1870,T1
5377,September 3,2015,Japan,Cambodia,3,0,World Cup and Asian Cup qualifier,in Japan,0,0,1724,730,0,0,36,215,1724,730,T1
5378,September 3,2015,Kyrgyzstan,Jordan,0,0,World Cup and Asian Cup qualifier,in Jordan,18,-18,1141,1485,3,-5,173,89,1123,1503,draw
5379,September 3,2015,Myanmar,Kuwait,0,9,World Cup and Asian Cup qualifier,in Qatar,-7,7,1027,1495,0,3,186,86,1034,1488,T1
5380,September 3,2015,Iceland,Netherlands,1,0,European Championship qualifier,in the Netherlands,37,-37,1733,1973,11,-2,33,6,1696,2010,T2
5381,September 3,2015,Oman,Turkmenistan,3,1,World Cup and Asian Cup qualifier,in Oman,6,-6,1519,1238,2,-3,78,146,1513,1244,T1
5382,September 3,2015,Maldives,Philippines,0,2,Friendly,in the Philippines,-3,3,1021,1280,0,0,187,136,1024,1277,T1
5383,September 3,2015,Bhutan,Qatar,0,15,World Cup and Asian Cup qualifier,in Qatar,0,0,578,1532,0,-1,232,75,578,1532,T1
5384,September 3,2015,Saudi Arabia,East Timor,7,0,World Cup and Asian Cup qualifier,in Saudi Arabia,1,-1,1501,718,2,0,84,217,1500,719,T1
5385,September 3,2015,Laos,South Korea,0,8,World Cup and Asian Cup qualifier,in South Korea,0,0,837,1759,0,0,208,27,837,1759,T1
5386,September 3,2015,Singapore,Syria,0,1,World Cup and Asian Cup qualifier,in Oman,-5,5,1187,1523,-1,0,163,77,1192,1518,T1
5387,September 3,2015,Thailand,Afghanistan,2,0,Friendly,in Thailand,3,-3,1369,1090,1,0,119,179,1366,1093,T1
5388,September 3,2015,Turkey,Latvia,1,1,European Championship qualifier,in Turkey,-15,15,1705,1481,-4,2,41,92,1720,1466,draw
5389,September 3,2015,Malaysia,United Arab Emirates,0,10,World Cup and Asian Cup qualifier,in the United Arab Emirates,-3,3,1141,1655,-1,1,173,49,1144,1652,T1
5390,September 3,2015,Uzbekistan,Yemen,1,0,World Cup and Asian Cup qualifier,in Uzbekistan,2,-2,1580,1171,1,0,63,168,1578,1173,T1
5391,September 4,2015,Antigua and Barbuda,Guatemala,1,0,World Cup qualifier,in Antigua and Barbuda,27,-27,1266,1434,6,-7,139,103,1239,1461,T1
5392,September 4,2015,Bolivia,Argentina,0,7,Friendly,in the United States,-3,3,1636,2073,1,0,51,2,1639,2070,T1
5393,September 4,2015,Canada,Belize,3,0,World Cup qualifier,in Canada,5,-5,1519,1174,2,-2,78,166,1514,1179,T1
5394,September 4,2015,El Salvador,Curaçao,1,0,World Cup qualifier,in Curaçao,7,-7,1499,1118,1,0,86,176,1492,1125,T2
5395,September 4,2015,Albania,Denmark,0,0,European Championship qualifier,in Denmark,13,-13,1620,1769,3,-1,56,23,1607,1782,draw
5396,September 4,2015,Djibouti,Togo,0,2,African Nations Cup qualifier,in Djibouti,-2,2,785,1445,0,1,210,99,787,1443,T2
5397,September 4,2015,Eastern Samoa,Cook Islands,2,0,World Cup and Oceania Cup qualifier,in Tonga,52,-52,464,687,1,-7,236,221,412,739,T1
5398,September 4,2015,Faroe Islands,Northern Ireland,1,3,European Championship qualifier,in the Faroe Islands,-16,16,1244,1553,-3,5,143,68,1260,1537,T2
5399,September 4,2015,Georgia,Scotland,1,0,European Championship qualifier,in Georgia,29,-29,1490,1706,8,-8,88,40,1461,1735,T1
5400,September 4,2015,Poland,Germany,1,3,European Championship qualifier,in Germany,-4,4,1733,2113,-1,0,31,1,1737,2109,T1
5401,September 4,2015,Finland,Greece,1,0,European Championship qualifier,in Greece,30,-30,1594,1618,7,-6,59,57,1564,1648,T2
5402,September 4,2015,Haiti,Grenada,3,1,World Cup qualifier,in Grenada,13,-13,1482,1129,1,-2,93,174,1469,1142,T2
5403,September 4,2015,Romania,Hungary,0,0,European Championship qualifier,in Hungary,0,0,1778,1680,1,1,22,44,1778,1680,draw
5404,September 4,2015,Gibraltar,Ireland,0,4,European Championship qualifier,in Portugal,-2,2,1129,1720,1,2,174,36,1131,1718,T1
5405,September 4,2015,Jamaica,Nicaragua,2,3,World Cup qualifier,in Jamaica,-38,38,1591,1214,-5,7,60,158,1629,1176,T2
5406,September 4,2015,Trinidad and Tobago,Mexico,3,3,Friendly,in the United States,7,-7,1590,1863,1,0,61,14,1583,1870,draw
5407,September 4,2015,Uruguay,Panama,1,0,Friendly,in Panama,8,-8,1885,1690,0,0,12,43,1877,1698,T2
5408,September 4,2015,France,Portugal,1,0,Friendly,in Portugal,12,-12,1937,1895,1,0,8,11,1925,1907,T2
5409,September 4,2015,Armenia,Serbia,0,2,European Championship qualifier,in Serbia,-10,10,1519,1716,-2,2,78,38,1529,1706,T1
5410,September 4,2015,Aruba,Saint Vincent and the Grenadines,0,2,World Cup qualifier,in Saint Vincent and the Grenadines,-6,6,912,1207,0,0,199,161,918,1201,T1
5411,September 4,2015,Samoa,Tonga,3,0,World Cup and Oceania Cup qualifier,in Tonga,38,-38,708,564,7,-3,217,233,670,602,T2
5412,September 4,2015,Peru,United States,1,2,Friendly,in the United States,-7,7,1801,1806,-3,2,21,19,1808,1799,T1
5413,September 4,2015,Venezuela,Honduras,0,3,Friendly,in Venezuela,-29,29,1670,1541,-4,7,46,74,1699,1512,T2
5414,September 5,2015,Austria,Moldova,1,0,European Championship qualifier,in Austria,3,-3,1751,1391,-1,-1,29,111,1748,1394,T1
5415,September 5,2015,Burkina Faso,Botswana,0,1,African Nations Cup qualifier,in Botswana,-25,25,1440,1295,-4,4,100,134,1465,1270,T1
5416,September 5,2015,Costa Rica,Brazil,0,1,Friendly,in the United States,-4,4,1764,2037,0,0,24,3,1768,2033,T1
5417,September 5,2015,Burundi,Niger,2,0,African Nations Cup qualifier,in Burundi,20,-20,1333,1279,4,-4,127,137,1313,1299,T1
5418,September 5,2015,Paraguay,Chile,2,3,Friendly,in Chile,-2,2,1696,1977,0,0,42,5,1698,1975,T1
5419,September 5,2015,Comoros,Uganda,0,1,African Nations Cup qualifier,in the Comoros,-2,2,892,1491,0,0,202,89,894,1489,T2
5420,September 5,2015,Estonia,Lithuania,1,0,European Championship qualifier,in Estonia,12,-12,1495,1419,4,-3,87,107,1483,1431,T1
5421,September 5,2015,Sudan,Gabon,0,4,Friendly,in Gabon,-8,8,1342,1491,-1,2,125,89,1350,1483,T1
5422,September 5,2015,Guinea-Bissau,Congo,2,4,African Nations Cup qualifier,in Guinea-Bissau,-23,23,1227,1460,-12,6,153,96,1250,1437,T2
5423,September 5,2015,Liberia,Tunisia,1,0,African Nations Cup qualifier,in Liberia,30,-30,1314,1541,2,-6,132,72,1284,1571,T1
5424,September 5,2015,Macedonia,Luxembourg,0,1,European Championship qualifier,in Luxembourg,-28,28,1432,1250,-6,12,103,143,1460,1222,T1
5425,September 5,2015,Mauritania,South Africa,3,1,African Nations Cup qualifier,in Mauritania,48,-48,1253,1505,20,-15,142,83,1205,1553,T1
5426,September 5,2015,Liechtenstein,Montenegro,0,2,European Championship qualifier,in Montenegro,-4,4,1215,1593,-2,2,158,60,1219,1589,T1
5427,September 5,2015,Namibia,Senegal,0,2,African Nations Cup qualifier,in Namibia,-15,15,1352,1678,-3,2,123,45,1367,1663,T2
5428,September 5,2015,Sweden,Russia,0,1,European Championship qualifier,in Russia,-18,18,1789,1760,-3,3,21,26,1807,1742,T1
5429,September 5,2015,Ghana,Rwanda,1,0,African Nations Cup qualifier,in Rwanda,12,-12,1666,1403,2,0,48,108,1654,1415,T2
5430,September 5,2015,San Marino,England,0,6,European Championship qualifier,in San Marino,0,0,886,1936,0,0,204,9,886,1936,T2
5431,September 5,2015,Morocco,São Tomé and Príncipe,3,0,African Nations Cup qualifier,in São Tomé and Príncipe,7,-7,1559,1071,4,-1,66,181,1552,1078,T2
5432,September 5,2015,Seychelles,Ethiopia,1,1,African Nations Cup qualifier,in the Seychelles,14,-14,965,1325,2,-2,190,129,951,1339,draw
5433,September 5,2015,Equatorial Guinea,South Sudan,0,1,African Nations Cup qualifier,in South Sudan,-32,32,1357,1088,-9,3,121,180,1389,1056,T1
5434,September 5,2015,Spain,Slovakia,2,0,European Championship qualifier,in Spain,9,-9,1973,1756,1,-3,6,28,1964,1765,T1
5435,September 5,2015,Slovenia,Switzerland,2,3,European Championship qualifier,in Switzerland,-7,7,1628,1810,-1,2,53,18,1635,1803,T1
5436,September 5,2015,Nigeria,Tanzania,0,0,African Nations Cup qualifier,in Tanzania,-15,15,1647,1257,-2,3,50,141,1662,1242,draw
5437,September 5,2015,Belarus,Ukraine,1,3,European Championship qualifier,in Ukraine,-7,7,1552,1818,-1,0,68,17,1559,1811,T1
5438,September 6,2015,Benin,Mali,1,1,African Nations Cup qualifier,in Benin,4,-4,1384,1543,2,-2,112,71,1380,1547,draw
5439,September 6,2015,Andorra,Bosnia and Herzegovina,0,3,European Championship qualifier,in Bosnia and Herzegovina,0,0,962,1720,0,1,191,35,962,1720,T1
5440,September 6,2015,Libya,Cape Verde,1,2,African Nations Cup qualifier,in Egypt,-16,16,1461,1558,1,4,94,67,1477,1542,T1
5441,September 6,2015,Chad,Egypt,1,5,African Nations Cup qualifier,in Chad,-13,13,1248,1640,-5,2,145,52,1261,1627,T2
5442,September 6,2015,Central African Republic,Democratic Republic of Congo,2,0,African Nations Cup qualifier,in Central African Republic,44,-44,1271,1457,14,-12,139,96,1227,1501,T1
5443,September 6,2015,Belgium,Cyprus,1,0,European Championship qualifier,in Cyprus,3,-3,1913,1398,0,0,10,109,1910,1401,T2
5444,September 6,2015,Gambia,Cameroon,0,1,African Nations Cup qualifier,in The Gambia,-11,11,1348,1633,-5,1,124,54,1359,1622,T2
5445,September 6,2015,Kazakhstan,Iceland,0,0,European Championship qualifier,in Iceland,18,-18,1359,1715,6,-8,120,39,1341,1733,draw
5446,September 6,2015,Bulgaria,Italy,0,1,European Championship qualifier,in Italy,-4,4,1584,1875,0,0,63,13,1588,1871,T1
5447,September 6,2015,Sierra Leone,Ivory Coast,0,0,African Nations Cup qualifier,in Nigeria,17,-17,1340,1720,4,-5,126,35,1323,1737,draw
5448,September 6,2015,Kenya,Zambia,1,2,African Nations Cup qualifier,in Kenya,-19,19,1375,1530,-6,5,116,76,1394,1511,T2
5449,September 6,2015,Czechia,Latvia,2,1,European Championship qualifier,in Latvia,10,-10,1772,1471,2,1,23,93,1762,1481,T2
5450,September 6,2015,Algeria,Lesotho,3,1,African Nations Cup qualifier,in Lesotho,6,-6,1684,1204,1,-2,44,162,1678,1210,T2
5451,September 6,2015,Madagascar,Angola,0,0,African Nations Cup qualifier,in Madagascar,5,-5,1255,1436,1,-1,142,100,1250,1441,draw
5452,September 6,2015,Azerbaijan,Malta,2,2,European Championship qualifier,in Malta,-6,6,1433,1243,-1,1,102,147,1439,1237,draw
5453,September 6,2015,Mauritius,Mozambique,1,0,African Nations Cup qualifier,in Mauritius,30,-30,1088,1313,3,-8,180,132,1058,1343,T1
5454,September 6,2015,Croatia,Norway,0,2,European Championship qualifier,in Norway,-38,38,1781,1668,-6,4,21,48,1819,1630,T1
5455,September 6,2015,Swaziland,Malawi,2,2,African Nations Cup qualifier,in Swaziland,2,-2,1243,1375,-1,0,147,116,1241,1377,draw
5456,September 6,2015,Turkey,Netherlands,3,0,European Championship qualifier,in Turkey,51,-51,1756,1922,13,-3,28,9,1705,1973,T1
5457,September 6,2015,Wales,Israel,0,0,European Championship qualifier,in Wales,-10,10,1699,1620,-2,2,41,56,1709,1610,draw
5458,September 6,2015,Zimbabwe,Guinea,1,1,African Nations Cup qualifier,in Zimbabwe,3,-3,1360,1503,2,-1,119,83,1357,1506,draw
5459,September 7,2015,Portugal,Albania,1,0,European Championship qualifier,in Albania,11,-11,1906,1609,0,-2,11,58,1895,1620,T2
5460,September 7,2015,Armenia,Denmark,0,0,European Championship qualifier,in Armenia,8,-8,1527,1761,1,-1,77,25,1519,1769,draw
5461,September 7,2015,Finland,Faroe Islands,1,0,European Championship qualifier,in Finland,3,-3,1597,1241,0,-2,59,148,1594,1244,T1
5462,September 7,2015,Serbia,France,1,2,Friendly,in France,-3,3,1713,1940,-1,0,39,7,1716,1937,T1
5463,September 7,2015,Georgia,Ireland,0,1,European Championship qualifier,in Ireland,-5,5,1485,1725,0,1,90,34,1490,1720,T1
5464,September 7,2015,Myanmar,New Zealand,1,1,Friendly,in Myanmar,8,-8,1035,1508,1,0,185,81,1027,1516,draw
5465,September 7,2015,Hungary,Northern Ireland,1,1,European Championship qualifier,in Northern Ireland,-2,2,1678,1555,0,0,45,68,1680,1553,draw
5466,September 7,2015,Gibraltar,Poland,1,8,European Championship qualifier,in Poland,-2,2,1127,1735,-1,0,175,31,1129,1733,T1
5467,September 7,2015,Romania,Greece,0,0,European Championship qualifier,in Romania,-13,13,1765,1631,-1,3,23,55,1778,1618,draw
5468,September 7,2015,Germany,Scotland,3,2,European Championship qualifier,in Scotland,6,-6,2119,1700,0,0,1,40,2113,1706,T2
5469,September 8,2015,Argentina,Mexico,2,2,Friendly,in the United States,-5,5,2068,1868,0,0,2,14,2073,1863,draw
5470,September 8,2015,Aruba,Saint Vincent and the Grenadines,2,1,World Cup qualifier,in Aruba,30,-30,942,1177,2,-4,197,165,912,1207,T1
5471,September 8,2015,Bahrain,Yemen,4,0,World Cup and Asian Cup qualifier,in Qatar,14,-14,1441,1157,5,-2,100,170,1427,1171,T1
5472,September 8,2015,Bangladesh,Jordan,0,4,World Cup and Asian Cup qualifier,in Bangladesh,-5,5,937,1490,-1,1,198,89,942,1485,T2
5473,September 8,2015,Belarus,Luxembourg,2,0,European Championship qualifier,in Belarus,5,-5,1557,1245,1,-1,68,145,1552,1250,T1
5474,September 8,2015,Belize,Canada,1,1,World Cup qualifier,in Belize,12,-12,1186,1507,3,-3,163,82,1174,1519,draw
5475,September 8,2015,Syria,Cambodia,6,0,World Cup and Asian Cup qualifier,in Cambodia,2,-2,1525,728,0,0,78,214,1523,730,T2
5476,September 8,2015,Maldives,China,0,3,World Cup and Asian Cup qualifier,in China,-2,2,1019,1576,0,0,187,65,1021,1574,T1
5477,September 8,2015,Peru,Colombia,1,1,Friendly,in the United States,5,-5,1806,1998,2,0,17,4,1801,2003,draw
5478,September 8,2015,Uruguay,Costa Rica,0,1,Friendly,in Costa Rica,-11,11,1874,1775,-1,2,13,22,1885,1764,T1
5479,September 8,2015,Ecuador,Honduras,2,0,Friendly,in Ecuador,3,-3,1822,1538,0,-2,15,74,1819,1541,T1
5480,September 8,2015,Curaçao,El Salvador,0,1,World Cup qualifier,in El Salvador,-2,2,1116,1501,0,1,176,84,1118,1499,T1
5481,September 8,2015,Switzerland,England,0,2,European Championship qualifier,in England,-13,13,1797,1949,-2,1,19,7,1810,1936,T1
5482,September 8,2015,Oman,Guam,0,0,World Cup and Asian Cup qualifier,in Guam,-18,18,1501,894,-5,3,84,202,1519,876,draw
5483,September 8,2015,Antigua and Barbuda,Guatemala,0,2,World Cup qualifier,in Guatemala,-11,11,1255,1445,-1,3,141,98,1266,1434,T1
5484,September 8,2015,Grenada,Haiti,0,3,World Cup qualifier,in Haiti,-5,5,1124,1487,-1,2,175,90,1129,1482,T1
5485,September 8,2015,Qatar,Hong Kong,3,2,World Cup and Asian Cup qualifier,in Hong Kong,8,-8,1540,1184,2,-1,73,164,1532,1192,T2
5486,September 8,2015,Iran,India,3,0,World Cup and Asian Cup qualifier,in India,2,-2,1733,1033,0,-1,33,186,1731,1035,T2
5487,September 8,2015,Japan,Afghanistan,6,0,World Cup and Asian Cup qualifier,in Iran,2,-2,1726,1088,1,0,34,179,1724,1090,T1
5488,September 8,2015,Kuwait,Laos,2,0,World Cup and Asian Cup qualifier,in Laos,2,-2,1497,835,0,0,86,208,1495,837,T2
5489,September 8,2015,Lebanon,South Korea,0,3,World Cup and Asian Cup qualifier,in Lebanon,-12,12,1373,1771,-5,3,116,24,1385,1759,T2
5490,September 8,2015,Russia,Liechtenstein,7,0,European Championship qualifier,in Liechtenstein,6,-6,1766,1209,1,0,25,158,1760,1215,T2
5491,September 8,2015,San Marino,Lithuania,1,2,European Championship qualifier,in Lithuania,-1,1,885,1420,-1,0,205,107,886,1419,T1
5492,September 8,2015,Macedonia,Spain,0,1,European Championship qualifier,in Macedonia,-3,3,1429,1976,-1,0,104,6,1432,1973,T2
5493,September 8,2015,Saudi Arabia,Malaysia,2,1,World Cup and Asian Cup qualifier,in Malaysia,7,-7,1508,1134,4,-1,80,173,1501,1141,T2
5494,September 8,2015,Moldova,Montenegro,0,2,European Championship qualifier,in Moldova,-21,21,1370,1614,-8,2,118,58,1391,1593,T2
5495,September 8,2015,Nicaragua,Jamaica,0,2,World Cup qualifier,in Nicaragua,-10,10,1204,1601,-1,1,160,60,1214,1591,T2
5496,September 8,2015,Nigeria,Niger,2,0,Friendly,in Nigeria,2,-2,1649,1277,1,1,50,136,1647,1279,T1
5497,September 8,2015,Palestine,United Arab Emirates,0,0,World Cup and Asian Cup qualifier,in Palestine,12,-12,1327,1643,2,-1,128,51,1315,1655,draw
5498,September 8,2015,Uzbekistan,Philippines,5,1,World Cup and Asian Cup qualifier,in the Philippines,18,-18,1598,1262,3,-3,61,139,1580,1280,T2
5499,September 8,2015,Ukraine,Slovakia,0,0,European Championship qualifier,in Slovakia,2,-2,1820,1754,0,-1,16,29,1818,1756,draw
5500,September 8,2015,Slovenia,Estonia,1,0,European Championship qualifier,in Slovenia,8,-8,1636,1487,3,-4,53,90,1628,1495,T1
5501,September 8,2015,Senegal,South Africa,0,1,Friendly,in South Africa,-12,12,1666,1517,-3,3,48,79,1678,1505,T1
5502,September 8,2015,Sweden,Austria,1,4,European Championship qualifier,in Sweden,-48,48,1741,1799,-10,12,30,18,1789,1751,T2
5503,September 8,2015,Vietnam,Taiwan,2,1,World Cup and Asian Cup qualifier,in Taiwan,5,-5,1235,779,3,0,150,211,1230,784,T2
5504,September 8,2015,Australia,Tajikistan,3,0,World Cup and Asian Cup qualifier,in Tajikistan,6,-6,1739,1228,1,-3,31,153,1733,1234,T2
5505,September 8,2015,Iraq,Thailand,2,2,World Cup and Asian Cup qualifier,in Thailand,-4,4,1530,1373,-1,2,75,116,1534,1369,draw
5506,September 8,2015,Brazil,United States,4,1,Friendly,in the United States,11,-11,2048,1795,0,-2,3,20,2037,1806,T2
5507,September 8,2015,Panama,Venezuela,1,1,Friendly,in Venezuela,2,-2,1692,1668,0,1,43,46,1690,1670,draw
5508,September 8,2015,Zambia,Gabon,1,1,Friendly,in Zambia,-4,4,1526,1495,-1,1,77,87,1530,1491,draw
5509,September 12,2015,Rwanda,Gabon,0,1,Friendly,in Rwanda,-10,10,1393,1505,-1,4,109,83,1403,1495,T2
5510,September 30,2015,Ethiopia,Botswana,3,2,Friendly,in Botswana,12,-12,1337,1283,3,0,127,134,1325,1295,T2
5511,October 2,2015,Oman,Syria,2,1,Friendly,in Oman,8,-8,1509,1517,5,0,80,78,1501,1525,T1
5512,October 3,2015,Iraq,Jordan,0,3,Friendly,in Jordan,-15,15,1515,1505,-4,5,79,84,1530,1490,T1
5513,October 7,2015,Lesotho,Comoros,0,0,World Cup qualifier,in the Comoros,-11,11,1193,903,-1,1,161,202,1204,892,draw
5514,October 7,2015,Mauritius,Kenya,2,5,World Cup qualifier,in Mauritius,-18,18,1070,1393,-3,5,182,109,1088,1375,T2
5515,October 7,2015,Burundi,Seychelles,1,0,World Cup qualifier,in the Seychelles,7,-7,1340,958,2,-1,126,191,1333,965,T2
5516,October 7,2015,Malawi,Tanzania,0,2,World Cup qualifier,in Tanzania,-32,32,1343,1289,-10,6,124,134,1375,1257,T1
5517,October 8,2015,Serbia,Albania,2,0,European Championship qualifier,in Albania,30,-30,1743,1579,8,-6,31,65,1713,1609,T2
5518,October 8,2015,Argentina,Ecuador,0,2,World Cup qualifier,in Argentina,-53,53,2015,1875,-1,2,3,13,2068,1822,T2
5519,October 8,2015,Uzbekistan,Bahrain,4,0,World Cup and Asian Cup qualifier,in Bahrain,31,-31,1629,1410,8,-7,53,107,1598,1441,T2
5520,October 8,2015,Bhutan,Maldives,3,4,World Cup and Asian Cup qualifier,in Bhutan,-5,5,573,1024,0,0,231,187,578,1019,T2
5521,October 8,2015,Bolivia,Uruguay,0,2,World Cup qualifier,in Bolivia,-19,19,1617,1893,-4,1,57,12,1636,1874,T2
5522,October 8,2015,Brazil,Chile,0,2,World Cup qualifier,in Chile,-28,28,2020,2005,1,0,2,5,2048,1977,T1
5523,October 8,2015,Peru,Colombia,0,2,World Cup qualifier,in Colombia,-9,9,1797,2007,-1,0,18,4,1806,1998,T1
5524,October 8,2015,South Africa,Costa Rica,1,0,Friendly,in Costa Rica,18,-18,1535,1757,3,-4,74,26,1517,1775,T2
5525,October 8,2015,Nigeria,Democratic Republic of Congo,0,2,Friendly,in Belgium,-23,23,1626,1480,-4,3,54,93,1649,1457,T1
5526,October 8,2015,Palestine,East Timor,1,1,World Cup and Asian Cup qualifier,in East Timor,-18,18,1309,736,-1,2,130,214,1327,718,draw
5527,October 8,2015,Armenia,France,0,4,Friendly,in France,-2,2,1525,1942,-4,0,79,8,1527,1940,T1
5528,October 8,2015,Georgia,Gibraltar,4,0,European Championship qualifier,in Georgia,5,-5,1490,1122,3,-1,89,175,1485,1127,T1
5529,October 8,2015,Honduras,Guatemala,1,1,Friendly,in Honduras,-5,5,1533,1450,-1,0,75,98,1538,1445,draw
5530,October 8,2015,Hungary,Faroe Islands,2,1,European Championship qualifier,in Hungary,2,-2,1680,1239,1,-2,44,150,1678,1241,T1
5531,October 8,2015,Ireland,Germany,1,0,European Championship qualifier,in Ireland,34,-34,1759,2085,10,0,25,1,1725,2119,T1
5532,October 8,2015,Syria,Japan,0,3,World Cup and Asian Cup qualifier,in Oman,-16,16,1501,1742,-9,2,86,32,1517,1726,T1
5533,October 8,2015,Jordan,Australia,2,0,World Cup and Asian Cup qualifier,in Jordan,41,-41,1546,1698,13,-10,71,41,1505,1739,T1
5534,October 8,2015,South Korea,Kuwait,1,0,World Cup and Asian Cup qualifier,in Kuwait,11,-11,1782,1486,3,-4,21,92,1771,1497,T2
5535,October 8,2015,Kyrgyzstan,Tajikistan,2,2,World Cup and Asian Cup qualifier,in Kyrgyzstan,-1,1,1140,1229,0,-1,172,154,1141,1228,draw
5536,October 8,2015,Lebanon,Myanmar,2,0,World Cup and Asian Cup qualifier,in Thailand,8,-8,1381,1027,3,0,112,185,1373,1035,T1
5537,October 8,2015,Guinea-Bissau,Liberia,1,1,World Cup qualifier,in Liberia,10,-10,1237,1304,3,-2,151,133,1227,1314,draw
5538,October 8,2015,Laos,Malaysia,1,3,Friendly,in Thailand,-5,5,830,1139,0,0,208,173,835,1134,T1
5539,October 8,2015,Philippines,North Korea,0,0,World Cup and Asian Cup qualifier,in North Korea,16,-16,1278,1531,3,-6,137,76,1262,1547,draw
5540,October 8,2015,Greece,Northern Ireland,1,3,European Championship qualifier,in Northern Ireland,-28,28,1603,1583,-5,5,61,64,1631,1555,T1
5541,October 8,2015,Oman,Iran,1,1,World Cup and Asian Cup qualifier,in Oman,7,-7,1516,1726,0,-2,80,35,1509,1733,draw
5542,October 8,2015,Trinidad and Tobago,Panama,2,1,Friendly,in Panama,15,-15,1605,1677,3,-2,60,45,1590,1692,T2
5543,October 8,2015,Denmark,Portugal,0,1,European Championship qualifier,in Portugal,-8,8,1753,1914,-2,1,29,10,1761,1906,T1
5544,October 8,2015,Qatar,China,1,0,World Cup and Asian Cup qualifier,in Qatar,16,-16,1556,1560,3,-1,70,66,1540,1576,T1
5545,October 8,2015,Finland,Romania,1,1,European Championship qualifier,in Romania,13,-13,1610,1752,3,-4,59,30,1597,1765,draw
5546,October 8,2015,São Tomé and Príncipe,Ethiopia,1,0,World Cup qualifier,in São Tomé and Príncipe,29,-29,1100,1308,2,-3,179,131,1071,1337,T1
5547,October 8,2015,Saudi Arabia,United Arab Emirates,2,1,World Cup and Asian Cup qualifier,in Saudi Arabia,22,-22,1530,1621,4,-4,77,55,1508,1643,T1
5548,October 8,2015,Poland,Scotland,2,2,European Championship qualifier,in Scotland,4,-4,1739,1696,-2,-2,34,42,1735,1700,draw
5549,October 8,2015,Singapore,Afghanistan,1,0,World Cup and Asian Cup qualifier,in Singapore,10,-10,1197,1078,1,-2,161,181,1187,1088,T1
5550,October 8,2015,Mauritania,South Sudan,1,1,World Cup qualifier,in South Sudan,-4,4,1249,1092,0,-1,143,180,1253,1088,draw
5551,October 8,2015,Turkmenistan,India,2,1,World Cup and Asian Cup qualifier,in Turkmenistan,6,-6,1244,1027,2,1,147,185,1238,1033,T1
5552,October 8,2015,Paraguay,Venezuela,1,0,World Cup qualifier,in Venezuela,24,-24,1720,1644,6,-3,36,49,1696,1668,T2
5553,October 8,2015,Vietnam,Iraq,1,1,World Cup and Asian Cup qualifier,in Vietnam,10,-10,1245,1505,5,-4,145,83,1235,1515,draw
5554,October 9,2015,Algeria,Guinea,1,2,Friendly,in Algeria,-17,17,1667,1520,-3,5,46,80,1684,1503,T2
5555,October 9,2015,Djibouti,Swaziland,0,6,World Cup qualifier,in Djibouti,-10,10,775,1253,-1,5,211,143,785,1243,T2
5556,October 9,2015,England,Estonia,2,0,European Championship qualifier,in England,2,-2,1951,1485,0,-1,7,91,1949,1487,T1
5557,October 9,2015,Gambia,Namibia,1,1,World Cup qualifier,in The Gambia,-5,5,1343,1357,0,1,123,121,1348,1352,draw
5558,October 9,2015,Haiti,El Salvador,3,1,Friendly,in the United States,16,-16,1503,1485,4,-5,86,91,1487,1501,T1
5559,October 9,2015,Liechtenstein,Sweden,0,2,European Championship qualifier,in Liechtenstein,-5,5,1204,1746,-1,3,159,30,1209,1741,T2
5560,October 9,2015,Ukraine,Macedonia,2,0,European Championship qualifier,in Macedonia,9,-9,1829,1420,0,-3,16,106,1820,1429,T2
5561,October 9,2015,Mali,Burkina Faso,4,1,Friendly,in France,12,-12,1555,1428,2,-4,70,104,1543,1440,T1
5562,October 9,2015,Moldova,Russia,1,2,European Championship qualifier,in Moldova,-6,6,1364,1772,0,1,117,23,1370,1766,T2
5563,October 9,2015,Montenegro,Austria,2,3,European Championship qualifier,in Montenegro,-15,15,1599,1814,-4,0,62,17,1614,1799,T2
5564,October 9,2015,Morocco,Ivory Coast,0,1,Friendly,in Morocco,-8,8,1551,1728,-4,2,71,34,1559,1720,T2
5565,October 9,2015,Somalia,Niger,0,2,World Cup qualifier,in Ethiopia,-5,5,863,1282,0,2,206,136,868,1277,T1
5566,October 9,2015,Belarus,Slovakia,1,0,European Championship qualifier,in Slovakia,34,-34,1591,1720,6,-8,63,36,1557,1754,T2
5567,October 9,2015,Lithuania,Slovenia,1,1,European Championship qualifier,in Slovenia,14,-14,1434,1622,5,-3,101,54,1420,1636,draw
5568,October 9,2015,Spain,Luxembourg,4,0,European Championship qualifier,in Spain,1,-1,1977,1244,0,-2,6,147,1976,1245,T1
5569,October 9,2015,San Marino,Switzerland,0,7,European Championship qualifier,in Switzerland,0,0,885,1797,0,0,205,18,885,1797,T1
5570,October 9,2015,Taiwan,Macao,5,1,Friendly,in Taiwan,7,-7,786,613,1,0,210,228,779,620,T1
5571,October 9,2015,Thailand,Hong Kong,1,0,Friendly,in Thailand,3,-3,1376,1181,0,0,116,164,1373,1184,T1
5572,October 9,2015,Tunisia,Gabon,3,3,Friendly,in Tunisia,-4,4,1537,1509,0,1,73,82,1541,1505,draw
5573,October 10,2015,Belgium,Andorra,4,1,European Championship qualifier,in Andorra,1,-1,1914,961,1,0,10,190,1913,962,T2
5574,October 10,2015,Azerbaijan,Italy,1,3,European Championship qualifier,in Azerbaijan,-7,7,1426,1882,-3,-1,105,14,1433,1875,T2
5575,October 10,2015,Bosnia and Herzegovina,Wales,2,0,European Championship qualifier,in Bosnia and Herzegovina,20,-20,1740,1679,4,-3,32,43,1720,1699,T1
5576,October 10,2015,Sierra Leone,Chad,0,1,World Cup qualifier,in Chad,-20,20,1320,1268,-2,4,128,141,1340,1248,T1
5577,October 10,2015,Croatia,Bulgaria,3,0,European Championship qualifier,in Croatia,11,-11,1792,1573,1,-2,21,66,1781,1584,T1
5578,October 10,2015,Turkey,Czechia,2,0,European Championship qualifier,in Czechia,40,-40,1796,1732,7,-11,20,34,1756,1772,T2
5579,October 10,2015,Botswana,Eritrea,2,0,World Cup qualifier,in Eritrea,24,-24,1307,1085,3,-3,132,180,1283,1109,T2
5580,October 10,2015,Latvia,Iceland,2,2,European Championship qualifier,in Iceland,15,-15,1486,1700,4,0,90,39,1471,1715,draw
5581,October 10,2015,Israel,Cyprus,1,2,European Championship qualifier,in Israel,-35,35,1585,1433,-7,6,63,102,1620,1398,T2
5582,October 10,2015,Netherlands,Kazakhstan,2,1,European Championship qualifier,in Kazakhstan,3,-3,1925,1356,0,-2,9,121,1922,1359,T2
5583,October 10,2015,Kosovo,Equatorial Guinea,2,0,Friendly,in Kosovo,10,-10,1387,1347,4,-1,111,122,1377,1357,T1
5584,October 10,2015,Central African Republic,Madagascar,0,3,World Cup qualifier,in Madagascar,-27,27,1244,1282,-6,5,146,136,1271,1255,T1
5585,October 10,2015,Malta,Norway,0,2,European Championship qualifier,in Norway,-3,3,1240,1671,0,0,149,45,1243,1668,T1
5586,October 10,2015,Mexico,United States,3,2,CONCACAF Cup,in the United States,22,-22,1890,1773,2,-3,13,23,1868,1795,T2
5587,October 11,2015,Armenia,Albania,0,3,European Championship qualifier,in Armenia,-40,40,1485,1619,-12,9,91,56,1525,1579,T2
5588,October 11,2015,Denmark,France,1,2,Friendly,in Denmark,-7,7,1746,1949,-1,0,28,8,1753,1942,T2
5589,October 11,2015,Zambia,Egypt,0,3,Friendly,in the United Arab Emirates,-12,12,1514,1652,-2,1,80,49,1526,1640,T1
5590,October 11,2015,São Tomé and Príncipe,Ethiopia,0,3,World Cup qualifier,in Ethiopia,-10,10,1090,1318,-1,2,179,129,1100,1308,T1
5591,October 11,2015,Faroe Islands,Romania,0,3,European Championship qualifier,in the Faroe Islands,-6,6,1233,1758,-1,3,151,25,1239,1752,T2
5592,October 11,2015,Finland,Northern Ireland,1,1,European Championship qualifier,in Finland,-7,7,1603,1590,-3,0,60,64,1610,1583,draw
5593,October 11,2015,Georgia,Germany,1,2,European Championship qualifier,in Germany,-1,1,1489,2086,1,0,88,1,1490,2085,T1
5594,October 11,2015,Greece,Hungary,4,3,European Championship qualifier,in Greece,19,-19,1622,1661,6,-6,53,48,1603,1680,T1
5595,October 11,2015,Mauritius,Kenya,0,0,World Cup qualifier,in Kenya,17,-17,1087,1376,2,-6,180,115,1070,1393,draw
5596,October 11,2015,Tanzania,Malawi,0,1,World Cup qualifier,in Malawi,-12,12,1277,1355,-4,1,139,122,1289,1343,T1
5597,October 11,2015,Cameroon,Nigeria,0,3,Friendly,in Belgium,-18,18,1615,1644,-7,3,58,50,1633,1626,T1
5598,October 11,2015,Poland,Ireland,2,1,European Championship qualifier,in Poland,15,-15,1754,1744,6,-5,27,30,1739,1759,T1
5599,October 11,2015,Gibraltar,Scotland,0,6,European Championship qualifier,in Portugal,-3,3,1119,1699,0,1,175,40,1122,1696,T1
5600,October 11,2015,Serbia,Portugal,1,2,European Championship qualifier,in Serbia,-16,16,1727,1930,-5,1,35,9,1743,1914,T2
5601,October 12,2015,Liechtenstein,Austria,0,3,European Championship qualifier,in Austria,-1,1,1203,1815,-1,1,160,16,1204,1814,T1
5602,October 12,2015,Macedonia,Belarus,0,0,European Championship qualifier,in Belarus,13,-13,1433,1578,6,-2,101,65,1420,1591,draw
5603,October 12,2015,Democratic Republic of Congo,Gabon,2,1,Friendly,in Belgium,11,-11,1491,1498,7,-5,87,86,1480,1509,T1
5604,October 12,2015,Estonia,Switzerland,0,1,European Championship qualifier,in Estonia,-9,9,1476,1806,-3,0,94,18,1485,1797,T2
5605,October 12,2015,Lithuania,England,0,3,European Championship qualifier,in Lithuania,-6,6,1428,1957,-3,0,104,7,1434,1951,T2
5606,October 12,2015,Slovakia,Luxembourg,4,2,European Championship qualifier,in Luxembourg,6,-6,1726,1238,1,-3,36,149,1720,1244,T2
5607,October 12,2015,Guinea,Morocco,1,1,Friendly,in Morocco,4,-4,1524,1547,0,0,78,71,1520,1551,draw
5608,October 12,2015,Russia,Montenegro,2,0,European Championship qualifier,in Russia,10,-10,1782,1589,2,-1,22,63,1772,1599,T1
5609,October 12,2015,San Marino,Slovenia,0,2,European Championship qualifier,in San Marino,-1,1,884,1623,0,0,205,53,885,1622,T2
5610,October 12,2015,Moldova,Sweden,0,2,European Championship qualifier,in Sweden,-4,4,1360,1750,0,0,117,28,1364,1746,T1
5611,October 12,2015,Spain,Ukraine,1,0,European Championship qualifier,in Ukraine,17,-17,1994,1812,0,-1,6,17,1977,1829,T2
5612,October 13,2015,Senegal,Algeria,0,1,Friendly,in Algeria,-7,7,1659,1674,-2,2,48,43,1666,1667,T1
5613,October 13,2015,Philippines,Bahrain,0,2,World Cup and Asian Cup qualifier,in Bahrain,-12,12,1266,1422,-2,1,140,107,1278,1410,T1
5614,October 13,2015,Israel,Belgium,1,3,European Championship qualifier,in Belgium,-5,5,1580,1919,-1,0,65,11,1585,1914,T1
5615,October 13,2015,Bhutan,Hong Kong,0,1,World Cup and Asian Cup qualifier,in Bhutan,-2,2,571,1183,-1,1,232,163,573,1181,T2
5616,October 13,2015,Eritrea,Botswana,1,3,World Cup qualifier,in Botswana,-8,8,1077,1315,0,1,181,131,1085,1307,T1
5617,October 13,2015,Venezuela,Brazil,1,3,World Cup qualifier,in Brazil,-4,4,1640,2024,-1,0,51,2,1644,2020,T1
5618,October 13,2015,Azerbaijan,Bulgaria,0,2,European Championship qualifier,in Bulgaria,-12,12,1414,1585,-2,2,108,64,1426,1573,T1
5619,October 13,2015,Burundi,Seychelles,2,0,World Cup qualifier,in Burundi,4,-4,1344,954,2,-1,124,192,1340,958,T1
5620,October 13,2015,Canada,Ghana,1,1,Friendly,in the United States,4,-4,1511,1662,1,0,81,46,1507,1666,draw
5621,October 13,2015,Benin,Congo,1,2,Friendly,in Congo,-5,5,1379,1465,-5,2,116,94,1384,1460,T1
5622,October 13,2015,Cyprus,Bosnia and Herzegovina,2,3,European Championship qualifier,in Cyprus,-9,9,1424,1749,-4,2,105,30,1433,1740,T2
5623,October 13,2015,Malaysia,East Timor,1,0,World Cup and Asian Cup qualifier,in East Timor,6,-6,1145,730,1,0,172,214,1139,736,T2
5624,October 13,2015,Bolivia,Ecuador,0,2,World Cup qualifier,in Ecuador,-7,7,1610,1882,-1,0,58,15,1617,1875,T1
5625,October 13,2015,El Salvador,Guatemala,1,1,Friendly,in the United States,-1,1,1484,1451,1,0,91,98,1485,1450,draw
5626,October 13,2015,Liberia,Guinea-Bissau,3,1,World Cup qualifier,in Guinea-Bissau,33,-33,1337,1204,8,-9,126,159,1304,1237,T2
5627,October 13,2015,South Africa,Honduras,1,1,Friendly,in Honduras,3,-3,1538,1530,1,-1,73,76,1535,1533,draw
5628,October 13,2015,Iran,Japan,1,1,Friendly,in Iran,-2,2,1724,1744,-2,-1,38,32,1726,1742,draw
5629,October 13,2015,Italy,Norway,2,1,European Championship qualifier,in Italy,6,-6,1888,1665,0,-1,14,45,1882,1671,T1
5630,October 13,2015,Jordan,Tajikistan,3,0,World Cup and Asian Cup qualifier,in Jordan,6,-6,1552,1223,1,0,71,154,1546,1229,T1
5631,October 13,2015,Lebanon,Kuwait,0,0,World Cup and Asian Cup qualifier,in Kuwait,11,-11,1392,1475,1,-3,111,93,1381,1486,draw
5632,October 13,2015,Kyrgyzstan,Bangladesh,2,0,World Cup and Asian Cup qualifier,in Kyrgyzstan,9,-9,1149,928,1,-1,171,199,1140,937,T1
5633,October 13,2015,Latvia,Kazakhstan,0,1,European Championship qualifier,in Latvia,-32,32,1454,1388,-7,9,97,112,1486,1356,T2
5634,October 13,2015,Lesotho,Comoros,1,1,World Cup qualifier,in Lesotho,-16,16,1177,919,-2,2,164,200,1193,903,draw
5635,October 13,2015,Central African Republic,Madagascar,2,2,World Cup qualifier,in Madagascar,8,-8,1252,1274,2,-4,144,139,1244,1282,draw
5636,October 13,2015,Croatia,Malta,1,0,European Championship qualifier,in Malta,3,-3,1795,1237,1,0,20,148,1792,1240,T2
5637,October 13,2015,Mauritania,South Sudan,4,0,World Cup qualifier,in Mauritania,14,-14,1263,1078,3,-2,141,180,1249,1092,T1
5638,October 13,2015,Panama,Mexico,0,1,Friendly,in Mexico,-3,3,1674,1893,0,1,43,12,1677,1890,T1
5639,October 13,2015,Myanmar,Laos,3,1,World Cup and Asian Cup qualifier,in Thailand,15,-15,1042,815,0,0,185,208,1027,830,T1
5640,October 13,2015,Namibia,Gambia,2,1,World Cup qualifier,in Namibia,14,-14,1371,1329,2,-4,118,128,1357,1343,T1
5641,October 13,2015,Czechia,Netherlands,3,2,European Championship qualifier,in the Netherlands,34,-34,1766,1891,8,-3,25,13,1732,1925,T2
5642,October 13,2015,Somalia,Niger,0,4,World Cup qualifier,in Niger,-4,4,859,1286,-1,0,207,135,863,1282,T1
5643,October 13,2015,Yemen,North Korea,0,1,World Cup and Asian Cup qualifier,in North Korea,-2,2,1155,1533,0,1,170,75,1157,1531,T1
5644,October 13,2015,Oman,India,3,0,World Cup and Asian Cup qualifier,in Oman,2,-2,1518,1025,0,-1,79,186,1516,1027,T1
5645,October 13,2015,Paraguay,Argentina,0,0,World Cup qualifier,in Paraguay,10,-10,1730,2005,4,-1,34,4,1720,2015,draw
5646,October 13,2015,Peru,Chile,3,4,World Cup qualifier,in Peru,-14,14,1783,2019,-3,2,22,3,1797,2005,T2
5647,October 13,2015,Qatar,Maldives,4,0,World Cup and Asian Cup qualifier,in Qatar,2,-2,1558,1022,1,0,68,187,1556,1024,T1
5648,October 13,2015,Chad,Sierra Leone,1,2,World Cup qualifier,in Nigeria,-17,17,1251,1337,-4,2,145,126,1268,1320,T1
5649,October 13,2015,Cambodia,Singapore,1,2,World Cup and Asian Cup qualifier,in Singapore,-1,1,727,1198,0,0,215,161,728,1197,T1
5650,October 13,2015,South Korea,Jamaica,3,0,Friendly,in South Korea,6,-6,1788,1595,1,0,21,61,1782,1601,T1
5651,October 13,2015,Syria,Afghanistan,5,2,World Cup and Asian Cup qualifier,in Oman,6,-6,1507,1072,2,0,83,182,1501,1078,T1
5652,October 13,2015,Nicaragua,Trinidad and Tobago,0,0,Friendly,in Trinidad and Tobago,9,-9,1213,1596,3,-1,156,60,1204,1605,draw
5653,October 13,2015,Turkey,Iceland,1,0,European Championship qualifier,in Turkey,10,-10,1806,1690,2,-2,18,41,1796,1700,T1
5654,October 13,2015,Guam,Turkmenistan,0,1,World Cup and Asian Cup qualifier,in Turkmenistan,-3,3,891,1247,0,0,203,146,894,1244,T1
5655,October 13,2015,Colombia,Uruguay,0,3,World Cup qualifier,in Uruguay,-36,36,1971,1929,-2,2,6,10,2007,1893,T1
5656,October 13,2015,United States,Costa Rica,0,1,Friendly,in the United States,-13,13,1760,1770,-2,2,26,24,1773,1757,T2
5657,October 13,2015,Thailand,Vietnam,3,0,World Cup and Asian Cup qualifier,in Vietnam,32,-32,1408,1213,6,-11,109,156,1376,1245,T2
5658,October 13,2015,Wales,Andorra,2,0,European Championship qualifier,in Wales,1,-1,1680,960,0,0,42,190,1679,961,T1
5659,October 17,2015,Swaziland,Djibouti,2,1,World Cup qualifier,in Swaziland,1,-1,1254,774,0,0,143,211,1253,775,T1
5660,November 3,2015,Brunei,Cambodia,1,6,Friendly,in Cambodia,-9,9,603,736,0,1,229,214,612,727,T1
5661,November 4,2015,Saint Vincent and the Grenadines,Antigua and Barbuda,2,1,Friendly,in Saint Vincent and the Grenadines,9,-9,1186,1246,2,-4,162,146,1177,1255,T1
5662,November 5,2015,Turkmenistan,United Arab Emirates,1,5,Friendly,in the United Arab Emirates,-2,2,1245,1623,-1,2,146,53,1247,1621,T1
5663,November 6,2015,Angola,Namibia,1,0,Friendly tournament,in Angola,8,-8,1444,1363,0,0,100,118,1436,1371,T1
5664,November 6,2015,Zambia,Democratic Republic of Congo,0,3,Friendly tournament,in Angola,-28,28,1486,1519,-9,8,89,79,1514,1491,T1
5665,November 7,2015,Democratic Republic of Congo,Angola,0,1,Friendly tournament,in Angola,-14,14,1505,1458,-4,4,83,96,1519,1444,T1
5666,November 7,2015,Myanmar,Hong Kong,0,5,Friendly,in Hong Kong,-8,8,1034,1191,0,2,185,162,1042,1183,T1
5667,November 7,2015,Namibia,Zambia,0,0,Friendly tournament,in Angola,5,-5,1368,1481,0,-2,118,91,1363,1486,draw
5668,November 7,2015,Vanuatu,Fiji,1,1,Friendly,in Vanuatu,0,0,1174,1281,0,0,167,136,1174,1281,draw
5669,November 9,2015,Saudi Arabia,Palestine,0,0,World Cup and Asian Cup qualifier,in Jordan,-11,11,1519,1320,-2,3,78,130,1530,1309,draw
5670,November 10,2015,Fiji,Vanuatu,1,2,Friendly,in Vanuatu,-10,10,1271,1184,-3,2,139,165,1281,1174,T1
5671,November 11,2015,Estonia,Georgia,3,0,Friendly,in Estonia,13,-13,1489,1476,4,-3,88,91,1476,1489,T1
5672,November 11,2015,Jordan,Malta,2,0,Friendly,in Turkey,4,-4,1556,1233,1,0,70,148,1552,1237,T1
5673,November 11,2015,Gabon,Mozambique,0,1,World Cup qualifier,in Mozambique,-25,25,1473,1338,-7,8,93,125,1498,1313,T1
5674,November 11,2015,Sudan,Zambia,0,1,World Cup qualifier,in Sudan,-18,18,1324,1499,-5,5,130,86,1342,1481,T2
5675,November 12,2015,Cambodia,Afghanistan,0,3,World Cup and Asian Cup qualifier,in Iran,-9,9,727,1081,-1,2,215,180,736,1072,T1
5676,November 12,2015,Andorra,Saint Kitts and Nevis,0,1,Friendly,in Andorra,-5,5,955,1237,-1,4,191,147,960,1232,T2
5677,November 12,2015,Australia,Kyrgyzstan,3,0,World Cup and Asian Cup qualifier,in Australia,2,-2,1700,1147,1,0,39,171,1698,1149,T1
5678,November 12,2015,Burkina Faso,Benin,1,2,World Cup qualifier,in Benin,-17,17,1411,1396,-5,6,108,110,1428,1379,T1
5679,November 12,2015,Venezuela,Bolivia,2,4,World Cup qualifier,in Bolivia,-24,24,1616,1634,-6,6,57,52,1640,1610,T1
5680,November 12,2015,Democratic Republic of Congo,Burundi,3,2,World Cup qualifier,in Burundi,17,-17,1522,1327,6,-5,77,129,1505,1344,T2
5681,November 12,2015,Chile,Colombia,1,1,World Cup qualifier,in Chile,-8,8,2011,1979,0,0,3,6,2019,1971,draw
5682,November 12,2015,Bhutan,China,0,12,World Cup and Asian Cup qualifier,in China,0,0,571,1560,0,0,232,67,571,1560,T1
5683,November 12,2015,Ecuador,Uruguay,2,1,World Cup qualifier,in Ecuador,17,-17,1899,1912,3,-1,12,11,1882,1929,T1
5684,November 12,2015,Guam,India,0,1,World Cup and Asian Cup qualifier,in India,-8,8,883,1033,-2,1,205,185,891,1025,T1
5685,November 12,2015,Iran,Turkmenistan,3,1,World Cup and Asian Cup qualifier,in Iran,2,-2,1726,1243,1,1,37,145,1724,1245,T1
5686,November 12,2015,Lebanon,Laos,7,0,World Cup and Asian Cup qualifier,in Lebanon,2,-2,1394,813,0,0,111,208,1392,815,T1
5687,November 12,2015,Montenegro,Macedonia,1,4,Friendly,in Macedonia,-20,20,1569,1453,-3,2,66,99,1589,1433,T1
5688,November 12,2015,Maldives,Hong Kong,0,1,World Cup and Asian Cup qualifier,in the Maldives,-16,16,1006,1207,0,3,187,159,1022,1191,T2
5689,November 12,2015,Morocco,Equatorial Guinea,2,0,World Cup qualifier,in Morocco,9,-9,1556,1338,2,-1,70,124,1547,1347,T1
5690,November 12,2015,Namibia,Guinea,0,1,World Cup qualifier,in Namibia,-17,17,1351,1541,-4,4,122,73,1368,1524,T2
5691,November 12,2015,Norway,Hungary,0,1,European Championship qualifier,in Norway,-26,26,1639,1687,-6,5,51,42,1665,1661,T2
5692,November 12,2015,New Zealand,Oman,1,0,Friendly,in Oman,13,-13,1521,1505,3,-5,78,84,1508,1518,T2
5693,November 12,2015,Malaysia,Palestine,0,6,World Cup and Asian Cup qualifier,in Jordan,-23,23,1122,1343,-2,8,174,123,1145,1320,T1
5694,November 12,2015,Philippines,Yemen,0,1,World Cup and Asian Cup qualifier,in the Philippines,-31,31,1235,1186,-8,7,148,163,1266,1155,T2
5695,November 12,2015,Japan,Singapore,3,0,World Cup and Asian Cup qualifier,in Singapore,5,-5,1749,1193,2,-1,30,162,1744,1198,T2
5696,November 12,2015,Myanmar,South Korea,0,4,World Cup and Asian Cup qualifier,in South Korea,-1,1,1033,1789,0,0,185,21,1034,1788,T1
5697,November 12,2015,Bangladesh,Tajikistan,0,5,World Cup and Asian Cup qualifier,in Tajikistan,-7,7,921,1230,0,2,199,152,928,1223,T1
5698,November 12,2015,Thailand,Taiwan,4,2,World Cup and Asian Cup qualifier,in Thailand,1,-1,1409,785,0,0,109,210,1408,786,T1
5699,November 12,2015,Uganda,Togo,1,0,World Cup qualifier,in Togo,23,-23,1514,1422,6,-5,81,105,1491,1445,T2
5700,November 12,2015,East Timor,United Arab Emirates,0,8,World Cup and Asian Cup qualifier,in the United Arab Emirates,0,0,730,1623,1,0,214,53,730,1623,T1
5701,November 12,2015,North Korea,Uzbekistan,1,3,World Cup and Asian Cup qualifier,in Uzbekistan,-15,15,1518,1644,-5,3,80,49,1533,1629,T1
5702,November 13,2015,South Africa,Angola,3,1,World Cup qualifier,in Angola,32,-32,1570,1426,9,-6,65,102,1538,1458,T2
5703,November 13,2015,Brazil,Argentina,1,1,World Cup qualifier,in Argentina,5,-5,2029,2000,0,-1,2,5,2024,2005,draw
5704,November 13,2015,Italy,Belgium,1,3,Friendly,in Belgium,-10,10,1878,1929,0,0,15,10,1888,1919,T1
5705,November 13,2015,Ireland,Bosnia and Herzegovina,1,1,European Championship qualifier,in Bosnia and Herzegovina,6,-6,1750,1743,4,-3,29,33,1744,1749,draw
5706,November 13,2015,Honduras,Canada,0,1,World Cup qualifier,in Canada,-15,15,1515,1526,-5,6,81,76,1530,1511,T1
5707,November 13,2015,Comoros,Ghana,0,0,World Cup qualifier,in the Comoros,19,-19,938,1643,2,-3,198,49,919,1662,draw
5708,November 13,2015,Costa Rica,Haiti,1,0,World Cup qualifier,in Costa Rica,4,-4,1774,1499,-1,0,25,86,1770,1503,T1
5709,November 13,2015,Czechia,Serbia,4,1,Friendly,in Czechia,11,-11,1777,1716,1,-2,24,38,1766,1727,T1
5710,November 13,2015,France,Germany,2,0,Friendly,in France,17,-17,1966,2069,1,0,7,1,1949,2086,T1
5711,November 13,2015,Guatemala,Trinidad and Tobago,1,2,World Cup qualifier,in Guatemala,-17,17,1434,1613,1,2,99,58,1451,1596,T2
5712,November 13,2015,Jamaica,Panama,0,2,World Cup qualifier,in Jamaica,-32,32,1563,1706,-6,5,67,39,1595,1674,T2
5713,November 13,2015,Kenya,Cape Verde,1,0,World Cup qualifier,in Kenya,25,-25,1401,1533,7,-7,110,75,1376,1558,T1
5714,November 13,2015,Kosovo,Albania,2,2,Friendly,in Kosovo,4,-4,1391,1615,1,-1,113,57,1387,1619,draw
5715,November 13,2015,Ivory Coast,Liberia,1,0,World Cup qualifier,in Liberia,6,-6,1734,1331,0,-1,35,127,1728,1337,T2
5716,November 13,2015,Libya,Rwanda,1,0,World Cup qualifier,in Tunisia,16,-16,1477,1377,4,-5,91,117,1461,1393,T1
5717,November 13,2015,Luxembourg,Greece,1,0,Friendly,in Luxembourg,17,-17,1255,1605,5,-4,141,59,1238,1622,T1
5718,November 13,2015,Senegal,Madagascar,2,2,World Cup qualifier,in Madagascar,-14,14,1645,1288,0,3,47,135,1659,1274,draw
5719,November 13,2015,Mauritania,Tunisia,1,2,World Cup qualifier,in Mauritania,-11,11,1252,1548,-2,2,142,73,1263,1537,T2
5720,November 13,2015,El Salvador,Mexico,0,3,World Cup qualifier,in Mexico,-4,4,1480,1897,0,-1,90,14,1484,1893,T1
5721,November 13,2015,Cameroon,Niger,3,0,World Cup qualifier,in Niger,15,-15,1630,1271,6,-3,52,138,1615,1286,T2
5722,November 13,2015,Northern Ireland,Latvia,1,0,Friendly,in Northern Ireland,4,-4,1594,1450,1,0,61,98,1590,1454,T1
5723,November 13,2015,Peru,Paraguay,1,0,World Cup qualifier,in Peru,12,-12,1795,1718,2,-3,20,37,1783,1730,T1
5724,November 13,2015,Iceland,Poland,2,4,Friendly,in Poland,-8,8,1682,1762,-2,2,43,26,1690,1754,T1
5725,November 13,2015,Turkey,Qatar,2,1,Friendly,in Qatar,6,-6,1812,1552,1,-4,17,72,1806,1558,T2
5726,November 13,2015,Slovakia,Switzerland,3,2,Friendly,in Slovakia,9,-9,1735,1797,3,-1,34,19,1726,1806,T1
5727,November 13,2015,Spain,England,2,0,Friendly,in Spain,9,-9,2003,1948,1,-1,4,8,1994,1957,T1
5728,November 13,2015,Nigeria,Swaziland,0,0,World Cup qualifier,in Swaziland,-14,14,1630,1268,-3,1,52,140,1644,1254,draw
5729,November 13,2015,United States,Saint Vincent and the Grenadines,6,1,World Cup qualifier,in the United States,2,-2,1762,1184,0,-2,26,165,1760,1186,T1
5730,November 13,2015,Wales,Netherlands,2,3,Friendly,in Wales,-7,7,1673,1898,-2,1,45,13,1680,1891,T2
5731,November 14,2015,Botswana,Mali,2,1,World Cup qualifier,in Botswana,28,-28,1343,1527,10,-4,123,75,1315,1555,T1
5732,November 14,2015,Chad,Egypt,1,0,World Cup qualifier,in Chad,34,-34,1285,1618,7,-8,137,54,1251,1652,T1
5733,November 14,2015,Congo,Ethiopia,4,3,World Cup qualifier,in Ethiopia,17,-17,1482,1301,5,-2,90,134,1465,1318,T2
5734,November 14,2015,Gabon,Mozambique,1,0,World Cup qualifier,in Gabon,8,-8,1481,1330,3,-4,91,128,1473,1338,T1
5735,November 14,2015,Portugal,Russia,0,1,Friendly,in Russia,-11,11,1919,1793,-1,1,10,22,1930,1782,T1
5736,November 14,2015,Denmark,Sweden,1,2,European Championship qualifier,in Sweden,-14,14,1732,1764,-3,3,35,26,1746,1750,T1
5737,November 14,2015,Algeria,Tanzania,2,2,World Cup qualifier,in Tanzania,-14,14,1660,1291,-1,1,45,135,1674,1277,draw
5738,November 14,2015,Ukraine,Slovenia,2,0,European Championship qualifier,in Ukraine,10,-10,1822,1613,1,-3,16,57,1812,1623,T1
5739,November 15,2015,Burundi,Democratic Republic of Congo,2,2,World Cup qualifier,in the Democratic Republic of the Congo,14,-14,1341,1508,5,-6,125,83,1327,1522,draw
5740,November 15,2015,Equatorial Guinea,Morocco,1,0,World Cup qualifier,in Equatorial Guinea,27,-27,1365,1529,7,-6,118,75,1338,1556,T1
5741,November 15,2015,Guinea,Namibia,2,0,World Cup qualifier,in Morocco,15,-15,1556,1336,4,-5,69,127,1541,1351,T1
5742,November 15,2015,Hungary,Norway,2,1,European Championship qualifier,in Hungary,12,-12,1699,1627,1,-3,41,52,1687,1639,T1
5743,November 15,2015,Uganda,Togo,3,0,World Cup qualifier,in Uganda,17,-17,1531,1405,8,-4,74,109,1514,1422,T1
5744,November 15,2015,Sudan,Zambia,0,2,World Cup qualifier,in Zambia,-10,10,1314,1509,0,4,132,82,1324,1499,T1
5745,November 16,2015,Georgia,Albania,2,2,Friendly,in Albania,6,-6,1482,1609,4,-2,90,58,1476,1615,draw
5746,November 16,2015,Ireland,Bosnia and Herzegovina,2,0,European Championship qualifier,in Ireland,21,-21,1771,1722,4,-4,26,36,1750,1743,T1
5747,November 17,2015,Tanzania,Algeria,0,7,World Cup qualifier,in Algeria,-6,6,1285,1666,-1,0,136,45,1291,1660,T1
5748,November 17,2015,Austria,Switzerland,1,2,Friendly,in Austria,-13,13,1802,1810,-3,1,20,18,1815,1797,T2
5749,November 17,2015,Azerbaijan,Moldova,2,1,Friendly,in Azerbaijan,6,-6,1420,1354,1,-2,105,121,1414,1360,T1
5750,November 17,2015,Australia,Bangladesh,4,0,World Cup and Asian Cup qualifier,in Bangladesh,1,-1,1701,920,1,0,39,200,1700,921,T2
5751,November 17,2015,Qatar,Bhutan,3,0,World Cup and Asian Cup qualifier,in Bhutan,0,0,1552,571,2,0,69,232,1552,571,T2
5752,November 17,2015,Peru,Brazil,0,3,World Cup qualifier,in Brazil,-9,9,1786,2038,-3,0,23,2,1795,2029,T1
5753,November 17,2015,Burkina Faso,Benin,2,0,World Cup qualifier,in Burkina Faso,20,-20,1431,1376,7,-5,100,116,1411,1396,T1
5754,November 17,2015,Cambodia,Japan,0,2,World Cup and Asian Cup qualifier,in Cambodia,0,0,727,1749,0,0,215,31,727,1749,T2
5755,November 17,2015,Cameroon,Niger,0,0,World Cup qualifier,in Cameroon,-17,17,1613,1288,-6,4,56,135,1630,1271,draw
5756,November 17,2015,Kenya,Cape Verde,0,2,World Cup qualifier,in Cape Verde,-12,12,1389,1545,-2,1,112,72,1401,1533,T1
5757,November 17,2015,Colombia,Argentina,0,1,World Cup qualifier,in Colombia,-24,24,1955,2024,-1,2,7,3,1979,2000,T2
5758,November 17,2015,Ethiopia,Congo,1,2,World Cup qualifier,in Congo,-7,7,1294,1489,0,2,134,88,1301,1482,T1
5759,November 17,2015,Denmark,Sweden,2,2,European Championship qualifier,in Denmark,-4,4,1728,1768,0,0,34,27,1732,1764,draw
5760,November 17,2015,Saudi Arabia,East Timor,10,0,World Cup and Asian Cup qualifier,in East Timor,2,-2,1521,728,0,0,79,214,1519,730,T2
5761,November 17,2015,Egypt,Chad,4,0,World Cup qualifier,in Egypt,6,-6,1624,1279,2,-1,52,138,1618,1285,T1
5762,November 17,2015,Canada,El Salvador,0,0,World Cup qualifier,in El Salvador,3,-3,1529,1477,1,1,76,92,1526,1480,draw
5763,November 17,2015,France,England,0,2,Friendly,in England,-12,12,1954,1960,-1,2,8,6,1966,1948,T1
5764,November 17,2015,Estonia,Saint Kitts and Nevis,3,0,Friendly,in Estonia,4,-4,1493,1233,1,-1,87,148,1489,1237,T1
5765,November 17,2015,Ghana,Comoros,2,0,World Cup qualifier,in Ghana,1,-1,1644,937,0,0,48,198,1643,938,T1
5766,November 17,2015,Iran,Guam,6,0,World Cup and Asian Cup qualifier,in Guam,1,-1,1727,882,-1,0,36,205,1726,883,T2
5767,November 17,2015,Jamaica,Haiti,1,0,World Cup qualifier,in Haiti,22,-22,1585,1477,5,-5,62,92,1563,1499,T2
5768,November 17,2015,Honduras,Mexico,0,2,World Cup qualifier,in Honduras,-10,10,1505,1907,-5,1,86,13,1515,1897,T2
5769,November 17,2015,China,Hong Kong,0,0,World Cup and Asian Cup qualifier,in Hong Kong,-12,12,1548,1219,-3,4,71,155,1560,1207,draw
5770,November 17,2015,Romania,Italy,2,2,Friendly,in Italy,6,-6,1764,1872,1,0,29,15,1758,1878,draw
5771,November 17,2015,Liberia,Ivory Coast,0,3,World Cup qualifier,in Ivory Coast,-4,4,1327,1738,-2,0,130,33,1331,1734,T1
5772,November 17,2015,Jordan,Kyrgyzstan,0,1,World Cup and Asian Cup qualifier,in Kyrgyzstan,-34,34,1522,1181,-9,5,78,166,1556,1147,T1
5773,November 17,2015,South Korea,Laos,5,0,World Cup and Asian Cup qualifier,in Laos,1,-1,1790,812,1,0,22,208,1789,813,T2
5774,November 17,2015,Portugal,Luxembourg,2,0,Friendly,in Luxembourg,1,-1,1920,1254,-1,-1,11,143,1919,1255,T2
5775,November 17,2015,Macedonia,Lebanon,0,1,Friendly,in Macedonia,-14,14,1439,1408,-2,4,99,108,1453,1394,T2
5776,November 17,2015,United Arab Emirates,Malaysia,2,1,World Cup and Asian Cup qualifier,in Malaysia,4,-4,1627,1118,3,-1,50,175,1623,1122,T2
5777,November 17,2015,Botswana,Mali,0,2,World Cup qualifier,in Mali,-10,10,1333,1537,-4,3,127,73,1343,1527,T1
5778,November 17,2015,Swaziland,Nigeria,0,2,World Cup qualifier,in Nigeria,-4,4,1264,1634,-1,1,142,49,1268,1630,T1
5779,November 17,2015,Bahrain,North Korea,0,2,World Cup and Asian Cup qualifier,in North Korea,-15,15,1407,1533,-4,6,109,74,1422,1518,T1
5780,November 17,2015,Panama,Costa Rica,1,2,World Cup qualifier,in Panama,-22,22,1684,1796,-3,4,42,21,1706,1774,T2
5781,November 17,2015,Paraguay,Bolivia,2,1,World Cup qualifier,in Paraguay,10,-10,1728,1624,3,-3,34,52,1718,1634,T1
5782,November 17,2015,Czechia,Poland,1,3,Friendly,in Poland,-11,11,1766,1773,-4,3,28,25,1777,1762,T1
5783,November 17,2015,Croatia,Russia,3,1,Friendly,in Russia,19,-19,1814,1774,3,-2,17,24,1795,1793,T2
5784,November 17,2015,Rwanda,Libya,1,3,World Cup qualifier,in Rwanda,-30,30,1347,1507,-5,10,122,84,1377,1477,T2
5785,November 17,2015,Madagascar,Senegal,0,3,World Cup qualifier,in Senegal,-5,5,1283,1650,-1,0,137,46,1288,1645,T1
5786,November 17,2015,Singapore,Syria,1,2,World Cup and Asian Cup qualifier,in Singapore,-9,9,1184,1516,-1,3,163,81,1193,1507,T2
5787,November 17,2015,Slovakia,Iceland,3,1,Friendly,in Slovakia,9,-9,1744,1673,0,0,32,43,1735,1682,T1
5788,November 17,2015,Ukraine,Slovenia,1,1,European Championship qualifier,in Slovenia,-6,6,1816,1619,0,2,16,54,1822,1613,draw
5789,November 17,2015,South Africa,Angola,1,0,World Cup qualifier,in South Africa,8,-8,1578,1418,0,-4,65,106,1570,1426,T1
5790,November 17,2015,Guatemala,Saint Vincent and the Grenadines,4,0,World Cup qualifier,in Saint Vincent and the Grenadines,22,-22,1456,1162,3,-5,96,170,1434,1184,T2
5791,November 17,2015,Taiwan,Iraq,0,2,World Cup and Asian Cup qualifier,in Taiwan,-2,2,783,1507,0,1,210,84,785,1505,T2
5792,November 17,2015,Trinidad and Tobago,United States,0,0,World Cup qualifier,in Trinidad and Tobago,3,-3,1616,1759,1,-2,55,30,1613,1762,draw
5793,November 17,2015,Mauritania,Tunisia,1,2,World Cup qualifier,in Tunisia,-4,4,1248,1552,-2,3,145,69,1252,1548,T1
5794,November 17,2015,Turkey,Greece,0,0,Friendly,in Turkey,-7,7,1805,1612,-1,2,19,57,1812,1605,draw
5795,November 17,2015,Turkmenistan,Oman,2,1,World Cup and Asian Cup qualifier,in Turkmenistan,29,-29,1272,1476,6,-9,140,94,1243,1505,T1
5796,November 17,2015,Uruguay,Chile,3,0,World Cup qualifier,in Uruguay,35,-35,1947,1976,2,-2,9,5,1912,2011,T1
5797,November 17,2015,Yemen,Uzbekistan,1,3,World Cup and Asian Cup qualifier,in Qatar,-4,4,1182,1648,-2,0,165,47,1186,1644,T1
5798,November 17,2015,Ecuador,Venezuela,3,1,World Cup qualifier,in Venezuela,16,-16,1915,1600,0,-5,12,60,1899,1616,T2
5799,November 21,2015,Burundi,Zanzibar,1,0,CECAFA Cup,in Ethiopia,16,-16,1357,1261,3,-3,121,142,1341,1277,T1
5800,November 21,2015,Ethiopia,Rwanda,0,1,CECAFA Cup,in Ethiopia,-23,23,1271,1370,-5,5,139,117,1294,1347,T2
5801,November 22,2015,Kenya,Uganda,2,0,CECAFA Cup,in Ethiopia,42,-42,1431,1489,12,-12,100,87,1389,1531,T1
5802,November 22,2015,Tanzania,Somalia,4,0,CECAFA Cup,in Ethiopia,6,-6,1291,853,1,0,134,207,1285,859,T1
5803,November 23,2015,Malawi,Sudan,2,1,CECAFA Cup,in Ethiopia,18,-18,1373,1296,5,-1,117,133,1355,1314,T1
5804,November 23,2015,South Sudan,Djibouti,2,0,CECAFA Cup,in Ethiopia,9,-9,1087,765,2,-1,179,212,1078,774,T1
5805,November 24,2015,Rwanda,Tanzania,1,2,CECAFA Cup,in Ethiopia,-24,24,1346,1315,-5,2,123,132,1370,1291,T1
5806,November 24,2015,Zanzibar,Uganda,0,4,CECAFA Cup,in Ethiopia,-16,16,1245,1505,-4,2,146,85,1261,1489,T1
5807,November 25,2015,Kenya,Burundi,1,1,CECAFA Cup,in Ethiopia,-4,4,1427,1361,-3,2,103,119,1431,1357,draw
5808,November 25,2015,Ethiopia,Somalia,2,0,CECAFA Cup,in Ethiopia,3,-3,1274,850,1,0,138,207,1271,853,T1
5809,November 25,2015,Malawi,Djibouti,3,0,CECAFA Cup,in Ethiopia,2,-2,1375,763,0,-1,117,213,1373,765,T1
5810,November 25,2015,South Sudan,Sudan,0,0,CECAFA Cup,in Ethiopia,11,-11,1098,1285,1,-1,178,135,1087,1296,draw
5811,November 27,2015,Rwanda,Somalia,3,0,CECAFA Cup,in Ethiopia,4,-4,1350,846,1,0,122,207,1346,850,T1
5812,November 27,2015,Malawi,South Sudan,0,2,CECAFA Cup,in Ethiopia,-50,50,1325,1148,-14,6,131,172,1375,1098,T1
5813,November 27,2015,Djibouti,Sudan,0,4,CECAFA Cup,in Ethiopia,-4,4,759,1289,0,1,213,134,763,1285,T1
5814,November 27,2015,Kenya,Zanzibar,1,3,CECAFA Cup,in Ethiopia,-44,44,1383,1289,-10,12,113,134,1427,1245,T1
5815,November 28,2015,Tanzania,Ethiopia,1,1,CECAFA Cup,in Ethiopia,3,-3,1318,1271,0,-1,132,140,1315,1274,draw
5816,November 28,2015,Uganda,Burundi,1,0,CECAFA Cup,in Ethiopia,12,-12,1517,1349,5,-4,80,122,1505,1361,T1
5817,November 30,2015,Tanzania,Ethiopia,1,1,CECAFA Cup,in Ethiopia,3,-3,1321,1268,1,-1,131,141,1318,1271,draw
5818,November 30,2015,Uganda,Malawi,2,0,CECAFA Cup,in Ethiopia,15,-15,1532,1310,5,-1,75,132,1517,1325,T1
5819,December 1,2015,Kenya,Rwanda,0,0,CECAFA Cup,in Ethiopia,-2,2,1381,1352,0,0,113,121,1383,1350,draw
5820,December 1,2015,South Sudan,Sudan,0,0,CECAFA Cup,in Ethiopia,8,-8,1156,1281,0,-3,172,137,1148,1289,draw
5821,December 3,2015,Uganda,Ethiopia,0,0,CECAFA Cup,in Ethiopia,-9,9,1523,1277,-2,2,77,139,1532,1268,draw
5822,December 3,2015,Sudan,Rwanda,1,1,CECAFA Cup,in Ethiopia,4,-4,1285,1348,1,-1,136,122,1281,1352,draw
5823,December 5,2015,Ethiopia,Sudan,1,1,CECAFA Cup,in Ethiopia,-5,5,1272,1290,0,2,139,134,1277,1285,draw
5824,December 5,2015,Uganda,Rwanda,1,0,CECAFA Cup,in Ethiopia,11,-11,1534,1337,3,-1,74,123,1523,1348,T1
5825,December 8,2015,Cuba,Nicaragua,0,5,Friendly,in Nicaragua,-24,24,1356,1237,-4,10,119,147,1380,1213,T1
5826,December 11,2015,Nicaragua,Cuba,1,0,Friendly,in Nicaragua,11,-11,1248,1345,2,-2,145,121,1237,1356,T1
5827,December 15,2015,Nicaragua,Costa Rica,0,1,Friendly,in Costa Rica,0,0,1248,1796,0,0,145,21,1248,1796,T1
5828,December 16,2015,Honduras,Cuba,2,0,Friendly,in Honduras,5,-5,1510,1340,4,-1,82,122,1505,1345,T1
5829,December 17,2015,Bangladesh,Nepal,1,0,Friendly,in Bangladesh,6,-6,926,881,0,-2,200,205,920,887,T1
5830,December 23,2015,Sri Lanka,Nepal,1,0,South Asian Cup,in India,26,-26,792,855,1,-1,210,206,766,881,T1
5831,December 24,2015,Afghanistan,Bangladesh,4,0,South Asian Cup,in India,22,-22,1103,904,2,-2,179,202,1081,926,T1
5832,December 24,2015,Maldives,Bhutan,3,1,South Asian Cup,in India,5,-5,1011,566,0,0,187,232,1006,571,T1
5833,December 25,2015,Sri Lanka,India,0,2,South Asian Cup,in India,-7,7,785,1040,0,0,210,185,792,1033,T1
5834,December 26,2015,Afghanistan,Bhutan,3,0,South Asian Cup,in India,3,-3,1106,563,1,-2,178,234,1103,566,T1
5835,December 26,2015,Bangladesh,Maldives,1,3,South Asian Cup,in India,-21,21,883,1032,-1,0,203,187,904,1011,T1
5836,December 26,2015,Guadeloupe,Martinique,0,2,Friendly,in Martinique,-7,7,1320,1436,-2,1,131,100,1327,1429,T1
5837,December 27,2015,Nepal,India,1,4,South Asian Cup,in India,-11,11,844,1051,-1,0,207,185,855,1040,T1
5838,December 28,2015,Afghanistan,Maldives,4,1,South Asian Cup,in India,28,-28,1134,1004,4,0,174,187,1106,1032,T1
5839,December 28,2015,Bangladesh,Bhutan,3,0,South Asian Cup,in India,10,-10,893,553,1,0,202,234,883,563,T1
5840,December 31,2015,Afghanistan,Sri Lanka,5,0,South Asian Cup,in India,9,-9,1143,776,0,-1,174,211,1134,785,T1
5841,January 3,2016,Afghanistan,India,1,2,South Asian Cup,in India,-19,19,1124,1082,0,2,174,182,1143,1063,T1
5842,January 6,2016,Sweden,Estonia,1,1,Friendly,in the United Arab Emirates,-7,7,1761,1500,-2,0,29,87,1768,1493,draw
5843,January 8,2016,Bangladesh,Sri Lanka,4,2,Friendly tournament,in Bangladesh,10,-10,903,766,0,0,202,211,893,776,T1
5844,January 8,2016,Haiti,Trinidad and Tobago,1,0,Copa América qualifier,in Panama,28,-28,1505,1588,5,-6,87,61,1477,1616,T1
5845,January 8,2016,Cuba,Panama,0,4,Copa América qualifier,in Panama,-5,5,1335,1689,-3,0,125,42,1340,1684,T1
5846,January 10,2016,Finland,Sweden,0,3,Friendly,in the United Arab Emirates,-10,10,1593,1771,-2,3,60,26,1603,1761,T1
5847,January 11,2016,Maldives,Cambodia,3,2,Friendly tournament,in Bangladesh,5,-5,997,722,1,-1,187,216,992,727,T1
5848,January 13,2016,Iceland,Finland,1,0,Friendly,in the United Arab Emirates,8,-8,1681,1585,0,-1,43,61,1673,1593,T1
5849,January 13,2016,Nepal,Sri Lanka,1,0,Friendly tournament,in Bangladesh,12,-12,856,754,1,-2,206,213,844,766,T1
5850,January 15,2016,Nepal,Bangladesh,0,0,Friendly tournament,in Bangladesh,6,-6,862,897,1,0,205,202,856,903,draw
5851,January 16,2016,Iceland,United Arab Emirates,1,2,Friendly,in the United Arab Emirates,-9,9,1672,1636,-1,1,44,49,1681,1627,T1
5852,January 19,2016,Maldives,Nepal,1,4,Friendly tournament,in Bangladesh,-36,36,961,898,-2,3,189,202,997,862,T1
5853,January 27,2016,Egypt,Jordan,0,1,Friendly,in Egypt,-15,15,1609,1537,-4,5,56,73,1624,1522,T2
5854,January 27,2016,Nicaragua,Honduras,1,3,Friendly,in Nicaragua,-8,8,1240,1518,-2,1,147,81,1248,1510,T2
5855,January 29,2016,Egypt,Libya,2,0,Friendly,in Egypt,7,-7,1616,1500,2,-2,54,87,1609,1507,T1
5856,January 31,2016,Iceland,United States,2,3,Friendly,in the United States,-5,5,1667,1764,0,1,44,29,1672,1759,T1
5857,February 2,2016,Venezuela,Costa Rica,1,0,Friendly,in Venezuela,13,-13,1613,1783,3,-2,55,23,1600,1796,T1
5858,February 5,2016,Lebanon,Bahrain,0,2,Friendly,in Bahrain,-11,11,1397,1418,-2,3,110,106,1408,1407,T1
5859,February 5,2016,Canada,United States,0,1,Friendly,in the United States,-3,3,1526,1767,-1,1,78,28,1529,1764,T1
5860,February 6,2016,Martinique,Guadeloupe,1,1,Friendly,in Guadeloupe,0,0,1436,1320,0,0,100,131,1436,1320,draw
5861,February 10,2016,Guatemala,Honduras,3,1,Friendly,in Guatemala,13,-13,1469,1505,0,-4,96,85,1456,1518,T1
5862,February 14,2016,Lebanon,Uzbekistan,0,2,Friendly,in the United Arab Emirates,-6,6,1391,1654,0,1,110,46,1397,1648,T1
5863,February 17,2016,El Salvador,Panama,0,1,Friendly,in Panama,-3,3,1474,1692,-2,0,95,42,1477,1689,T1
5864,February 21,2016,Guyana,Suriname,2,0,Friendly,in Guyana,8,-8,1235,1154,5,-2,149,172,1227,1162,T1
5865,February 21,2016,Saint Kitts and Nevis,Bermuda,3,0,Friendly,in Saint Kitts and Nevis,13,-13,1246,1220,3,-6,146,155,1233,1233,T1
5866,February 25,2016,Suriname,French Guiana,3,2,Friendly,in French Guiana,16,-16,1170,1289,3,-1,169,134,1154,1305,T2
5867,March 2,2016,El Salvador,Guatemala,0,1,Friendly,in Guatemala,-7,7,1467,1476,-1,3,96,93,1474,1469,T1
5868,March 9,2016,El Salvador,Nicaragua,1,1,Friendly,in Nicaragua,-4,4,1463,1244,0,0,96,148,1467,1240,draw
5869,March 13,2016,Sint Maarten,Anguilla,2,0,Friendly,in Sint Maarten,2,-2,932,571,0,0,199,231,930,573,T1
5870,March 13,2016,Saint Vincent and the Grenadines,Martinique,0,4,Friendly,in Saint Vincent and the Grenadines,-10,10,1152,1446,-1,1,172,99,1162,1436,T2
5871,March 15,2016,Nicaragua,Panama,1,0,Friendly,in Nicaragua,18,-18,1262,1674,5,0,143,42,1244,1692,T1
5872,March 18,2016,Syria,Iraq,1,0,Friendly,in Iran,10,-10,1526,1497,3,-4,78,88,1516,1507,T1
5873,March 18,2016,Bangladesh,United Arab Emirates,1,6,Friendly,in the United Arab Emirates,0,0,897,1636,0,0,203,49,897,1636,T1
5874,March 19,2016,Grenada,Trinidad and Tobago,2,2,Friendly,in Grenada,8,-8,1132,1580,0,-3,174,63,1124,1588,draw
5875,March 19,2016,Guam,Taiwan,2,3,Friendly,in Taiwan,-10,10,872,793,0,0,205,210,882,783,T1
5876,March 22,2016,Bermuda,Cuba,1,2,CONCACAF Champ &amp; Carib Champ qual,in Cuba,-9,9,1211,1344,-3,4,158,121,1220,1335,T1
5877,March 22,2016,Sint Maarten,Grenada,0,5,CONCACAF Champ &amp; Carib Champ qual,in Grenada,-12,12,920,1144,0,0,199,174,932,1132,T1
5878,March 22,2016,Anguilla,Guyana,0,7,CONCACAF Champ &amp; Carib Champ qual,in Guyana,-1,1,570,1236,0,0,231,149,571,1235,T1
5879,March 22,2016,Sierra Leone,Malawi,1,1,Friendly,in Sierra Leone,-4,4,1333,1314,-3,0,125,132,1337,1310,draw
5880,March 23,2016,Antigua and Barbuda,Aruba,2,1,CONCACAF Champ &amp; Carib Champ qual,in Antigua and Barbuda,4,-4,1250,938,1,0,146,197,1246,942,T1
5881,March 23,2016,Barbados,Curaçao,1,0,CONCACAF Champ &amp; Carib Champ qual,in Barbados,13,-13,1158,1103,2,-2,171,180,1145,1116,T1
5882,March 23,2016,Tanzania,Chad,1,0,African Nations Cup qualifier,in Chad,23,-23,1344,1256,9,-5,121,143,1321,1279,T2
5883,March 23,2016,Israel,Croatia,0,2,Friendly,in Croatia,-4,4,1576,1818,-3,1,66,16,1580,1814,T1
5884,March 23,2016,Gibraltar,Liechtenstein,0,0,Friendly,in Gibraltar,0,0,1119,1203,-1,0,177,161,1119,1203,draw
5885,March 23,2016,Guadeloupe,Suriname,0,0,CONCACAF Champ &amp; Carib Champ qual,in Guadeloupe,-12,12,1308,1182,-1,4,132,165,1320,1170,draw
5886,March 23,2016,Guinea-Bissau,Kenya,1,0,African Nations Cup qualifier,in Guinea-Bissau,24,-24,1228,1357,6,-5,154,118,1204,1381,T1
5887,March 23,2016,British Virgin Islands,Martinique,0,3,CONCACAF Champ &amp; Carib Champ qual,in Martinique,0,0,627,1446,0,0,227,99,627,1446,T1
5888,March 23,2016,Poland,Serbia,1,0,Friendly,in Poland,6,-6,1779,1710,1,0,24,38,1773,1716,T1
5889,March 23,2016,Lithuania,Romania,0,1,Friendly,in Romania,-2,2,1426,1766,0,1,102,29,1428,1764,T1
5890,March 23,2016,Libya,São Tomé and Príncipe,1,2,African Nations Cup qualifier,in São Tomé and Príncipe,-34,34,1466,1124,-9,5,95,175,1500,1090,T1
5891,March 23,2016,Macedonia,Slovenia,0,1,Friendly,in Slovenia,-3,3,1436,1622,0,0,100,53,1439,1619,T1
5892,March 23,2016,South Sudan,Benin,1,2,African Nations Cup qualifier,in South Sudan,-13,13,1143,1389,-3,3,174,112,1156,1376,T2
5893,March 23,2016,Zambia,Congo,1,1,African Nations Cup qualifier,in Zambia,-7,7,1502,1496,-3,1,85,88,1509,1489,draw
5894,March 24,2016,Australia,Tajikistan,7,0,World Cup and Asian Cup qualifier,in Australia,3,-3,1704,1227,-1,-1,40,154,1701,1230,T1
5895,March 24,2016,Bahrain,Yemen,3,0,World Cup and Asian Cup qualifier,in Bahrain,9,-9,1427,1173,4,-4,102,169,1418,1182,T1
5896,March 24,2016,Colombia,Bolivia,3,2,World Cup qualifier,in Bolivia,8,-8,1963,1616,2,-3,5,55,1955,1624,T2
5897,March 24,2016,Argentina,Chile,2,1,World Cup qualifier,in Chile,23,-23,2047,1953,1,-3,2,8,2024,1976,T2
5898,March 24,2016,China,Maldives,4,0,World Cup and Asian Cup qualifier,in China,1,-1,1549,960,0,-1,71,190,1548,961,T1
5899,March 24,2016,Botswana,Comoros,0,1,African Nations Cup qualifier,in the Comoros,-34,34,1299,971,-6,9,132,189,1333,937,T1
5900,March 24,2016,Scotland,Czechia,1,0,Friendly,in Czechia,14,-14,1713,1752,2,-1,38,30,1699,1766,T2
5901,March 24,2016,Denmark,Iceland,2,1,Friendly,in Denmark,6,-6,1734,1661,-1,-1,35,45,1728,1667,T1
5902,March 24,2016,Liberia,Djibouti,1,0,African Nations Cup qualifier,in Djibouti,3,-3,1330,756,3,0,127,212,1327,759,T2
5903,March 24,2016,Ecuador,Paraguay,2,2,World Cup qualifier,in Ecuador,-14,14,1901,1742,-1,1,13,33,1915,1728,draw
5904,March 24,2016,Norway,Estonia,0,0,Friendly,in Estonia,-1,1,1626,1501,0,0,51,86,1627,1500,draw
5905,March 24,2016,Ghana,Mozambique,3,1,African Nations Cup qualifier,in Ghana,5,-5,1649,1325,0,-1,48,129,1644,1330,T1
5906,March 24,2016,Greece,Montenegro,2,1,Friendly,in Greece,6,-6,1618,1563,3,0,54,67,1612,1569,T1
5907,March 24,2016,Iran,India,4,0,World Cup and Asian Cup qualifier,in Iran,1,-1,1728,1081,0,0,36,182,1727,1082,T1
5908,March 24,2016,Thailand,Iraq,2,2,World Cup and Asian Cup qualifier,in Iran,5,-5,1414,1492,0,-1,108,88,1409,1497,draw
5909,March 24,2016,Spain,Italy,1,1,Friendly,in Italy,-1,1,2002,1873,0,0,4,15,2003,1872,draw
5910,March 24,2016,Japan,Afghanistan,5,0,World Cup and Asian Cup qualifier,in Japan,1,-1,1750,1123,0,-1,31,176,1749,1124,T1
5911,March 24,2016,Jordan,Bangladesh,8,0,World Cup and Asian Cup qualifier,in Jordan,1,-1,1538,896,0,0,73,203,1537,897,T1
5912,March 24,2016,Madagascar,Central African Republic,1,1,African Nations Cup qualifier,in Madagascar,-7,7,1276,1259,0,2,137,143,1283,1252,draw
5913,March 24,2016,Malta,Moldova,0,0,Friendly,in Malta,1,-1,1234,1353,1,0,150,119,1233,1354,draw
5914,March 24,2016,Guam,Oman,0,1,World Cup and Asian Cup qualifier,in Oman,-1,1,871,1477,0,0,205,92,872,1476,T1
5915,March 24,2016,Peru,Venezuela,2,2,World Cup qualifier,in Peru,-13,13,1773,1626,-3,4,25,51,1786,1613,draw
5916,March 24,2016,Hong Kong,Qatar,0,2,World Cup and Asian Cup qualifier,in Qatar,-5,5,1214,1557,-2,1,158,68,1219,1552,T1
5917,March 24,2016,Malaysia,Saudi Arabia,0,2,World Cup and Asian Cup qualifier,in Saudi Arabia,-3,3,1115,1524,0,0,178,80,1118,1521,T1
5918,March 24,2016,Myanmar,Singapore,1,2,Friendly,in Singapore,-4,4,1029,1188,0,1,186,162,1033,1184,T1
5919,March 24,2016,Papua New Guinea,Solomon Islands,0,2,Friendly,in the Solomon Islands,-7,7,1047,1183,0,4,185,165,1054,1176,T1
5920,March 24,2016,Lebanon,South Korea,0,1,World Cup and Asian Cup qualifier,in South Korea,-2,2,1389,1792,-1,0,111,21,1391,1790,T1
5921,March 24,2016,Cambodia,Syria,0,6,World Cup and Asian Cup qualifier,in Oman,-1,1,721,1527,0,0,216,78,722,1526,T1
5922,March 24,2016,Turkey,Sweden,2,1,Friendly,in Turkey,6,-6,1811,1765,1,-3,18,29,1805,1771,T1
5923,March 24,2016,United Arab Emirates,Palestine,2,0,World Cup and Asian Cup qualifier,in the United Arab Emirates,6,-6,1642,1337,0,0,49,123,1636,1343,T1
5924,March 24,2016,Cyprus,Ukraine,0,1,Friendly,in Ukraine,-1,1,1423,1817,-2,0,105,17,1424,1816,T1
5925,March 24,2016,Uzbekistan,Philippines,1,0,World Cup and Asian Cup qualifier,in Uzbekistan,2,-2,1656,1233,0,-1,46,151,1654,1235,T1
5926,March 24,2016,Taiwan,Vietnam,1,4,World Cup and Asian Cup qualifier,in Vietnam,-3,3,790,1216,0,1,210,157,793,1213,T1
5927,March 24,2016,Wales,Northern Ireland,1,1,Friendly,in Wales,-5,5,1668,1599,0,0,43,59,1673,1594,draw
5928,March 25,2016,Ethiopia,Algeria,1,7,African Nations Cup qualifier,in Algeria,-5,5,1267,1671,-2,2,140,42,1272,1666,T1
5929,March 25,2016,Belarus,Armenia,0,0,Friendly,in Armenia,0,0,1578,1485,0,-1,64,90,1578,1485,draw
5930,March 25,2016,Uruguay,Brazil,2,2,World Cup qualifier,in Brazil,10,-10,1957,2028,1,0,8,3,1947,2038,draw
5931,March 25,2016,Mexico,Canada,3,0,World Cup qualifier,in Canada,12,-12,1919,1514,1,-3,11,82,1907,1526,T2
5932,March 25,2016,El Salvador,Honduras,2,2,World Cup qualifier,in El Salvador,-3,3,1460,1508,0,-1,96,84,1463,1505,draw
5933,March 25,2016,Sierra Leone,Gabon,1,2,Friendly,in Gabon,-4,4,1329,1485,-1,1,127,90,1333,1481,T1
5934,March 25,2016,United States,Guatemala,0,2,World Cup qualifier,in Guatemala,-45,45,1722,1521,-10,13,37,80,1767,1476,T1
5935,March 25,2016,Malawi,Guinea,0,0,African Nations Cup qualifier,in Guinea,15,-15,1329,1541,3,-4,127,73,1314,1556,draw
5936,March 25,2016,Panama,Haiti,0,0,World Cup qualifier,in Haiti,-4,4,1670,1509,-1,0,43,83,1674,1505,draw
5937,March 25,2016,Switzerland,Ireland,0,1,Friendly,in Ireland,-8,8,1802,1779,0,4,19,22,1810,1771,T1
5938,March 25,2016,Sudan,Ivory Coast,0,1,African Nations Cup qualifier,in Ivory Coast,-2,2,1288,1740,-2,2,135,32,1290,1738,T1
5939,March 25,2016,Jamaica,Costa Rica,1,1,World Cup qualifier,in Jamaica,5,-5,1590,1778,-1,-2,61,24,1585,1783,draw
5940,March 25,2016,Luxembourg,Bosnia and Herzegovina,0,3,Friendly,in Luxembourg,-4,4,1250,1726,-1,1,146,36,1254,1722,T2
5941,March 25,2016,Equatorial Guinea,Mali,0,1,African Nations Cup qualifier,in Mali,-7,7,1358,1544,-1,2,116,72,1365,1537,T1
5942,March 25,2016,Mauritania,Gambia,2,1,African Nations Cup qualifier,in Mauritania,19,-19,1267,1310,7,-2,140,130,1248,1329,T1
5943,March 25,2016,France,Netherlands,3,2,Friendly,in the Netherlands,11,-11,1965,1887,2,0,5,14,1954,1898,T2
5944,March 25,2016,Egypt,Nigeria,1,1,African Nations Cup qualifier,in Nigeria,7,-7,1623,1627,2,0,53,50,1616,1634,draw
5945,March 25,2016,Portugal,Bulgaria,0,1,Friendly,in Portugal,-18,18,1902,1603,-1,1,12,59,1920,1585,T2
5946,March 25,2016,Slovakia,Latvia,0,0,Friendly,in Slovakia,-8,8,1736,1458,-1,1,33,97,1744,1450,draw
5947,March 25,2016,Trinidad and Tobago,Saint Vincent and the Grenadines,3,2,World Cup qualifier,in Saint Vincent and the Grenadines,5,-5,1585,1147,1,0,62,172,1580,1152,T2
5948,March 25,2016,Zimbabwe,Swaziland,1,1,African Nations Cup qualifier,in Swaziland,0,0,1360,1264,1,-1,115,142,1360,1264,draw
5949,March 25,2016,Tunisia,Togo,1,0,African Nations Cup qualifier,in Tunisia,8,-8,1560,1397,2,0,68,109,1552,1405,T1
5950,March 26,2016,Puerto Rico,Anguilla,4,0,CONCACAF Champ &amp; Carib Champ qual,in Anguilla,7,-7,1072,563,0,-2,184,233,1065,570,T2
5951,March 26,2016,Aruba,Saint Kitts and Nevis,0,2,CONCACAF Champ &amp; Carib Champ qual,in Aruba,-14,14,924,1260,0,4,198,144,938,1246,T2
5952,March 26,2016,Albania,Austria,1,2,Friendly,in Austria,-3,3,1606,1805,1,0,57,19,1609,1802,T1
5953,March 26,2016,Bermuda,French Guiana,2,1,CONCACAF Champ &amp; Carib Champ qual,in Bermuda,19,-19,1230,1270,6,-6,153,139,1211,1289,T1
5954,March 26,2016,Dominica,British Virgin Islands,7,0,CONCACAF Champ &amp; Carib Champ qual,in the British Virgin Islands,19,-19,976,608,1,-1,190,228,957,627,T2
5955,March 26,2016,Burkina Faso,Uganda,1,0,African Nations Cup qualifier,in Burkina Faso,20,-20,1451,1514,2,-7,99,82,1431,1534,T1
5956,March 26,2016,Namibia,Burundi,3,1,African Nations Cup qualifier,in Burundi,39,-39,1375,1310,10,-8,115,128,1336,1349,T2
5957,March 26,2016,South Africa,Cameroon,2,2,African Nations Cup qualifier,in Cameroon,7,-7,1585,1606,2,0,62,57,1578,1613,draw
5958,March 26,2016,Morocco,Cape Verde,1,0,African Nations Cup qualifier,in Cape Verde,26,-26,1555,1519,7,-9,70,80,1529,1545,T2
5959,March 26,2016,Dominican Republic,Curaçao,1,2,CONCACAF Champ &amp; Carib Champ qual,in Curaçao,-18,18,1148,1121,0,3,170,177,1166,1103,T1
5960,March 26,2016,Angola,Democratic Republic of Congo,1,2,African Nations Cup qualifier,in the Democratic Republic of the Congo,-10,10,1408,1518,-1,3,108,81,1418,1508,T1
5961,March 26,2016,Germany,England,2,3,Friendly,in Germany,-15,15,2054,1975,0,2,1,5,2069,1960,T2
5962,March 26,2016,Croatia,Hungary,1,1,Friendly,in Hungary,-1,1,1817,1700,0,0,16,41,1818,1699,draw
5963,March 26,2016,Azerbaijan,Kazakhstan,0,1,Friendly,in Turkey,-11,11,1409,1399,-1,4,107,109,1420,1388,T1
5964,March 26,2016,Mauritius,Rwanda,1,0,African Nations Cup qualifier,in Mauritius,28,-28,1115,1309,2,-7,179,130,1087,1337,T1
5965,March 26,2016,Finland,Poland,0,5,Friendly,in Poland,-6,6,1579,1785,-2,0,64,22,1585,1779,T1
5966,March 26,2016,Lithuania,Russia,0,3,Friendly,in Russia,-2,2,1424,1776,0,0,103,25,1426,1774,T1
5967,March 26,2016,Senegal,Niger,2,0,African Nations Cup qualifier,in Senegal,4,-4,1654,1284,0,0,47,135,1650,1288,T1
5968,March 26,2016,Lesotho,Seychelles,0,2,African Nations Cup qualifier,in the Seychelles,-40,40,1137,994,-6,5,174,188,1177,954,T1
5969,March 26,2016,Sint Maarten,US Virgin Islands,1,2,CONCACAF Champ &amp; Carib Champ qual,in Sint Maarten,-34,34,886,740,-4,4,203,214,920,706,T2
5970,March 26,2016,New Caledonia,Vanuatu,1,2,Friendly,in Vanuatu,-12,12,1346,1196,-4,2,120,162,1358,1184,T1
5971,March 27,2016,Benin,South Sudan,4,1,African Nations Cup qualifier,in Benin,8,-8,1397,1135,2,-1,110,174,1389,1143,T1
5972,March 27,2016,Comoros,Botswana,1,2,African Nations Cup qualifier,in Botswana,-3,3,968,1302,0,0,191,132,971,1299,T1
5973,March 27,2016,Congo,Zambia,1,1,African Nations Cup qualifier,in Congo,-5,5,1491,1507,-1,0,89,86,1496,1502,draw
5974,March 27,2016,Kenya,Guinea-Bissau,0,1,African Nations Cup qualifier,in Kenya,-32,32,1325,1260,-9,10,127,144,1357,1228,T2
5975,March 27,2016,Mozambique,Ghana,0,0,African Nations Cup qualifier,in Mozambique,11,-11,1336,1638,4,-1,123,49,1325,1649,draw
5976,March 27,2016,Spain,Romania,0,0,Friendly,in Romania,-4,4,1998,1770,0,0,4,27,2002,1766,draw
5977,March 27,2016,Solomon Islands,Papua New Guinea,1,2,Friendly,in the Solomon Islands,-16,16,1167,1063,-3,0,168,185,1183,1047,T2
5978,March 27,2016,South Korea,Thailand,1,0,Friendly,in Thailand,3,-3,1795,1411,0,0,21,106,1792,1414,T2
5979,March 28,2016,Madagascar,Central African Republic,1,2,African Nations Cup qualifier,in Central African Republic,-15,15,1261,1274,-7,10,143,136,1276,1259,T1
5980,March 28,2016,Equatorial Guinea,Mali,0,1,African Nations Cup qualifier,in Equatorial Guinea,-15,15,1343,1559,-4,3,121,69,1358,1544,T2
5981,March 28,2016,Faroe Islands,Liechtenstein,3,2,Friendly,in Spain,9,-9,1242,1194,2,-1,150,162,1233,1203,T1
5982,March 28,2016,Libya,São Tomé and Príncipe,4,0,African Nations Cup qualifier,in Algeria,9,-9,1475,1115,2,-3,93,178,1466,1124,T1
5983,March 28,2016,Andorra,Moldova,0,1,Friendly,in Malta,-2,2,953,1355,0,1,193,117,955,1353,T1
5984,March 28,2016,Slovenia,Northern Ireland,0,1,Friendly,in Northern Ireland,-8,8,1614,1607,-2,3,56,57,1622,1599,T1
5985,March 28,2016,Gabon,Sierra Leone,0,1,Friendly,in Sierra Leone,-12,12,1473,1341,-5,3,95,122,1485,1329,T1
5986,March 28,2016,Wales,Ukraine,0,1,Friendly,in Ukraine,-4,4,1664,1821,0,0,44,16,1668,1817,T1
5987,March 28,2016,Swaziland,Zimbabwe,0,4,African Nations Cup qualifier,in Zimbabwe,-18,18,1246,1378,-7,1,149,115,1264,1360,T1
5988,March 29,2016,Afghanistan,Singapore,2,1,World Cup and Asian Cup qualifier,in Iran,24,-24,1147,1164,4,-6,171,169,1123,1188,T1
5989,March 29,2016,Angola,Democratic Republic of Congo,0,2,African Nations Cup qualifier,in Angola,-29,29,1379,1547,-5,8,113,73,1408,1518,T2
5990,March 29,2016,Bolivia,Argentina,0,2,World Cup qualifier,in Argentina,-3,3,1613,2050,1,0,54,2,1616,2047,T1
5991,March 29,2016,Australia,Jordan,5,1,World Cup and Asian Cup qualifier,in Australia,13,-13,1717,1525,1,-3,39,77,1704,1538,T1
5992,March 29,2016,Austria,Turkey,1,2,Friendly,in Austria,-13,13,1792,1824,-1,2,20,16,1805,1811,T2
5993,March 29,2016,Qatar,China,0,2,World Cup and Asian Cup qualifier,in China,-22,22,1535,1571,-4,5,74,67,1557,1549,T1
5994,March 29,2016,Colombia,Ecuador,3,1,World Cup qualifier,in Colombia,17,-17,1980,1884,2,-1,5,14,1963,1901,T1
5995,March 29,2016,Jamaica,Costa Rica,0,3,World Cup qualifier,in Costa Rica,-11,11,1579,1789,-3,3,64,21,1590,1778,T1
5996,March 29,2016,Dominica,Martinique,1,4,CONCACAF Champ &amp; Carib Champ qual,in Dominica,-7,7,969,1453,0,1,190,99,976,1446,T2
5997,March 29,2016,Barbados,Dominican Republic,0,2,CONCACAF Champ &amp; Carib Champ qual,in the Dominican Republic,-22,22,1136,1170,-5,3,174,167,1158,1148,T1
5998,March 29,2016,Nigeria,Egypt,0,1,African Nations Cup qualifier,in Egypt,-15,15,1612,1638,-5,5,55,48,1627,1623,T1
5999,March 29,2016,England,Netherlands,1,2,Friendly,in England,-15,15,1960,1902,-4,1,9,13,1975,1887,T2
6000,March 29,2016,Serbia,Estonia,1,0,Friendly,in Estonia,7,-7,1717,1494,0,-1,39,88,1710,1501,T2
6001,March 29,2016,Algeria,Ethiopia,3,3,African Nations Cup qualifier,in Ethiopia,-14,14,1657,1281,-5,3,47,137,1671,1267,draw
6002,March 29,2016,France,Russia,4,2,Friendly,in France,5,-5,1970,1771,0,0,6,25,1965,1776,T1
6003,March 29,2016,Cuba,French Guiana,0,3,CONCACAF Champ &amp; Carib Champ qual,in French Guiana,-32,32,1312,1302,-10,8,129,131,1344,1270,T1
6004,March 29,2016,Gambia,Mauritania,0,0,African Nations Cup qualifier,in The Gambia,-8,8,1302,1275,-3,1,131,139,1310,1267,draw
6005,March 29,2016,Georgia,Kazakhstan,1,1,Friendly,in Georgia,-5,5,1477,1404,0,1,91,108,1482,1399,draw
6006,March 29,2016,Italy,Germany,1,4,Friendly,in Germany,-6,6,1867,2060,0,0,15,1,1873,2054,T1
6007,March 29,2016,Gibraltar,Latvia,0,5,Friendly,in Gibraltar,-8,8,1111,1466,-1,1,178,96,1119,1458,T2
6008,March 29,2016,Iceland,Greece,3,2,Friendly,in Greece,12,-12,1673,1606,2,-6,43,60,1661,1618,T2
6009,March 29,2016,Honduras,El Salvador,2,0,World Cup qualifier,in Honduras,18,-18,1526,1442,9,-4,76,100,1508,1460,T1
6010,March 29,2016,India,Turkmenistan,1,2,World Cup and Asian Cup qualifier,in India,-15,15,1066,1287,-1,2,183,135,1081,1272,T2
6011,March 29,2016,Oman,Iran,0,2,World Cup and Asian Cup qualifier,in Iran,-7,7,1470,1735,-3,1,95,34,1477,1728,T1
6012,March 29,2016,Iraq,Vietnam,1,0,World Cup and Asian Cup qualifier,in Iran,7,-7,1499,1209,1,0,87,158,1492,1216,T1
6013,March 29,2016,Ireland,Slovakia,2,2,Friendly,in Ireland,-4,4,1775,1740,-1,0,24,33,1779,1736,draw
6014,March 29,2016,Japan,Syria,5,0,World Cup and Asian Cup qualifier,in Japan,11,-11,1761,1516,1,-3,29,79,1750,1527,T1
6015,March 29,2016,Myanmar,Lebanon,1,1,World Cup and Asian Cup qualifier,in Lebanon,17,-17,1046,1372,0,-2,186,115,1029,1389,draw
6016,March 29,2016,Seychelles,Lesotho,1,2,African Nations Cup qualifier,in Lesotho,-8,8,986,1145,-1,1,189,172,994,1137,T1
6017,March 29,2016,Djibouti,Liberia,0,5,African Nations Cup qualifier,in Liberia,-2,2,754,1332,0,1,212,124,756,1330,T1
6018,March 29,2016,Albania,Luxembourg,2,0,Friendly,in Luxembourg,6,-6,1612,1244,3,-3,55,150,1606,1250,T2
6019,March 29,2016,Macedonia,Bulgaria,0,2,Friendly,in Macedonia,-12,12,1424,1615,0,8,101,52,1436,1603,T2
6020,March 29,2016,Guinea,Malawi,2,1,African Nations Cup qualifier,in Malawi,14,-14,1555,1315,1,-2,72,128,1541,1329,T2
6021,March 29,2016,Malaysia,Macao,0,0,Friendly,in Malaysia,-9,9,1106,622,-1,0,179,227,1115,613,draw
6022,March 29,2016,Bhutan,Maldives,2,4,World Cup and Asian Cup qualifier,in the Maldives,-3,3,550,963,0,0,234,192,553,960,T1
6023,March 29,2016,Canada,Mexico,0,2,World Cup qualifier,in Mexico,-3,3,1511,1922,2,1,80,10,1514,1919,T1
6024,March 29,2016,Montenegro,Belarus,0,0,Friendly,in Montenegro,-2,2,1561,1580,-2,2,69,63,1563,1578,draw
6025,March 29,2016,Cape Verde,Morocco,0,2,African Nations Cup qualifier,in Morocco,-19,19,1500,1574,-6,5,86,66,1519,1555,T1
6026,March 29,2016,Burundi,Namibia,3,1,African Nations Cup qualifier,in Namibia,43,-43,1353,1332,11,-8,117,124,1310,1375,T2
6027,March 29,2016,Niger,Senegal,1,2,African Nations Cup qualifier,in Niger,-7,7,1277,1661,-3,2,138,45,1284,1654,T2
6028,March 29,2016,Norway,Finland,2,0,Friendly,in Norway,9,-9,1635,1570,1,-4,50,68,1626,1579,T1
6029,March 29,2016,East Timor,Palestine,0,7,World Cup and Asian Cup qualifier,in Palestine,-1,1,727,1338,0,1,215,122,728,1337,T1
6030,March 29,2016,Haiti,Panama,0,1,World Cup qualifier,in Panama,-7,7,1502,1677,-1,1,85,42,1509,1670,T1
6031,March 29,2016,Brazil,Paraguay,2,2,World Cup qualifier,in Paraguay,-10,10,2018,1752,0,0,3,31,2028,1742,draw
6032,March 29,2016,North Korea,Philippines,2,3,World Cup and Asian Cup qualifier,in the Philippines,-30,30,1503,1263,-9,10,84,143,1533,1233,T1
6033,March 29,2016,Belgium,Portugal,1,2,Friendly,in Portugal,-8,8,1921,1910,-1,0,11,12,1929,1902,T1
6034,March 29,2016,Guyana,Puerto Rico,1,0,CONCACAF Champ &amp; Carib Champ qual,in Puerto Rico,16,-16,1252,1056,3,-1,148,185,1236,1072,T2
6035,March 29,2016,Rwanda,Mauritius,5,0,African Nations Cup qualifier,in Rwanda,12,-12,1321,1103,3,-3,127,181,1309,1115,T1
6036,March 29,2016,Denmark,Scotland,0,1,Friendly,in Scotland,-8,8,1726,1721,-2,0,36,38,1734,1713,T1
6037,March 29,2016,Cameroon,South Africa,0,0,African Nations Cup qualifier,in South Africa,4,-4,1610,1581,0,0,58,62,1606,1585,draw
6038,March 29,2016,Antigua and Barbuda,Saint Kitts and Nevis,0,1,CONCACAF Champ &amp; Carib Champ qual,in Saint Kitts and Nevis,-14,14,1236,1274,-5,4,152,140,1250,1260,T1
6039,March 29,2016,Sudan,Ivory Coast,1,1,African Nations Cup qualifier,in Sudan,15,-15,1303,1725,4,-5,130,37,1288,1740,draw
6040,March 29,2016,Suriname,Guadeloupe,3,2,CONCACAF Champ &amp; Carib Champ qual,in Suriname,21,-21,1203,1287,4,-4,161,135,1182,1308,T1
6041,March 29,2016,Sweden,Czechia,1,1,Friendly,in Sweden,-3,3,1762,1755,0,-1,28,30,1765,1752,draw
6042,March 29,2016,Switzerland,Bosnia and Herzegovina,0,2,Friendly,in Switzerland,-22,22,1780,1748,-3,4,23,32,1802,1726,T2
6043,March 29,2016,Kyrgyzstan,Tajikistan,1,0,World Cup and Asian Cup qualifier,in Tajikistan,28,-28,1209,1199,8,-7,158,162,1181,1227,T2
6044,March 29,2016,Togo,Tunisia,0,0,African Nations Cup qualifier,in Togo,4,-4,1401,1556,1,-3,109,71,1397,1560,draw
6045,March 29,2016,Trinidad and Tobago,Saint Vincent and the Grenadines,6,0,World Cup qualifier,in Trinidad and Tobago,4,-4,1589,1143,1,-2,61,173,1585,1147,T1
6046,March 29,2016,United Arab Emirates,Saudi Arabia,1,1,World Cup and Asian Cup qualifier,in the United Arab Emirates,-11,11,1631,1535,-3,3,51,74,1642,1524,draw
6047,March 29,2016,Uganda,Burkina Faso,0,0,African Nations Cup qualifier,in Uganda,-9,9,1505,1460,-1,2,83,97,1514,1451,draw
6048,March 29,2016,Uruguay,Peru,1,0,World Cup qualifier,in Uruguay,7,-7,1964,1766,0,-1,8,27,1957,1773,T1
6049,March 29,2016,Guatemala,United States,0,4,World Cup qualifier,in the United States,-11,11,1510,1733,-3,2,81,35,1521,1722,T1
6050,March 29,2016,Grenada,US Virgin Islands,2,1,CONCACAF Champ &amp; Carib Champ qual,in the US Virgin Islands,6,-6,1150,734,2,0,170,214,1144,740,T2
6051,March 29,2016,Uzbekistan,Bahrain,1,0,World Cup and Asian Cup qualifier,in Uzbekistan,5,-5,1661,1422,1,-3,45,105,1656,1427,T1
6052,March 29,2016,Chile,Venezuela,4,1,World Cup qualifier,in Venezuela,15,-15,1968,1611,2,-6,7,57,1953,1626,T2
6053,April 27,2016,Martinique,Panama,0,2,Friendly,in Martinique,-10,10,1443,1687,0,0,99,42,1453,1677,T2
6054,May 20,2016,Ivory Coast,Hungary,0,0,Friendly,in Hungary,2,-2,1727,1698,1,0,36,41,1725,1700,draw
6055,May 21,2016,Lesotho,Botswana,1,2,Friendly,in Botswana,-4,4,1141,1306,-1,1,173,130,1145,1302,T1
6056,May 22,2016,England,Turkey,2,1,Friendly,in England,4,-4,1964,1820,1,-1,8,17,1960,1824,T1
6057,May 22,2016,United States,Puerto Rico,3,1,Friendly,in Puerto Rico,1,-1,1734,1055,0,0,35,185,1733,1056,T2
6058,May 23,2016,Trinidad and Tobago,Peru,0,4,Friendly,in Peru,-6,6,1583,1772,0,2,61,25,1589,1766,T1
6059,May 24,2016,Panama,Venezuela,0,0,Friendly,in Panama,-5,5,1682,1616,0,5,42,52,1687,1611,draw
6060,May 25,2016,Democratic Republic of Congo,Romania,1,1,Friendly,in Italy,6,-6,1553,1764,0,0,73,27,1547,1770,draw
6061,May 25,2016,Cyprus,Serbia,1,2,Friendly,in Serbia,-2,2,1421,1719,-1,0,105,39,1423,1717,T1
6062,May 25,2016,Ecuador,United States,0,1,Friendly,in the United States,-11,11,1873,1745,0,2,14,33,1884,1734,T1
6063,May 26,2016,Azerbaijan,Andorra,0,0,Friendly,in Austria,-9,9,1400,962,-2,0,109,193,1409,953,draw
6064,May 27,2016,Argentina,Honduras,1,0,Friendly,in Argentina,1,-1,2051,1525,0,0,2,76,2050,1526,T1
6065,May 27,2016,Jamaica,Chile,2,1,Friendly,in Chile,19,-19,1598,1949,3,-2,61,9,1579,1968,T2
6066,May 27,2016,Venezuela,Costa Rica,1,2,Friendly,in Costa Rica,-3,3,1613,1792,-4,1,56,20,1616,1789,T1
6067,May 27,2016,Moldova,Croatia,0,1,Friendly,in Croatia,-1,1,1354,1818,0,0,116,18,1355,1817,T1
6068,May 27,2016,Malta,Czechia,0,6,Friendly,in Austria,-2,2,1232,1757,0,0,153,30,1234,1755,T1
6069,May 27,2016,England,Australia,2,1,Friendly,in England,2,-2,1966,1715,1,0,7,40,1964,1717,T1
6070,May 27,2016,Netherlands,Ireland,1,1,Friendly,in Ireland,-1,1,1901,1776,0,0,13,24,1902,1775,draw
6071,May 27,2016,Swaziland,Lesotho,2,0,Friendly,in Lesotho,15,-15,1261,1126,4,-2,145,175,1246,1141,T2
6072,May 27,2016,Morocco,Congo,2,0,Friendly,in Morocco,8,-8,1582,1483,4,-1,62,90,1574,1491,T1
6073,May 27,2016,Nigeria,Mali,1,0,Friendly,in France,8,-8,1620,1551,4,-3,52,73,1612,1559,T1
6074,May 27,2016,Belarus,Northern Ireland,0,3,Friendly,in Northern Ireland,-11,11,1569,1618,-5,6,68,53,1580,1607,T1
6075,May 27,2016,Georgia,Slovakia,1,3,Friendly,in Austria,-5,5,1472,1745,-3,1,94,33,1477,1740,T1
6076,May 27,2016,Zambia,Togo,0,1,Friendly,in Togo,-10,10,1497,1411,-5,2,87,106,1507,1401,T1
6077,May 27,2016,Uruguay,Trinidad and Tobago,3,1,Friendly,in Uruguay,2,-2,1966,1581,1,-2,7,63,1964,1583,T1
6078,May 28,2016,Guatemala,Armenia,1,7,Friendly,in the United States,-23,23,1487,1508,-8,8,89,81,1510,1485,T1
6079,May 28,2016,Mauritania,Gabon,2,0,Friendly,in Spain,23,-23,1298,1450,5,-5,134,98,1275,1473,T1
6080,May 28,2016,Paraguay,Mexico,0,1,Friendly,in the United States,-5,5,1747,1927,-2,-1,33,11,1752,1922,T1
6081,May 28,2016,Malaysia,Myanmar,0,0,Friendly,in Myanmar,1,-1,1107,1045,0,0,179,186,1106,1046,draw
6082,May 28,2016,New Zealand,Fiji,3,1,World Cup qualifier and Oceania Cup,in Papua New Guinea,14,-14,1535,1257,4,-5,74,147,1521,1271,T1
6083,May 28,2016,Peru,El Salvador,3,1,Friendly,in the United States,4,-4,1776,1438,2,0,23,100,1772,1442,T1
6084,May 28,2016,Senegal,Rwanda,2,0,Friendly,in Rwanda,6,-6,1667,1315,1,0,44,127,1661,1321,T2
6085,May 28,2016,Solomon Islands,Vanuatu,1,0,World Cup qualifier and Oceania Cup,in Papua New Guinea,27,-27,1194,1169,5,-5,163,168,1167,1196,T1
6086,May 28,2016,Belgium,Switzerland,2,1,Friendly,in Switzerland,9,-9,1930,1771,1,-2,10,25,1921,1780,T2
6087,May 28,2016,United States,Bolivia,4,0,Friendly,in the United States,8,-8,1753,1605,2,-4,31,60,1745,1613,T1
6088,May 29,2016,Albania,Qatar,3,1,Friendly,in Austria,12,-12,1624,1523,5,-4,52,78,1612,1535,T1
6089,May 29,2016,Brazil,Panama,2,0,Friendly,in the United States,4,-4,2022,1678,0,0,3,42,2018,1682,T1
6090,May 29,2016,East Timor,Cambodia,0,2,Friendly,in Cambodia,-11,11,716,732,-2,2,217,215,727,721,T1
6091,May 29,2016,Haiti,Colombia,1,3,Friendly,in the United States,-2,2,1500,1982,0,0,84,5,1502,1980,T1
6092,May 29,2016,Germany,Slovakia,1,3,Friendly,in Germany,-27,27,2033,1772,-1,9,2,25,2060,1745,T2
6093,May 29,2016,Scotland,Italy,0,1,Friendly,in Malta,-6,6,1715,1873,-1,1,39,14,1721,1867,T1
6094,May 29,2016,Kenya,Tanzania,1,1,Friendly,in Kenya,-2,2,1323,1346,0,1,126,118,1325,1344,draw
6095,May 29,2016,Nepal,Laos,1,1,Friendly,in Laos,0,0,898,812,0,0,201,208,898,812,draw
6096,May 29,2016,Lithuania,Estonia,2,0,Baltic Cup,in Lithuania,21,-21,1445,1473,2,-4,99,92,1424,1494,T1
6097,May 29,2016,Azerbaijan,Macedonia,1,3,Friendly,in Austria,-14,14,1386,1438,-2,0,111,101,1400,1424,T1
6098,May 29,2016,New Caledonia,Papua New Guinea,1,1,World Cup qualifier and Oceania Cup,in Papua New Guinea,-12,12,1334,1075,-5,1,123,183,1346,1063,draw
6099,May 29,2016,Norway,Portugal,0,3,Friendly,in Portugal,-4,4,1631,1914,0,0,50,12,1635,1910,T1
6100,May 29,2016,Spain,Bosnia and Herzegovina,3,1,Friendly,in Switzerland,6,-6,2004,1742,0,-2,4,34,1998,1748,T1
6101,May 29,2016,Tahiti,Samoa,4,0,World Cup qualifier and Oceania Cup,in Papua New Guinea,5,-5,1231,703,1,0,154,218,1226,708,T1
6102,May 29,2016,Turkey,Montenegro,1,0,Friendly,in Turkey,2,-2,1822,1559,0,0,17,69,1820,1561,T1
6103,May 29,2016,Romania,Ukraine,3,4,Friendly,in Italy,-8,8,1756,1829,-4,0,31,16,1764,1821,T1
6104,May 30,2016,France,Cameroon,3,2,Friendly,in France,1,-1,1971,1609,0,0,6,58,1970,1610,T1
6105,May 30,2016,Zambia,Gambia,0,0,Friendly,in The Gambia,-3,3,1494,1305,0,1,87,131,1497,1302,draw
6106,May 30,2016,Sweden,Slovenia,0,0,Friendly,in Sweden,-6,6,1756,1620,-2,3,30,53,1762,1614,draw
6107,May 31,2016,Austria,Malta,2,1,Friendly,in Austria,0,0,1792,1232,0,0,20,153,1792,1232,T1
6108,May 31,2016,Solomon Islands,Fiji,0,1,World Cup qualifier and Oceania Cup,in Papua New Guinea,-21,21,1173,1278,-2,8,165,139,1194,1257,T1
6109,May 31,2016,Ireland,Belarus,1,2,Friendly,in Ireland,-17,17,1759,1586,-5,6,28,62,1776,1569,T2
6110,May 31,2016,Sudan,Kenya,1,1,Friendly,in Kenya,3,-3,1306,1320,2,0,130,126,1303,1323,draw
6111,May 31,2016,Luxembourg,Nigeria,1,3,Friendly,in Luxembourg,-5,5,1239,1625,-1,1,151,52,1244,1620,T2
6112,May 31,2016,New Zealand,Vanuatu,5,0,World Cup qualifier and Oceania Cup,in Papua New Guinea,11,-11,1546,1158,0,-1,74,169,1535,1169,T1
6113,May 31,2016,Serbia,Israel,3,1,Friendly,in Serbia,6,-6,1725,1570,0,-2,38,67,1719,1576,T1
6114,May 31,2016,Syria,Vietnam,0,2,Friendly,in Vietnam,-23,23,1493,1232,-7,5,86,153,1516,1209,T1
6115,May 31,2016,Uganda,Zimbabwe,0,2,Friendly,in Zimbabwe,-16,16,1489,1394,-5,4,87,110,1505,1378,T1
6116,June 1,2016,El Salvador,Armenia,0,4,Friendly,in the United States,-15,15,1423,1523,-2,2,103,78,1438,1508,T1
6117,June 1,2016,Finland,Belgium,1,1,Friendly,in Belgium,9,-9,1579,1921,1,-1,66,11,1570,1930,draw
6118,June 1,2016,Curaçao,Guyana,5,2,CONCACAF Champ &amp; Carib Champ qual,in Curaçao,38,-38,1159,1214,7,-8,169,157,1121,1252,T1
6119,June 1,2016,Czechia,Russia,2,1,Friendly,in Austria,10,-10,1767,1761,3,-2,26,27,1757,1771,T1
6120,June 1,2016,Estonia,Andorra,2,0,Friendly,in Estonia,1,-1,1474,961,-1,0,93,193,1473,962,T1
6121,June 1,2016,Bermuda,French Guiana,1,0,CONCACAF Champ &amp; Carib Champ qual,in French Guiana,29,-29,1259,1273,8,-9,148,142,1230,1302,T2
6122,June 1,2016,Puerto Rico,Grenada,3,3,CONCACAF Champ &amp; Carib Champ qual,in Grenada,10,-10,1065,1140,0,-3,185,173,1055,1150,draw
6123,June 1,2016,Venezuela,Guatemala,1,1,Friendly,in the United States,-3,3,1610,1490,0,1,57,87,1613,1487,draw
6124,June 1,2016,Lithuania,Latvia,1,2,Baltic Cup,in Latvia,-10,10,1435,1476,-2,5,101,90,1445,1466,T1
6125,June 1,2016,Martinique,Guadeloupe,2,0,CONCACAF Champ &amp; Carib Champ qual,in Martinique,11,-11,1454,1276,2,-4,98,140,1443,1287,T1
6126,June 1,2016,Chile,Mexico,0,1,Friendly,in the United States,-11,11,1938,1938,0,2,9,9,1949,1927,T1
6127,June 1,2016,Samoa,New Caledonia,0,7,World Cup qualifier and Oceania Cup,in Papua New Guinea,-3,3,700,1337,-1,1,219,122,703,1334,T1
6128,June 1,2016,Norway,Iceland,3,2,Friendly,in Norway,8,-8,1639,1665,2,-1,48,44,1631,1673,T1
6129,June 1,2016,Tahiti,Papua New Guinea,2,2,World Cup qualifier and Oceania Cup,in Papua New Guinea,-4,4,1227,1079,0,1,155,182,1231,1075,draw
6130,June 1,2016,Poland,Netherlands,1,2,Friendly,in Poland,-10,10,1775,1911,-1,0,23,13,1785,1901,T2
6131,June 1,2016,South Korea,Spain,1,6,Friendly,in Austria,-9,9,1786,2013,-2,0,21,4,1795,2004,T1
6132,June 1,2016,Suriname,Saint Kitts and Nevis,0,1,CONCACAF Champ &amp; Carib Champ qual,in Saint Kitts and Nevis,-11,11,1192,1285,-2,5,163,136,1203,1274,T1
6133,June 2,2016,England,Portugal,1,0,Friendly,in England,6,-6,1972,1908,1,-1,6,13,1966,1914,T1
6134,June 2,2016,India,Laos,1,0,Asian Cup qualifier,in Laos,12,-12,1078,800,1,0,183,208,1066,812,T2
6135,June 2,2016,Macedonia,Iran,1,3,Friendly,in Macedonia,-7,7,1431,1742,-1,1,101,34,1438,1735,T2
6136,June 2,2016,East Timor,Malaysia,0,3,Asian Cup qualifier,in Malaysia,-4,4,712,1111,0,1,217,178,716,1107,T1
6137,June 2,2016,Yemen,Maldives,2,0,Asian Cup qualifier,in the Maldives,21,-21,1194,942,3,-5,162,197,1173,963,T2
6138,June 2,2016,Seychelles,Algeria,0,2,African Nations Cup qualifier,in the Seychelles,-2,2,984,1659,0,0,189,47,986,1657,T2
6139,June 2,2016,Somaliland,Chagos Islands,3,2,World Football Cup,in Georgia,10,-10,1002,798,1,0,187,209,992,808,T1
6140,June 2,2016,Cambodia,Taiwan,2,2,Asian Cup qualifier,in Taiwan,9,-9,741,781,1,0,214,210,732,790,draw
6141,June 2,2016,Tajikistan,Bangladesh,5,0,Asian Cup qualifier,in Tajikistan,7,-7,1206,889,0,0,161,202,1199,896,T1
6142,June 3,2016,Azerbaijan,Canada,1,1,Friendly,in Austria,3,-3,1389,1508,0,0,112,80,1386,1511,draw
6143,June 3,2016,Denmark,Bosnia and Herzegovina,2,2,Friendly tournament,in Japan,1,-1,1727,1741,1,0,36,34,1726,1742,draw
6144,June 3,2016,Trinidad and Tobago,China,2,4,Friendly,in China,-11,11,1570,1582,-3,4,67,63,1581,1571,T1
6145,June 3,2016,Djibouti,Tunisia,0,3,African Nations Cup qualifier,in Djibouti,-1,1,753,1557,-1,0,213,70,754,1556,T2
6146,June 3,2016,Hong Kong,Vietnam,2,2,Friendly tournament,in Myanmar,1,-1,1215,1231,0,-1,157,154,1214,1232,draw
6147,June 3,2016,Bulgaria,Japan,2,7,Friendly tournament,in Japan,-12,12,1603,1773,-3,3,59,24,1615,1761,T1
6148,June 3,2016,Jordan,United Arab Emirates,3,1,King's Cup,in Thailand,29,-29,1554,1602,4,-9,72,60,1525,1631,T1
6149,June 3,2016,Faroe Islands,Kosovo,0,2,Friendly,in Germany,-9,9,1233,1400,-2,2,152,109,1242,1391,T1
6150,June 3,2016,Morocco,Libya,1,1,African Nations Cup qualifier,in Tunisia,-6,6,1576,1481,-3,1,66,90,1582,1475,draw
6151,June 3,2016,Mauritania,Cameroon,0,1,African Nations Cup qualifier,in Mauritania,-9,9,1289,1618,0,5,133,53,1298,1609,T2
6152,June 3,2016,Singapore,Myanmar,1,0,Friendly tournament,in Myanmar,14,-14,1178,1031,2,0,166,186,1164,1045,T2
6153,June 3,2016,Georgia,Romania,1,5,Friendly,in Romania,-4,4,1468,1760,-1,1,95,29,1472,1756,T1
6154,June 3,2016,Switzerland,Moldova,2,1,Friendly,in Switzerland,1,-1,1772,1353,0,0,25,116,1771,1354,T1
6155,June 3,2016,Thailand,Syria,2,2,King's Cup,in Thailand,-1,1,1410,1494,-1,1,107,85,1411,1493,draw
6156,June 3,2016,Albania,Ukraine,1,3,Friendly,in Italy,-7,7,1617,1836,-2,0,55,16,1624,1829,T1
6157,June 3,2016,Colombia,United States,2,0,Copa América,in the United States,24,-24,2006,1729,0,-3,5,35,1982,1753,T2
6158,June 4,2016,Australia,Greece,1,0,Friendly,in Australia,5,-5,1720,1601,0,-3,39,60,1715,1606,T1
6159,June 4,2016,Netherlands,Austria,2,0,Friendly,in Austria,14,-14,1925,1778,1,-3,11,22,1911,1792,T2
6160,June 4,2016,Dominican Republic,Bermuda,1,0,CONCACAF Champ &amp; Carib Champ qual,in Bermuda,30,-30,1200,1229,5,-5,163,153,1170,1259,T2
6161,June 4,2016,Uganda,Botswana,2,1,African Nations Cup qualifier,in Botswana,15,-15,1504,1291,6,0,82,130,1489,1306,T2
6162,June 4,2016,Ecuador,Brazil,0,0,Copa América,in the United States,10,-10,1883,2012,0,-1,14,4,1873,2022,draw
6163,June 4,2016,Senegal,Burundi,2,0,African Nations Cup qualifier,in Burundi,14,-14,1681,1339,1,-5,42,121,1667,1353,T2
6164,June 4,2016,Paraguay,Costa Rica,0,0,Copa América,in the United States,3,-3,1750,1789,0,0,32,19,1747,1792,draw
6165,June 4,2016,Croatia,San Marino,10,0,Friendly,in Croatia,0,0,1818,884,0,0,18,204,1818,884,T1
6166,June 4,2016,Latvia,Estonia,0,0,Baltic Cup,in Estonia,4,-4,1480,1470,1,1,90,92,1476,1474,draw
6167,June 4,2016,France,Scotland,3,0,Friendly,in France,4,-4,1975,1711,1,-1,6,40,1971,1715,T1
6168,June 4,2016,South Africa,Gambia,4,0,African Nations Cup qualifier,in The Gambia,20,-20,1601,1285,4,-4,60,136,1581,1305,T2
6169,June 4,2016,Hungary,Germany,0,2,Friendly,in Germany,-2,2,1696,2035,0,0,41,2,1698,2033,T1
6170,June 4,2016,Dominica,Guadeloupe,1,2,CONCACAF Champ &amp; Carib Champ qual,in Guadeloupe,-4,4,965,1280,-1,1,191,139,969,1276,T1
6171,June 4,2016,Zambia,Guinea-Bissau,2,3,African Nations Cup qualifier,in Guinea-Bissau,-27,27,1467,1287,-10,13,95,134,1494,1260,T1
6172,June 4,2016,Gabon,Ivory Coast,1,2,Friendly,in Ivory Coast,-2,2,1448,1729,0,1,99,35,1450,1727,T1
6173,June 4,2016,Niger,Namibia,0,1,African Nations Cup qualifier,in Namibia,-12,12,1265,1344,-3,5,142,119,1277,1332,T1
6174,June 4,2016,New Zealand,Solomon Islands,1,0,World Cup qualifier and Oceania Cup,in Papua New Guinea,5,-5,1551,1168,0,-2,75,169,1546,1173,T1
6175,June 4,2016,Peru,Haiti,1,0,Copa América,in the United States,8,-8,1784,1492,1,-4,21,86,1776,1500,T1
6176,June 4,2016,Puerto Rico,Antigua and Barbuda,2,1,CONCACAF Champ &amp; Carib Champ qual,in Puerto Rico,24,-24,1089,1212,3,-7,182,158,1065,1236,T1
6177,June 4,2016,Rwanda,Mozambique,2,3,African Nations Cup qualifier,in Rwanda,-24,24,1291,1360,-3,7,130,116,1315,1336,T2
6178,June 4,2016,São Tomé and Príncipe,Cape Verde,1,2,African Nations Cup qualifier,in São Tomé and Príncipe,-6,6,1109,1506,-2,1,179,81,1115,1500,T2
6179,June 4,2016,Sierra Leone,Sudan,1,0,African Nations Cup qualifier,in Sierra Leone,13,-13,1354,1293,3,1,117,129,1341,1306,T1
6180,June 4,2016,Northern Ireland,Slovakia,0,0,Friendly,in Slovakia,6,-6,1624,1766,1,-2,52,27,1618,1772,draw
6181,June 4,2016,South Sudan,Mali,0,3,African Nations Cup qualifier,in South Sudan,-10,10,1125,1561,-1,5,176,69,1135,1551,T2
6182,June 4,2016,Suriname,Saint Vincent and the Grenadines,2,1,CONCACAF Champ &amp; Carib Champ qual,in Suriname,12,-12,1204,1131,2,-2,162,174,1192,1143,T1
6183,June 4,2016,Egypt,Tanzania,2,0,African Nations Cup qualifier,in Tanzania,15,-15,1653,1331,1,-7,48,125,1638,1346,T2
6184,June 4,2016,Guyana,US Virgin Islands,7,0,CONCACAF Champ &amp; Carib Champ qual,in the US Virgin Islands,9,-9,1223,725,3,-1,155,216,1214,734,T2
6185,June 4,2016,Fiji,Vanuatu,2,3,World Cup qualifier and Oceania Cup,in Papua New Guinea,-33,33,1245,1191,-10,4,148,166,1278,1158,T1
6186,June 5,2016,Norway,Belgium,2,3,Friendly,in Belgium,-2,2,1637,1923,-1,0,50,12,1639,1921,T1
6187,June 5,2016,Angola,Central African Republic,1,3,African Nations Cup qualifier,in Central African Republic,-30,30,1349,1304,-4,12,118,128,1379,1274,T1
6188,June 5,2016,Burkina Faso,Comoros,1,0,African Nations Cup qualifier,in the Comoros,4,-4,1464,964,1,-1,95,191,1460,968,T2
6189,June 5,2016,Czechia,South Korea,1,2,Friendly,in Czechia,-12,12,1755,1798,-5,1,31,19,1767,1786,T2
6190,June 5,2016,Kenya,Congo,2,1,African Nations Cup qualifier,in Kenya,24,-24,1344,1459,7,-8,119,96,1320,1483,T1
6191,June 5,2016,Lesotho,Ethiopia,1,2,African Nations Cup qualifier,in Lesotho,-17,17,1109,1298,-3,9,178,129,1126,1281,T2
6192,June 5,2016,Liberia,Togo,2,2,African Nations Cup qualifier,in Liberia,-1,1,1331,1412,0,-1,124,107,1332,1411,draw
6193,June 5,2016,Democratic Republic of Congo,Madagascar,6,1,African Nations Cup qualifier,in Madagascar,20,-20,1573,1241,7,-3,67,148,1553,1261,T2
6194,June 5,2016,Mauritius,Ghana,0,2,African Nations Cup qualifier,in Mauritius,-5,5,1098,1643,0,1,181,49,1103,1638,T2
6195,June 5,2016,Uruguay,Mexico,1,3,Copa América,in the United States,-41,41,1925,1979,-2,3,10,6,1966,1938,T1
6196,June 5,2016,New Caledonia,Tahiti,1,1,World Cup qualifier and Oceania Cup,in Papua New Guinea,-8,8,1329,1235,-3,4,126,150,1337,1227,draw
6197,June 5,2016,Papua New Guinea,Samoa,8,0,World Cup qualifier and Oceania Cup,in Papua New Guinea,7,-7,1086,693,0,-1,183,220,1079,700,T1
6198,June 5,2016,Serbia,Russia,1,1,Friendly,in Monaco,1,-1,1726,1760,0,0,38,28,1725,1761,draw
6199,June 5,2016,Turkey,Slovenia,1,0,Friendly,in Slovenia,7,-7,1829,1613,0,-3,17,56,1822,1620,T2
6200,June 5,2016,Swaziland,Guinea,1,0,African Nations Cup qualifier,in Swaziland,30,-30,1291,1525,13,-4,132,76,1261,1555,T1
6201,June 5,2016,Wales,Sweden,0,3,Friendly,in Sweden,-9,9,1655,1765,-2,4,47,27,1664,1756,T1
6202,June 5,2016,Syria,United Arab Emirates,1,0,King's Cup,in Thailand,20,-20,1514,1582,5,-3,80,62,1494,1602,T1
6203,June 5,2016,Thailand,Jordan,2,0,King's Cup,in Thailand,25,-25,1435,1529,7,-2,100,75,1410,1554,T1
6204,June 5,2016,Jamaica,Venezuela,0,1,Copa América,in the United States,-24,24,1574,1634,-4,5,66,51,1598,1610,T1
6205,June 5,2016,Zimbabwe,Malawi,3,0,African Nations Cup qualifier,in Zimbabwe,18,-18,1412,1297,4,-3,107,130,1394,1315,T1
6206,June 6,2016,Chile,Argentina,1,2,Copa América,in the United States,-17,17,1921,2068,-3,0,12,1,1938,2051,T1
6207,June 6,2016,Liechtenstein,Iceland,0,4,Friendly,in Iceland,-1,1,1193,1666,0,0,164,44,1194,1665,T1
6208,June 6,2016,Finland,Italy,0,2,Friendly,in Italy,-3,3,1576,1876,0,0,64,15,1579,1873,T1
6209,June 6,2016,Malaysia,East Timor,3,0,Asian Cup qualifier,in Malaysia,4,-4,1115,708,0,0,176,217,1111,712,T1
6210,June 6,2016,Hong Kong,Myanmar,0,3,Friendly tournament,in Myanmar,-32,32,1183,1063,-10,0,167,186,1215,1031,T1
6211,June 6,2016,Bolivia,Panama,1,2,Copa América,in the United States,-20,20,1585,1698,-4,2,61,41,1605,1678,T1
6212,June 6,2016,Poland,Lithuania,0,0,Friendly,in Poland,-9,9,1766,1444,-2,0,25,100,1775,1435,draw
6213,June 6,2016,Vietnam,Singapore,3,0,Friendly tournament,in Myanmar,22,-22,1253,1156,6,-2,147,170,1231,1178,T1
6214,June 7,2016,Grenada,Antigua and Barbuda,1,5,CONCACAF Champ &amp; Carib Champ qual,in Antigua and Barbuda,-20,20,1120,1232,-2,4,174,153,1140,1212,T1
6215,June 7,2016,Australia,Greece,1,2,Friendly,in Australia,-16,16,1704,1617,-1,3,40,55,1720,1601,T2
6216,June 7,2016,Bangladesh,Tajikistan,0,1,Asian Cup qualifier,in Bangladesh,-9,9,880,1215,-2,1,204,159,889,1206,T2
6217,June 7,2016,Taiwan,Cambodia,0,2,Asian Cup qualifier,in Cambodia,-25,25,756,766,-2,4,212,210,781,741,T1
6218,June 7,2016,Canada,Uzbekistan,2,1,Friendly,in Austria,14,-14,1522,1647,1,-3,80,48,1508,1661,T1
6219,June 7,2016,Kazakhstan,China,1,0,Friendly,in China,17,-17,1421,1565,3,-7,106,69,1404,1582,T2
6220,June 7,2016,Colombia,Paraguay,2,1,Copa América,in the United States,9,-9,2015,1741,2,-4,3,36,2006,1750,T1
6221,June 7,2016,US Virgin Islands,Curaçao,0,7,CONCACAF Champ &amp; Carib Champ qual,in Curaçao,-4,4,721,1163,0,0,216,169,725,1159,T1
6222,June 7,2016,Bulgaria,Denmark,0,4,Friendly tournament,in Japan,-18,18,1585,1745,-3,3,60,34,1603,1727,T1
6223,June 7,2016,Dominica,Martinique,0,4,CONCACAF Champ &amp; Carib Champ qual,in Dominica,-7,7,958,1461,-2,2,192,96,965,1454,T2
6224,June 7,2016,French Guiana,Dominican Republic,1,2,CONCACAF Champ &amp; Carib Champ qual,in the Dominican Republic,-18,18,1255,1218,-4,4,146,158,1273,1200,T1
6225,June 7,2016,Laos,India,1,6,Asian Cup qualifier,in India,-8,8,792,1086,-1,1,209,183,800,1078,T1
6226,June 7,2016,Kyrgyzstan,Iran,0,6,Friendly,in Iran,-1,1,1208,1743,-2,-2,160,35,1209,1742,T1
6227,June 7,2016,Japan,Bosnia and Herzegovina,1,2,Friendly tournament,in Japan,-20,20,1753,1761,-9,7,32,27,1773,1741,T2
6228,June 7,2016,Georgia,Spain,1,0,Friendly,in Spain,20,-20,1488,1993,5,-2,88,5,1468,2013,T2
6229,June 7,2016,Saint Kitts and Nevis,Saint Vincent and the Grenadines,1,0,CONCACAF Champ &amp; Carib Champ qual,in Saint Vincent and the Grenadines,17,-17,1302,1114,10,-2,129,176,1285,1131,T2
6230,June 7,2016,United States,Costa Rica,4,0,Copa América,in the United States,42,-42,1771,1747,12,-13,23,33,1729,1789,T1
6231,June 7,2016,Maldives,Yemen,0,2,Asian Cup qualifier,in Qatar,-11,11,931,1205,0,1,197,162,942,1194,T1
6232,June 8,2016,Haiti,Brazil,1,7,Copa América,in the United States,-5,5,1487,2017,-2,1,88,3,1492,2012,T1
6233,June 8,2016,Ecuador,Peru,2,2,Copa América,in the United States,-7,7,1876,1791,0,0,14,20,1883,1784,draw
6234,June 8,2016,Malawi,Namibia,0,0,Friendly,in Namibia,4,-4,1301,1340,1,-2,130,121,1297,1344,draw
6235,June 8,2016,New Zealand,New Caledonia,1,0,Oceania Nations Cup,in Papua New Guinea,11,-11,1562,1318,3,0,70,126,1551,1329,T1
6236,June 8,2016,Solomon Islands,Papua New Guinea,1,2,Oceania Nations Cup,in Papua New Guinea,-24,24,1144,1110,-3,5,171,178,1168,1086,T1
6237,June 8,2016,Estonia,Portugal,0,7,Friendly,in Portugal,-2,2,1468,1910,-1,0,93,13,1470,1908,T1
6238,June 9,2016,Mexico,Jamaica,2,0,Copa América,in the United States,7,-7,1986,1567,0,-3,6,68,1979,1574,T1
6239,June 9,2016,Uruguay,Venezuela,0,1,Copa América,in the United States,-42,42,1883,1676,-4,7,13,44,1925,1634,T1
6240,June 10,2016,Argentina,Panama,5,0,Copa América,in the United States,11,-11,2079,1687,0,-1,1,42,2068,1698,T1
6241,June 10,2016,Chile,Bolivia,2,1,Copa América,in the United States,6,-6,1927,1579,2,-2,9,62,1921,1585,T1
6242,June 10,2016,France,Romania,2,1,European Championship,in France,7,-7,1982,1753,0,-3,7,31,1975,1760,T1
6243,June 11,2016,Costa Rica,Colombia,3,2,Copa América,in the United States,41,-41,1788,1974,12,-3,21,7,1747,2015,T1
6244,June 11,2016,Russia,England,1,1,European Championship,in France,14,-14,1774,1958,3,0,25,8,1760,1972,draw
6245,June 11,2016,Madagascar,Seychelles,1,0,COSAFA Cup,in Namibia,7,-7,1248,977,1,0,148,189,1241,984,T1
6246,June 11,2016,Papua New Guinea,New Zealand,0,0,Oceania Nations Cup,in Papua New Guinea,19,-19,1129,1543,5,-3,173,73,1110,1562,draw
6247,June 11,2016,Zimbabwe,Swaziland,2,2,COSAFA Cup,in Namibia,-7,7,1405,1298,-1,2,109,131,1412,1291,draw
6248,June 11,2016,Albania,Switzerland,0,1,European Championship,in France,-15,15,1602,1787,-2,0,57,22,1617,1772,T1
6249,June 11,2016,Paraguay,United States,0,1,Copa América,in the United States,-16,16,1725,1787,-2,1,38,22,1741,1771,T1
6250,June 11,2016,Slovakia,Wales,1,2,European Championship,in France,-33,33,1733,1688,-11,5,35,42,1766,1655,T1
6251,June 12,2016,Benin,Equatorial Guinea,2,1,African Nations Cup qualifier,in Benin,12,-12,1409,1331,2,-3,109,123,1397,1343,T1
6252,June 12,2016,Croatia,Turkey,1,0,European Championship,in France,26,-26,1844,1803,2,-2,16,19,1818,1829,T1
6253,June 12,2016,Haiti,Ecuador,0,4,Copa América,in the United States,-9,9,1478,1885,-2,1,90,13,1487,1876,T1
6254,June 12,2016,Germany,Ukraine,2,0,European Championship,in France,18,-18,2053,1818,0,-2,2,18,2035,1836,T1
6255,June 12,2016,Lesotho,Mauritius,3,0,COSAFA Cup,in Namibia,34,-34,1143,1064,7,-3,172,185,1109,1098,T1
6256,June 12,2016,Malawi,Angola,3,0,COSAFA Cup,in Namibia,40,-40,1341,1309,11,-10,119,128,1301,1349,T1
6257,June 12,2016,Peru,Brazil,1,0,Copa América,in the United States,39,-39,1830,1978,3,-3,17,6,1791,2017,T1
6258,June 12,2016,Northern Ireland,Poland,0,1,European Championship,in France,-15,15,1609,1781,-3,2,56,24,1624,1766,T1
6259,June 13,2016,Sweden,Ireland,1,1,European Championship,in France,0,0,1765,1759,0,0,27,29,1765,1759,draw
6260,June 13,2016,Belgium,Italy,0,2,European Championship,in France,-43,43,1880,1919,-4,4,15,11,1923,1876,T1
6261,June 13,2016,Zimbabwe,Madagascar,0,0,COSAFA Cup,in Namibia,-8,8,1397,1256,-1,3,111,145,1405,1248,draw
6262,June 13,2016,Mexico,Venezuela,1,1,Copa América,in the United States,-18,18,1968,1694,-3,3,7,42,1986,1676,draw
6263,June 13,2016,Czechia,Spain,0,1,European Championship,in France,-10,10,1745,2003,-2,0,32,3,1755,1993,T1
6264,June 13,2016,Swaziland,Seychelles,4,0,COSAFA Cup,in Namibia,10,-10,1308,967,2,0,129,189,1298,977,T1
6265,June 13,2016,Uruguay,Jamaica,3,0,Copa América,in the United States,12,-12,1895,1555,1,-4,13,72,1883,1567,T1
6266,June 14,2016,Argentina,Bolivia,3,0,Copa América,in the United States,5,-5,2084,1574,0,-2,1,64,2079,1579,T1
6267,June 14,2016,Chile,Panama,4,2,Copa América,in the United States,15,-15,1942,1672,0,-2,9,46,1927,1687,T1
6268,June 14,2016,Austria,Hungary,0,2,European Championship,in France,-46,46,1732,1742,-11,7,36,34,1778,1696,T1
6269,June 14,2016,Iceland,Portugal,1,1,European Championship,in France,15,-15,1681,1895,2,0,44,12,1666,1910,draw
6270,June 14,2016,Lesotho,Angola,2,0,COSAFA Cup,in Namibia,43,-43,1186,1266,6,-13,166,141,1143,1309,T1
6271,June 14,2016,Mauritius,Malawi,0,1,COSAFA Cup,in Namibia,-7,7,1057,1348,-1,1,186,118,1064,1341,T1
6272,June 15,2016,France,Albania,2,0,European Championship,in France,4,-4,1986,1598,0,-1,4,58,1982,1602,T1
6273,June 15,2016,Romania,Switzerland,1,1,European Championship,in France,2,-2,1755,1785,0,-1,29,23,1753,1787,draw
6274,June 15,2016,Russia,Slovakia,1,2,European Championship,in France,-28,28,1746,1761,-6,9,31,26,1774,1733,T1
6275,June 15,2016,Madagascar,Swaziland,0,1,COSAFA Cup,in Namibia,-17,17,1239,1325,-4,2,149,126,1256,1308,T1
6276,June 15,2016,Zimbabwe,Seychelles,5,0,COSAFA Cup,in Namibia,6,-6,1403,961,1,-1,110,190,1397,967,T1
6277,June 16,2016,Wales,England,1,2,European Championship,in France,-9,9,1679,1967,-2,0,45,8,1688,1958,T1
6278,June 16,2016,Germany,Poland,0,0,European Championship,in France,-16,16,2037,1797,0,3,2,21,2053,1781,draw
6279,June 16,2016,Lesotho,Malawi,1,0,COSAFA Cup,in Namibia,29,-29,1215,1319,7,-8,159,126,1186,1348,T1
6280,June 16,2016,Angola,Mauritius,0,2,COSAFA Cup,in Namibia,-46,46,1220,1103,-15,4,156,182,1266,1057,T1
6281,June 16,2016,Northern Ireland,Ukraine,2,0,European Championship,in France,58,-58,1667,1760,9,-9,47,27,1609,1818,T1
6282,June 16,2016,United States,Ecuador,2,1,Copa América,in the United States,25,-25,1812,1860,4,-1,18,15,1787,1885,T1
6283,June 17,2016,Colombia,Peru,0,0,Copa América,in the United States,-10,10,1964,1840,-2,1,8,16,1974,1830,draw
6284,June 17,2016,Czechia,Croatia,2,2,European Championship,in France,7,-7,1752,1837,2,-1,30,17,1745,1844,draw
6285,June 17,2016,Italy,Sweden,1,0,European Championship,in France,15,-15,1934,1750,1,-7,10,31,1919,1765,T1
6286,June 17,2016,Malaysia,Papua New Guinea,0,2,Friendly,in Papua New Guinea,-10,10,1105,1139,-3,1,180,173,1115,1129,T1
6287,June 17,2016,Turkey,Spain,0,3,European Championship,in France,-21,21,1782,2024,-4,0,23,3,1803,2003,T1
6288,June 18,2016,Venezuela,Argentina,1,4,Copa América,in the United States,-8,8,1686,2092,0,0,42,1,1694,2084,T1
6289,June 18,2016,Austria,Portugal,0,0,European Championship,in France,11,-11,1743,1884,3,-2,33,14,1732,1895,draw
6290,June 18,2016,Ireland,Belgium,0,3,European Championship,in France,-29,29,1730,1909,-9,3,36,11,1759,1880,T1
6291,June 18,2016,Mexico,Chile,0,7,Copa América,in the United States,-60,60,1908,2002,-6,5,12,4,1968,1942,T1
6292,June 18,2016,Iceland,Hungary,1,1,European Championship,in France,4,-4,1685,1738,0,0,43,35,1681,1742,draw
6293,June 18,2016,South Africa,Lesotho,1,1,COSAFA Cup,in Namibia,-16,16,1585,1231,-2,5,59,154,1601,1215,draw
6294,June 18,2016,Namibia,Botswana,1,1,COSAFA Cup,in Namibia,-8,8,1332,1299,-2,2,121,131,1340,1291,draw
6295,June 19,2016,Albania,Romania,1,0,European Championship,in France,36,-36,1634,1719,4,-12,53,39,1598,1755,T1
6296,June 19,2016,Mozambique,Democratic Republic of Congo,0,1,COSAFA Cup,in Namibia,-9,9,1351,1582,-2,4,117,61,1360,1573,T1
6297,June 19,2016,Switzerland,France,0,0,European Championship,in France,17,-17,1802,1969,3,-1,19,6,1785,1986,draw
6298,June 19,2016,French Guiana,Bermuda,3,0,CONCACAF Champ &amp; Carib Champ qual,in French Guiana,23,-23,1278,1206,4,-7,141,162,1255,1229,T1
6299,June 19,2016,Swaziland,Zambia,0,0,COSAFA Cup,in Namibia,8,-8,1333,1459,4,-2,121,96,1325,1467,draw
6300,June 20,2016,Slovakia,England,0,0,European Championship,in France,13,-13,1774,1954,0,-1,24,8,1761,1967,draw
6301,June 20,2016,Russia,Wales,0,3,European Championship,in France,-52,52,1694,1731,-12,11,42,34,1746,1679,T1
6302,June 21,2016,Croatia,Spain,2,1,European Championship,in France,37,-37,1874,1987,2,-1,15,4,1837,2024,T1
6303,June 21,2016,Germany,Northern Ireland,1,0,European Championship,in France,5,-5,2042,1662,0,0,2,47,2037,1667,T1
6304,June 21,2016,Mozambique,Namibia,0,3,COSAFA Cup,in Namibia,-27,27,1324,1359,-8,7,125,115,1351,1332,T1
6305,June 21,2016,Poland,Ukraine,1,0,European Championship,in France,22,-22,1819,1738,3,-5,18,31,1797,1760,T1
6306,June 21,2016,Czechia,Turkey,0,2,European Championship,in France,-34,34,1718,1816,-11,4,39,19,1752,1782,T1
6307,June 21,2016,Argentina,United States,4,0,Copa América,in the United States,25,-25,2117,1787,0,-5,1,23,2092,1812,T2
6308,June 21,2016,Zambia,Lesotho,3,2,COSAFA Cup,in Namibia,8,-8,1467,1223,2,0,94,154,1459,1231,T1
6309,June 22,2016,Sweden,Belgium,0,1,European Championship,in France,-14,14,1736,1923,-5,1,32,10,1750,1909,T1
6310,June 22,2016,Botswana,Democratic Republic of Congo,0,0,COSAFA Cup,in Namibia,13,-13,1312,1569,4,-6,127,67,1299,1582,draw
6311,June 22,2016,Colombia,Chile,0,2,Copa América,in the United States,-33,33,1931,2035,-1,0,8,3,1964,2002,T1
6312,June 22,2016,Portugal,Hungary,3,3,European Championship,in France,-10,10,1874,1748,0,3,14,28,1884,1738,draw
6313,June 22,2016,Iceland,Austria,2,1,European Championship,in France,29,-29,1714,1714,5,-10,39,39,1685,1743,T1
6314,June 22,2016,Ireland,Italy,1,0,European Championship,in France,38,-38,1768,1896,9,-3,25,12,1730,1934,T1
6315,June 22,2016,New Caledonia,Malaysia,1,2,Friendly,in New Caledonia,-17,17,1301,1122,-4,4,131,176,1318,1105,T2
6316,June 22,2016,South Africa,Swaziland,5,1,COSAFA Cup,in Namibia,14,-14,1599,1319,1,-4,58,125,1585,1333,T1
6317,June 24,2016,Namibia,Zambia,1,0,COSAFA Cup,in Namibia,20,-20,1379,1447,1,-5,114,99,1359,1467,T1
6318,June 25,2016,Switzerland,Poland,1,1,European Championship,in France,1,-1,1803,1818,0,0,20,18,1802,1819,draw
6319,June 25,2016,Croatia,Portugal,0,1,European Championship,in France,-25,25,1849,1899,-2,2,16,12,1874,1874,T1
6320,June 25,2016,Botswana,South Africa,2,3,COSAFA Cup,in Namibia,-6,6,1306,1605,-1,0,128,58,1312,1599,T1
6321,June 25,2016,Swaziland,Democratic Republic of Congo,1,0,COSAFA Cup,in Namibia,32,-32,1351,1537,7,-6,118,73,1319,1569,T1
6322,June 25,2016,Colombia,United States,1,0,Copa América,in the United States,22,-22,1953,1765,0,-2,8,25,1931,1787,T2
6323,June 25,2016,Wales,Northern Ireland,1,0,European Championship,in France,20,-20,1751,1642,5,-4,28,51,1731,1662,T1
6324,June 26,2016,Chile,Argentina,0,0,Copa América,in the United States,6,-6,2041,2111,0,0,3,1,2035,2117,draw
6325,June 26,2016,Belgium,Hungary,4,0,European Championship,in France,25,-25,1948,1723,1,-7,9,36,1923,1748,T1
6326,June 26,2016,Malaysia,Fiji,1,1,Friendly,in Fiji,6,-6,1128,1239,1,0,175,147,1122,1245,draw
6327,June 26,2016,Ireland,France,1,2,European Championship,in France,-8,8,1760,1977,-1,0,25,6,1768,1969,T1
6328,June 26,2016,Germany,Slovakia,3,0,European Championship,in France,15,-15,2057,1759,0,-3,2,26,2042,1774,T1
6329,June 27,2016,Iceland,England,2,1,European Championship,in France,40,-40,1754,1914,12,-4,27,11,1714,1954,T1
6330,June 27,2016,Spain,Italy,0,2,European Championship,in France,-47,47,1940,1943,-5,5,9,8,1987,1896,T1
6331,June 30,2016,Mongolia,Macao,2,2,East Asian Cup qualifier,in Guam,-3,3,670,625,0,0,224,227,673,622,draw
6332,June 30,2016,Poland,Portugal,1,1,European Championship,in France,6,-6,1824,1893,0,-1,18,14,1818,1899,draw
6333,June 30,2016,Taiwan,Northern Mariana Islands,8,1,East Asian Cup qualifier,in Guam,14,-14,770,448,2,0,210,237,756,462,T1
6334,July 1,2016,Wales,Belgium,3,1,European Championship,in France,57,-57,1808,1891,9,-7,20,14,1751,1948,T1
6335,July 2,2016,Italy,Germany,1,1,European Championship,in France,8,-8,1951,2049,0,0,7,2,1943,2057,draw
6336,July 2,2016,Macao,Northern Mariana Islands,3,1,East Asian Cup qualifier,in Guam,16,-16,641,432,2,0,225,237,625,448,T1
6337,July 2,2016,Taiwan,Mongolia,2,0,East Asian Cup qualifier,in Guam,22,-22,792,648,1,0,209,224,770,670,T1
6338,July 3,2016,Iceland,France,2,5,European Championship,in France,-12,12,1742,1989,-3,1,31,4,1754,1977,T1
6339,July 4,2016,Mongolia,Northern Mariana Islands,8,0,East Asian Cup qualifier,in Guam,21,-21,669,411,0,0,224,237,648,432,T1
6340,July 4,2016,Taiwan,Macao,3,2,East Asian Cup qualifier,in Guam,12,-12,804,629,1,-2,208,227,792,641,T1
6341,July 6,2016,Portugal,Wales,2,0,European Championship,in France,29,-29,1922,1779,3,-3,10,23,1893,1808,T1
6342,July 7,2016,France,Germany,2,0,European Championship,in France,33,-33,2022,2016,1,-2,3,4,1989,2049,T1
6343,July 10,2016,France,Portugal,0,1,European Championship,in France,-38,38,1984,1960,-1,4,4,6,2022,1922,T2
6344,July 24,2016,Uzbekistan,Iraq,2,1,Friendly,in Uzbekistan,4,-4,1651,1495,0,0,49,85,1647,1499,T1
6345,July 28,2016,Cambodia,Singapore,2,1,Friendly,in Cambodia,17,-17,783,1139,0,-2,211,172,766,1156,T1
6346,August 8,2016,Turkmenistan,Oman,0,1,Friendly,in Oman,-3,3,1284,1473,-2,0,139,92,1287,1470,T1
6347,August 8,2016,Qatar,Iraq,2,1,Friendly,in Qatar,6,-6,1529,1489,3,-1,75,86,1523,1495,T1
6348,August 10,2016,Panama,Guatemala,0,0,Friendly,in Panama,-7,7,1665,1497,0,0,46,85,1672,1490,draw
6349,August 13,2016,Bhutan,India,0,3,Friendly,in Bhutan,-3,3,547,1089,0,1,234,183,550,1086,T2
6350,August 16,2016,North Korea,Iraq,1,0,Friendly,in Malaysia,10,-10,1513,1479,2,-3,82,89,1503,1489,T1
6351,August 18,2016,Jordan,Qatar,2,3,Friendly,in Switzerland,-10,10,1519,1539,-5,2,80,73,1529,1529,T1
6352,August 21,2016,North Korea,Iraq,1,1,Friendly,in Malaysia,-1,1,1512,1480,0,1,82,88,1513,1479,draw
6353,August 24,2016,Burkina Faso,Uzbekistan,0,1,Friendly,in Uzbekistan,-3,3,1461,1654,0,1,94,48,1464,1651,T1
6354,August 24,2016,Laos,Saudi Arabia,0,4,Friendly,in Qatar,-1,1,791,1536,0,0,210,75,792,1535,T1
6355,August 24,2016,North Korea,United Arab Emirates,2,0,Friendly,in China,18,-18,1530,1564,6,-6,76,67,1512,1582,T1
6356,August 24,2016,Nicaragua,Honduras,0,1,Friendly,in Honduras,-2,2,1260,1527,0,-1,144,77,1262,1525,T1
6357,August 25,2016,Qatar,Thailand,3,0,Friendly,in Qatar,8,-8,1547,1427,1,-1,72,102,1539,1435,T1
6358,August 27,2016,Syria,Tajikistan,0,0,Friendly,in Tajikistan,-5,5,1509,1220,0,3,82,156,1514,1215,draw
6359,August 28,2016,Dominican Republic,Puerto Rico,5,0,Friendly,in the Dominican Republic,8,-8,1226,1081,5,-1,154,184,1218,1089,T1
6360,August 30,2016,Uganda,Kenya,0,0,Friendly,in Uganda,-6,6,1498,1350,0,0,84,119,1504,1344,draw
6361,August 30,2016,Kyrgyzstan,Kazakhstan,2,0,Friendly,in Kyrgyzstan,20,-20,1228,1401,5,-4,155,110,1208,1421,T1
6362,August 30,2016,Guinea,Egypt,1,1,Friendly,in Egypt,6,-6,1531,1647,2,0,76,49,1525,1653,draw
6363,August 30,2016,Puerto Rico,Dominican Republic,0,1,Friendly,in Puerto Rico,-9,9,1072,1235,-1,4,185,150,1081,1226,T2
6364,August 31,2016,Russia,Turkey,0,0,Friendly,in Turkey,6,-6,1700,1810,0,0,43,19,1694,1816,draw
6365,August 31,2016,Norway,Belarus,0,1,Friendly,in Norway,-14,14,1623,1600,-2,0,54,59,1637,1586,T2
6366,August 31,2016,Jordan,Lebanon,1,1,Friendly,in Lebanon,-1,1,1518,1373,1,0,80,115,1519,1372,draw
6367,August 31,2016,Ireland,Oman,4,0,Friendly,in Ireland,4,-4,1764,1469,1,0,25,92,1760,1473,T1
6368,August 31,2016,Germany,Finland,2,0,Friendly,in Germany,1,-1,2017,1575,0,-1,3,62,2016,1576,T1
6369,August 31,2016,Estonia,Malta,1,1,Friendly,in Estonia,-7,7,1461,1239,0,6,93,147,1468,1232,draw
6370,August 31,2016,Denmark,Liechtenstein,5,0,Friendly,in Denmark,1,-1,1746,1192,0,0,29,165,1745,1193,T1
6371,August 31,2016,Armenia,Czechia,0,3,Friendly,in Czechia,-5,5,1518,1723,-1,2,80,37,1523,1718,T1
6372,August 31,2016,Morocco,Albania,0,0,Friendly,in Albania,4,-4,1580,1630,0,1,61,52,1576,1634,draw
6373,August 31,2016,Saint Kitts and Nevis,Nicaragua,0,0,Friendly,in Nicaragua,2,-2,1304,1258,1,0,129,144,1302,1260,draw
6374,September 1,2016,Gibraltar,Portugal,0,5,Friendly,in Portugal,0,0,1111,1960,0,0,179,6,1111,1960,T1
6375,September 1,2016,Greece,Netherlands,2,1,Friendly,in the Netherlands,18,-18,1635,1907,4,-2,52,12,1617,1925,T2
6376,September 1,2016,Maldives,Bangladesh,5,0,Friendly,in the Maldives,12,-12,943,868,0,-1,197,205,931,880,T1
6377,September 1,2016,Italy,France,1,3,Friendly,in Italy,-18,18,1933,2002,-1,-1,9,5,1951,1984,T2
6378,September 1,2016,Hong Kong,Cambodia,4,2,Friendly,in Hong Kong,2,-2,1185,781,0,0,168,211,1183,783,T1
6379,September 1,2016,Belgium,Spain,0,2,Friendly,in Belgium,-17,17,1874,1957,0,1,14,8,1891,1940,T2
6380,September 1,2016,Bahrain,Singapore,3,1,Friendly,in Bahrain,3,-3,1425,1136,3,-1,102,173,1422,1139,T1
6381,September 1,2016,Uzbekistan,Syria,1,0,World Cup qualifier,in Uzbekistan,8,-8,1662,1501,1,-1,47,83,1654,1509,T1
6382,September 1,2016,China,South Korea,2,3,World Cup qualifier,in South Korea,-5,5,1560,1803,-2,2,68,19,1565,1798,T1
6383,September 1,2016,Saudi Arabia,Thailand,1,0,World Cup qualifier,in Saudi Arabia,9,-9,1545,1418,3,-4,72,106,1536,1427,T1
6384,September 1,2016,Japan,United Arab Emirates,1,2,World Cup qualifier,in Japan,-34,34,1719,1598,-10,6,38,61,1753,1564,T2
6385,September 1,2016,Qatar,Iran,0,2,World Cup qualifier,in Iran,-9,9,1538,1752,-2,1,74,29,1547,1743,T1
6386,September 1,2016,Australia,Iraq,2,0,World Cup qualifier,in Australia,8,-8,1712,1472,1,-3,41,91,1704,1480,T1
6387,September 1,2016,Paraguay,Chile,2,1,World Cup qualifier,in Paraguay,31,-31,1756,2010,8,-2,28,4,1725,2041,T1
6388,September 1,2016,Ecuador,Brazil,0,3,World Cup qualifier,in Ecuador,-33,33,1827,2011,-1,2,16,3,1860,1978,T2
6389,September 1,2016,Colombia,Venezuela,2,0,World Cup qualifier,in Colombia,6,-6,1959,1680,0,-1,7,45,1953,1686,T1
6390,September 1,2016,Bolivia,Peru,2,0,World Cup qualifier,in Bolivia,43,-43,1617,1797,6,-4,57,21,1574,1840,T1
6391,September 1,2016,Argentina,Uruguay,1,0,World Cup qualifier,in Argentina,6,-6,2117,1889,0,0,1,13,2111,1895,T1
6392,September 2,2016,Sudan,Gabon,1,2,Friendly,in Sudan,-8,8,1285,1456,-4,1,137,97,1293,1448,T2
6393,September 2,2016,Luxembourg,Latvia,1,3,Friendly,in Latvia,-4,4,1235,1484,-3,1,150,87,1239,1480,T1
6394,September 2,2016,Mauritania,South Africa,1,1,African Nations Cup qualifier,in South Africa,17,-17,1306,1588,7,-2,128,61,1289,1605,draw
6395,September 2,2016,Guatemala,Trinidad and Tobago,2,2,World Cup qualifier,in Trinidad and Tobago,9,-9,1506,1561,3,-1,82,66,1497,1570,draw
6396,September 2,2016,Saint Vincent and the Grenadines,United States,0,6,World Cup qualifier,in Saint Vincent and the Grenadines,-3,3,1111,1768,0,0,178,24,1114,1765,T2
6397,September 2,2016,Panama,Jamaica,2,0,World Cup qualifier,in Panama,14,-14,1679,1541,0,-2,46,73,1665,1555,T1
6398,September 2,2016,Canada,Honduras,1,2,World Cup qualifier,in Honduras,-14,14,1508,1541,-2,5,81,73,1522,1527,T1
6399,September 2,2016,Costa Rica,Haiti,1,0,World Cup qualifier,in Haiti,9,-9,1797,1469,1,-2,21,91,1788,1478,T2
6400,September 2,2016,El Salvador,Mexico,1,3,World Cup qualifier,in El Salvador,-6,6,1417,1914,-2,1,106,10,1423,1908,T2
6401,September 3,2016,India,Puerto Rico,4,1,Friendly,in India,12,-12,1101,1060,1,-1,182,186,1089,1072,T1
6402,September 3,2016,Senegal,Namibia,2,0,African Nations Cup qualifier,in Senegal,5,-5,1686,1374,0,0,44,114,1681,1379,T1
6403,September 3,2016,Nigeria,Tanzania,1,0,African Nations Cup qualifier,in Nigeria,4,-4,1629,1327,1,-3,53,125,1625,1331,T1
6404,September 3,2016,Mauritius,Mozambique,0,1,African Nations Cup qualifier,in Mozambique,-5,5,1098,1329,-1,1,183,124,1103,1324,T1
6405,September 3,2016,Sierra Leone,Ivory Coast,1,1,African Nations Cup qualifier,in Ivory Coast,18,-18,1372,1711,0,-7,116,41,1354,1729,draw
6406,September 3,2016,Rwanda,Ghana,1,1,African Nations Cup qualifier,in Ghana,17,-17,1308,1626,6,-4,128,54,1291,1643,draw
6407,September 3,2016,Ethiopia,Seychelles,2,1,African Nations Cup qualifier,in Ethiopia,3,-3,1301,958,0,-1,133,191,1298,961,T1
6408,September 3,2016,Cape Verde,Libya,0,1,African Nations Cup qualifier,in Cape Verde,-27,27,1479,1508,-6,7,88,81,1506,1481,T2
6409,September 3,2016,Cameroon,Gambia,2,0,African Nations Cup qualifier,in Cameroon,5,-5,1623,1280,1,-2,55,139,1618,1285,T1
6410,September 3,2016,Angola,Madagascar,1,1,African Nations Cup qualifier,in Angola,-5,5,1215,1244,-2,0,160,147,1220,1239,draw
6411,September 4,2016,Jordan,Bahrain,0,0,Friendly,in Bahrain,0,0,1518,1425,0,0,79,102,1518,1425,draw
6412,September 4,2016,Kenya,Zambia,1,1,African Nations Cup qualifier,in Zambia,10,-10,1360,1437,2,-1,117,100,1350,1447,draw
6413,September 4,2016,Uganda,Comoros,1,0,African Nations Cup qualifier,in Uganda,1,-1,1499,963,0,0,85,189,1498,964,T1
6414,September 4,2016,Tunisia,Liberia,4,1,African Nations Cup qualifier,in Tunisia,9,-9,1566,1322,2,-3,68,125,1557,1331,T1
6415,September 4,2016,Djibouti,Togo,0,5,African Nations Cup qualifier,in Togo,-1,1,752,1413,0,-1,214,108,753,1412,T1
6416,September 4,2016,Niger,Burundi,3,1,African Nations Cup qualifier,in Niger,28,-28,1293,1311,7,-7,135,127,1265,1339,T1
6417,September 4,2016,Morocco,São Tomé and Príncipe,2,0,African Nations Cup qualifier,in Morocco,2,-2,1582,1107,0,0,63,180,1580,1109,T1
6418,September 4,2016,Mali,Benin,5,2,African Nations Cup qualifier,in Mali,13,-13,1574,1396,1,-2,65,110,1561,1409,T1
6419,September 4,2016,Malawi,Swaziland,1,0,African Nations Cup qualifier,in Malawi,16,-16,1335,1335,5,-3,121,121,1319,1351,T1
6420,September 4,2016,Zimbabwe,Guinea,0,1,African Nations Cup qualifier,in Guinea,-8,8,1395,1539,-2,1,111,76,1403,1531,T1
6421,September 4,2016,Equatorial Guinea,South Sudan,4,0,African Nations Cup qualifier,in Equatorial Guinea,11,-11,1342,1114,3,-1,119,177,1331,1125,T1
6422,September 4,2016,Democratic Republic of Congo,Central African Republic,4,1,African Nations Cup qualifier,in the Democratic Republic of the Congo,9,-9,1546,1295,5,-3,71,134,1537,1304,T1
6423,September 4,2016,Guinea-Bissau,Congo,0,1,African Nations Cup qualifier,in Congo,-7,7,1280,1466,-3,2,139,94,1287,1459,T1
6424,September 4,2016,Burkina Faso,Botswana,2,1,African Nations Cup qualifier,in Burkina Faso,7,-7,1468,1299,0,-4,93,133,1461,1306,T1
6425,September 4,2016,Algeria,Lesotho,6,0,African Nations Cup qualifier,in Algeria,4,-4,1663,1219,1,-2,47,158,1659,1223,T1
6426,September 4,2016,Slovakia,England,0,1,World Cup qualifier,in Slovakia,-17,17,1742,1931,-3,0,30,10,1759,1914,T2
6427,September 4,2016,San Marino,Azerbaijan,0,1,World Cup qualifier,in San Marino,-4,4,880,1393,0,0,203,112,884,1389,T2
6428,September 4,2016,Montenegro,Romania,1,1,World Cup qualifier,in Romania,13,-13,1572,1706,3,-5,66,42,1559,1719,draw
6429,September 4,2016,Germany,Norway,3,0,World Cup qualifier,in Norway,11,-11,2028,1612,0,-2,2,57,2017,1623,T2
6430,September 4,2016,Scotland,Malta,5,1,World Cup qualifier,in Malta,8,-8,1719,1231,5,-6,36,154,1711,1239,T2
6431,September 4,2016,Slovenia,Lithuania,2,2,World Cup qualifier,in Lithuania,-4,4,1609,1448,0,1,58,99,1613,1444,draw
6432,September 4,2016,Kazakhstan,Poland,2,2,World Cup qualifier,in Kazakhstan,15,-15,1416,1809,3,-1,107,18,1401,1824,draw
6433,September 4,2016,Armenia,Denmark,0,1,World Cup qualifier,in Denmark,-5,5,1513,1751,-1,1,80,29,1518,1746,T1
6434,September 4,2016,Northern Ireland,Czechia,0,0,World Cup qualifier,in Czechia,10,-10,1652,1713,1,-4,49,39,1642,1723,draw
6435,September 5,2016,Lebanon,Afghanistan,2,0,Friendly,in Lebanon,4,-4,1377,1143,1,-1,114,171,1373,1147,T1
6436,September 5,2016,Moldova,Wales,0,4,World Cup qualifier,in Wales,-3,3,1350,1782,0,0,118,23,1353,1779,T1
6437,September 5,2016,Ukraine,Iceland,1,1,World Cup qualifier,in Ukraine,-5,5,1733,1747,-1,0,33,30,1738,1742,draw
6438,September 5,2016,Spain,Liechtenstein,8,0,World Cup qualifier,in Spain,1,-1,1958,1191,0,0,8,165,1957,1192,T1
6439,September 5,2016,Serbia,Ireland,2,2,World Cup qualifier,in Serbia,-4,4,1722,1768,-2,1,36,24,1726,1764,draw
6440,September 5,2016,Israel,Italy,1,3,World Cup qualifier,in Israel,-11,11,1559,1944,-3,0,70,9,1570,1933,T2
6441,September 5,2016,Georgia,Austria,1,2,World Cup qualifier,in Georgia,-13,13,1475,1727,-2,4,88,34,1488,1714,T2
6442,September 5,2016,Kosovo,Finland,1,1,World Cup qualifier,in Finland,13,-13,1413,1562,1,-3,108,67,1400,1575,draw
6443,September 5,2016,Turkey,Croatia,1,1,World Cup qualifier,in Croatia,8,-8,1818,1841,0,0,17,15,1810,1849,draw
6444,September 6,2016,South Africa,Egypt,1,0,Friendly,in South Africa,9,-9,1597,1638,1,0,60,50,1588,1647,T1
6445,September 6,2016,Russia,Ghana,1,0,Friendly,in Russia,5,-5,1705,1621,0,-2,43,56,1700,1626,T1
6446,September 6,2016,Tajikistan,Palestine,1,1,Friendly,in Palestine,6,-6,1226,1332,2,-2,155,122,1220,1338,draw
6447,September 6,2016,Kyrgyzstan,Philippines,1,2,Friendly,in Kyrgyzstan,-12,12,1216,1275,-5,0,160,143,1228,1263,T2
6448,September 6,2016,Indonesia,Malaysia,3,0,Friendly,in Indonesia,9,-9,1217,1119,2,-1,159,176,1208,1128,T1
6449,September 6,2016,Gabon,Cameroon,1,2,Friendly,in Cameroon,-4,4,1452,1627,-1,0,98,55,1456,1623,T1
6450,September 6,2016,Laos,Maldives,0,4,Asian Cup qualifier,in the Maldives,-14,14,777,957,-1,4,211,193,791,943,T1
6451,September 6,2016,Bangladesh,Bhutan,0,0,Asian Cup qualifier,in Bangladesh,-17,17,851,564,-1,3,206,231,868,547,draw
6452,September 6,2016,Australia,United Arab Emirates,1,0,World Cup qualifier,in the United Arab Emirates,19,-19,1731,1579,5,-3,35,63,1712,1598,T2
6453,September 6,2016,Thailand,Japan,0,2,World Cup qualifier,in Thailand,-14,14,1404,1733,-3,4,108,33,1418,1719,T2
6454,September 6,2016,South Korea,Syria,0,0,World Cup qualifier,in Malaysia,-14,14,1789,1515,-3,4,22,80,1803,1501,draw
6455,September 6,2016,Uzbekistan,Qatar,1,0,World Cup qualifier,in Qatar,19,-19,1681,1519,2,-1,46,78,1662,1538,T2
6456,September 6,2016,Iraq,Saudi Arabia,1,2,World Cup qualifier,in Malaysia,-16,16,1456,1561,-5,3,95,69,1472,1545,T2
6457,September 6,2016,Iran,China,0,0,World Cup qualifier,in China,-5,5,1747,1565,0,2,28,67,1752,1560,draw
6458,September 6,2016,Switzerland,Portugal,2,0,World Cup qualifier,in Switzerland,35,-35,1838,1925,3,-4,16,10,1803,1960,T1
6459,September 6,2016,Sweden,Netherlands,1,1,World Cup qualifier,in Sweden,4,-4,1740,1903,1,0,31,12,1736,1907,draw
6460,September 6,2016,Gibraltar,Greece,1,4,World Cup qualifier,in Portugal,-3,3,1108,1638,0,1,178,50,1111,1635,T2
6461,September 6,2016,Hungary,Faroe Islands,0,0,World Cup qualifier,in the Faroe Islands,-16,16,1707,1249,-6,5,41,147,1723,1233,draw
6462,September 6,2016,Belgium,Cyprus,3,0,World Cup qualifier,in Cyprus,8,-8,1882,1413,0,-1,14,105,1874,1421,T2
6463,September 6,2016,Luxembourg,Bulgaria,3,4,World Cup qualifier,in Bulgaria,-3,3,1232,1588,-3,1,152,61,1235,1585,T1
6464,September 6,2016,Estonia,Bosnia and Herzegovina,0,5,World Cup qualifier,in Bosnia and Herzegovina,-7,7,1454,1768,-2,1,97,25,1461,1761,T1
6465,September 6,2016,Belarus,France,0,0,World Cup qualifier,in Belarus,14,-14,1614,1988,2,0,57,5,1600,2002,draw
6466,September 6,2016,Latvia,Andorra,1,0,World Cup qualifier,in Andorra,3,-3,1487,958,-1,0,87,190,1484,961,T2
6467,September 6,2016,Albania,Macedonia,2,1,World Cup qualifier,in Albania,6,-6,1636,1425,0,0,52,101,1630,1431,T1
6468,September 6,2016,Trinidad and Tobago,United States,0,4,World Cup qualifier,in the United States,-11,11,1550,1779,-4,0,72,24,1561,1768,T1
6469,September 6,2016,Mexico,Honduras,0,0,World Cup qualifier,in Mexico,-18,18,1896,1559,-2,4,13,70,1914,1541,draw
6470,September 6,2016,Jamaica,Haiti,0,2,World Cup qualifier,in Jamaica,-44,44,1497,1513,-12,10,86,81,1541,1469,T2
6471,September 6,2016,Saint Vincent and the Grenadines,Guatemala,3,9,World Cup qualifier,in Guatemala,-5,5,1106,1511,-2,0,180,83,1111,1506,T1
6472,September 6,2016,Costa Rica,Panama,3,1,World Cup qualifier,in Costa Rica,13,-13,1810,1666,1,-1,20,47,1797,1679,T1
6473,September 6,2016,Canada,El Salvador,3,1,World Cup qualifier,in Canada,15,-15,1523,1402,4,-3,77,109,1508,1417,T1
6474,September 6,2016,Argentina,Venezuela,2,2,World Cup qualifier,in Venezuela,-15,15,2102,1695,0,1,1,44,2117,1680,draw
6475,September 6,2016,Uruguay,Paraguay,4,0,World Cup qualifier,in Uruguay,16,-16,1905,1740,2,-4,11,31,1889,1756,T1
6476,September 6,2016,Peru,Ecuador,2,1,World Cup qualifier,in Peru,16,-16,1813,1811,3,-3,18,19,1797,1827,T1
6477,September 6,2016,Bolivia,Chile,0,0,World Cup qualifier,in Chile,18,-18,1635,1992,3,0,53,4,1617,2010,draw
6478,September 6,2016,Colombia,Brazil,1,2,World Cup qualifier,in Brazil,-12,12,1947,2023,0,0,7,3,1959,2011,T1
6479,September 29,2016,Qatar,Serbia,3,0,Friendly,in Qatar,23,-23,1542,1699,3,-6,75,43,1519,1722,T1
6480,September 30,2016,Angola,Botswana,1,1,Friendly,in Botswana,5,-5,1220,1294,4,-1,157,134,1215,1299,draw
6481,October 4,2016,Togo,Uganda,1,0,Friendly,in Togo,10,-10,1423,1489,1,-1,104,86,1413,1499,T1
6482,October 4,2016,Democratic Republic of Congo,Kenya,0,1,Friendly,in the Democratic Republic of the Congo,-17,17,1529,1377,-4,3,77,114,1546,1360,T2
6483,October 5,2016,Tajikistan,Palestine,3,3,Friendly,in Tajikistan,0,0,1226,1332,1,0,154,122,1226,1332,draw
6484,October 5,2016,New Caledonia,Solomon Islands,3,0,Friendly,in the Solomon Islands,15,-15,1316,1129,5,-4,126,174,1301,1144,T2
6485,October 5,2016,Dominican Republic,Trinidad and Tobago,0,4,CONCACAF Champ &amp; Carib Champ qual,in Trinidad and Tobago,-6,6,1229,1556,-3,0,153,72,1235,1550,T1
6486,October 5,2016,Antigua and Barbuda,Curaçao,0,3,CONCACAF Champ &amp; Carib Champ qual,in Curaçao,-32,32,1200,1195,-12,4,164,165,1232,1163,T1
6487,October 6,2016,North Korea,Vietnam,2,5,Friendly,in Vietnam,-26,26,1504,1279,-8,4,84,142,1530,1253,T1
6488,October 6,2016,Lebanon,Kyrgyzstan,0,0,Friendly,in Kyrgyzstan,-2,2,1375,1218,-1,1,115,159,1377,1216,draw
6489,October 6,2016,Mauritania,Canada,0,4,Friendly,in Morocco,-8,8,1298,1531,-2,1,132,77,1306,1523,T1
6490,October 6,2016,Hong Kong,Cambodia,2,0,Friendly,in Cambodia,4,-4,1189,777,2,0,167,210,1185,781,T2
6491,October 6,2016,Uzbekistan,Iran,0,1,World Cup qualifier,in Uzbekistan,-22,22,1659,1769,-2,2,48,26,1681,1747,T2
6492,October 6,2016,Thailand,United Arab Emirates,1,3,World Cup qualifier,in the United Arab Emirates,-10,10,1394,1589,-3,2,111,61,1404,1579,T1
6493,October 6,2016,South Korea,Qatar,3,2,World Cup qualifier,in South Korea,5,-5,1794,1537,0,-1,22,75,1789,1542,T1
6494,October 6,2016,Australia,Saudi Arabia,2,2,World Cup qualifier,in Saudi Arabia,-4,4,1727,1565,1,1,34,68,1731,1561,draw
6495,October 6,2016,Japan,Iraq,2,1,World Cup qualifier,in Japan,4,-4,1737,1452,0,-2,33,97,1733,1456,T1
6496,October 6,2016,China,Syria,0,1,World Cup qualifier,in China,-28,28,1537,1543,-8,8,75,72,1565,1515,T2
6497,October 6,2016,Turkey,Ukraine,2,2,World Cup qualifier,in Turkey,-10,10,1808,1743,-4,3,21,30,1818,1733,draw
6498,October 6,2016,Moldova,Serbia,0,3,World Cup qualifier,in Moldova,-13,13,1337,1712,-1,4,119,39,1350,1699,T2
6499,October 6,2016,Macedonia,Israel,1,2,World Cup qualifier,in Macedonia,-18,18,1407,1577,-5,6,106,64,1425,1559,T2
6500,October 6,2016,Liechtenstein,Albania,0,2,World Cup qualifier,in Liechtenstein,-7,7,1184,1643,-3,2,169,50,1191,1636,T2
6501,October 6,2016,Spain,Italy,1,1,World Cup qualifier,in Italy,5,-5,1963,1939,1,0,5,8,1958,1944,draw
6502,October 6,2016,Georgia,Ireland,0,1,World Cup qualifier,in Ireland,-4,4,1471,1772,-1,0,90,25,1475,1768,T1
6503,October 6,2016,Finland,Iceland,2,3,World Cup qualifier,in Iceland,-6,6,1556,1753,-2,0,70,28,1562,1747,T1
6504,October 6,2016,Kosovo,Croatia,0,6,World Cup qualifier,in Albania,-7,7,1406,1848,-1,-1,107,16,1413,1841,T1
6505,October 6,2016,Wales,Austria,2,2,World Cup qualifier,in Austria,3,-3,1785,1724,0,0,23,36,1782,1727,draw
6506,October 6,2016,Venezuela,Uruguay,0,3,World Cup qualifier,in Uruguay,-10,10,1685,1915,-1,0,45,11,1695,1905,T1
6507,October 6,2016,Peru,Argentina,2,2,World Cup qualifier,in Peru,10,-10,1823,2092,0,0,18,1,1813,2102,draw
6508,October 6,2016,Paraguay,Colombia,0,1,World Cup qualifier,in Paraguay,-14,14,1726,1961,-4,1,35,6,1740,1947,T2
6509,October 6,2016,Chile,Ecuador,0,3,World Cup qualifier,in Ecuador,-43,43,1949,1854,-3,4,7,15,1992,1811,T1
6510,October 6,2016,Bolivia,Brazil,0,5,World Cup qualifier,in Brazil,-5,5,1630,2028,0,1,53,2,1635,2023,T1
6511,October 7,2016,Singapore,Malaysia,0,0,Friendly,in Singapore,-3,3,1133,1122,-1,1,173,175,1136,1119,draw
6512,October 7,2016,Bahrain,Philippines,3,1,Friendly,in the Philippines,13,-13,1438,1262,2,-1,99,145,1425,1275,T2
6513,October 7,2016,Oman,Jordan,1,1,Friendly,in Oman,-1,1,1468,1519,1,0,90,79,1469,1518,draw
6514,October 7,2016,United States,Cuba,2,0,Friendly,in Cuba,3,-3,1782,1309,0,-1,24,128,1779,1312,T2
6515,October 7,2016,Ghana,Uganda,0,0,World Cup qualifier,in Ghana,-12,12,1609,1501,-1,1,57,85,1621,1489,draw
6516,October 7,2016,Andorra,Portugal,0,6,World Cup qualifier,in Portugal,0,0,958,1925,0,0,190,10,958,1925,T1
6517,October 7,2016,Netherlands,Belarus,4,1,World Cup qualifier,in the Netherlands,7,-7,1910,1607,0,-2,12,59,1903,1614,T1
6518,October 7,2016,Luxembourg,Sweden,0,1,World Cup qualifier,in Luxembourg,-3,3,1229,1743,-1,2,152,30,1232,1740,T2
6519,October 7,2016,Switzerland,Hungary,3,2,World Cup qualifier,in Hungary,18,-18,1856,1689,2,-2,15,43,1838,1707,T2
6520,October 7,2016,Faroe Islands,Latvia,2,0,World Cup qualifier,in Latvia,52,-52,1301,1435,16,-14,131,101,1249,1487,T2
6521,October 7,2016,Greece,Cyprus,2,0,World Cup qualifier,in Greece,8,-8,1646,1405,1,-2,50,107,1638,1413,T1
6522,October 7,2016,Bulgaria,France,1,4,World Cup qualifier,in France,-4,4,1584,1992,0,0,62,4,1588,1988,T1
6523,October 7,2016,Estonia,Gibraltar,4,0,World Cup qualifier,in Estonia,5,-5,1459,1103,2,-3,94,181,1454,1108,T1
6524,October 7,2016,Bosnia and Herzegovina,Belgium,0,4,World Cup qualifier,in Belgium,-17,17,1751,1899,-1,1,28,13,1768,1882,T1
6525,October 8,2016,New Caledonia,Solomon Islands,1,0,Friendly,in the Solomon Islands,8,-8,1324,1121,1,-1,125,175,1316,1129,T2
6526,October 8,2016,New Zealand,Mexico,1,2,Friendly,in the United States,-2,2,1541,1898,-2,0,74,14,1543,1896,T1
6527,October 8,2016,Belize,Honduras,1,2,Friendly,in Belize,-3,3,1183,1562,-1,1,169,68,1186,1559,T2
6528,October 8,2016,East Timor,Taiwan,1,2,Asian Cup qualifier,in Taiwan,-10,10,698,814,-1,0,218,208,708,804,T1
6529,October 8,2016,Senegal,Cape Verde,2,0,World Cup qualifier,in Senegal,9,-9,1695,1470,1,-3,43,90,1686,1479,T1
6530,October 8,2016,Mali,Ivory Coast,1,3,World Cup qualifier,in Ivory Coast,-12,12,1562,1723,-3,3,68,37,1574,1711,T1
6531,October 8,2016,Morocco,Gabon,0,0,World Cup qualifier,in Gabon,-2,2,1580,1454,-1,-1,64,97,1582,1452,draw
6532,October 8,2016,Libya,Democratic Republic of Congo,0,4,World Cup qualifier,in the Democratic Republic of the Congo,-25,25,1483,1554,-2,6,85,72,1508,1529,T1
6533,October 8,2016,Burkina Faso,South Africa,1,1,World Cup qualifier,in Burkina Faso,2,-2,1470,1595,0,1,90,59,1468,1597,draw
6534,October 8,2016,Slovakia,Slovenia,0,1,World Cup qualifier,in Slovenia,-22,22,1720,1631,-6,4,38,53,1742,1609,T1
6535,October 8,2016,Scotland,Lithuania,1,1,World Cup qualifier,in Scotland,-16,16,1703,1464,-5,4,42,94,1719,1448,draw
6536,October 8,2016,Poland,Denmark,3,2,World Cup qualifier,in Poland,11,-11,1820,1740,1,-3,19,31,1809,1751,T1
6537,October 8,2016,Northern Ireland,San Marino,4,0,World Cup qualifier,in Northern Ireland,0,0,1652,880,0,0,49,203,1652,880,T1
6538,October 8,2016,Montenegro,Kazakhstan,5,0,World Cup qualifier,in Montenegro,15,-15,1587,1401,5,-5,61,109,1572,1416,T1
6539,October 8,2016,Czechia,Germany,0,3,World Cup qualifier,in Germany,-6,6,1707,2034,-2,0,40,2,1713,2028,T1
6540,October 8,2016,England,Malta,2,0,World Cup qualifier,in England,1,-1,1932,1230,0,0,9,151,1931,1231,T1
6541,October 8,2016,Norway,Azerbaijan,0,1,World Cup qualifier,in Azerbaijan,-27,27,1585,1420,-6,8,62,104,1612,1393,T1
6542,October 8,2016,Romania,Armenia,5,0,World Cup qualifier,in Armenia,30,-30,1736,1483,8,-5,33,85,1706,1513,T2
6543,October 8,2016,Suriname,Guyana,3,2,CONCACAF Champ &amp; Carib Champ qual,in Suriname,15,-15,1219,1208,8,-7,155,162,1204,1223,T1
6544,October 8,2016,Saint Kitts and Nevis,French Guiana,0,1,CONCACAF Champ &amp; Carib Champ qual,in French Guiana,-16,16,1288,1294,-8,10,138,134,1304,1278,T1
6545,October 8,2016,Martinique,Dominican Republic,2,1,CONCACAF Champ &amp; Carib Champ qual,in the Dominican Republic,13,-13,1474,1216,5,-8,88,160,1461,1229,T2
6546,October 8,2016,Antigua and Barbuda,Puerto Rico,2,0,CONCACAF Champ &amp; Carib Champ qual,in Antigua and Barbuda,12,-12,1212,1048,3,0,161,186,1200,1060,T1
6547,October 9,2016,Togo,Mozambique,2,0,Friendly,in Togo,7,-7,1430,1322,2,-2,101,125,1423,1329,T1
6548,October 9,2016,Costa Rica,Russia,4,3,Friendly,in Russia,10,-10,1820,1695,1,-1,19,42,1810,1705,T2
6549,October 9,2016,Vietnam,Indonesia,2,2,Friendly,in Indonesia,1,-1,1280,1216,3,0,141,159,1279,1217,draw
6550,October 9,2016,Cambodia,Sri Lanka,4,0,Friendly,in Cambodia,12,-12,789,742,0,-1,210,214,777,754,T1
6551,October 9,2016,Nigeria,Zambia,2,1,World Cup qualifier,in Zambia,15,-15,1644,1422,3,-3,52,103,1629,1437,T2
6552,October 9,2016,Guinea,Tunisia,0,2,World Cup qualifier,in Tunisia,-19,19,1520,1585,-3,4,78,62,1539,1566,T1
6553,October 9,2016,Congo,Egypt,1,2,World Cup qualifier,in Congo,-16,16,1450,1654,-5,3,98,49,1466,1638,T2
6554,October 9,2016,Algeria,Cameroon,1,1,World Cup qualifier,in Algeria,-7,7,1656,1634,-1,3,48,53,1663,1627,draw
6555,October 9,2016,Wales,Georgia,1,1,World Cup qualifier,in Wales,-17,17,1768,1488,-4,4,27,85,1785,1471,draw
6556,October 9,2016,Kosovo,Ukraine,0,3,World Cup qualifier,in Poland,-9,9,1397,1752,-3,1,109,28,1406,1743,T1
6557,October 9,2016,Serbia,Austria,3,2,World Cup qualifier,in Serbia,15,-15,1727,1709,5,-3,34,39,1712,1724,T1
6558,October 9,2016,Ireland,Moldova,3,1,World Cup qualifier,in Moldova,8,-8,1780,1329,1,-3,24,122,1772,1337,T2
6559,October 9,2016,Macedonia,Italy,2,3,World Cup qualifier,in Macedonia,-3,3,1404,1942,-1,0,106,8,1407,1939,T2
6560,October 9,2016,Israel,Liechtenstein,2,1,World Cup qualifier,in Israel,2,-2,1579,1182,-1,-1,66,169,1577,1184,T1
6561,October 9,2016,Turkey,Iceland,0,2,World Cup qualifier,in Iceland,-26,26,1782,1779,-1,2,22,25,1808,1753,T1
6562,October 9,2016,Finland,Croatia,0,1,World Cup qualifier,in Finland,-10,10,1546,1858,-2,2,72,15,1556,1848,T2
6563,October 9,2016,Spain,Albania,2,0,World Cup qualifier,in Albania,13,-13,1976,1630,0,-4,5,55,1963,1643,T2
6564,October 10,2016,Philippines,North Korea,1,3,Friendly,in the Philippines,-9,9,1253,1513,-2,3,147,79,1262,1504,T2
6565,October 10,2016,Jordan,Morocco,1,2,Friendly,in Morocco,-6,6,1513,1586,0,3,79,62,1519,1580,T1
6566,October 10,2016,Bangladesh,Bhutan,1,3,Asian Cup qualifier,in Bhutan,-45,45,806,609,-2,3,208,228,851,564,T1
6567,October 10,2016,Bulgaria,Sweden,0,3,World Cup qualifier,in Sweden,-13,13,1571,1756,-2,2,66,28,1584,1743,T1
6568,October 10,2016,Netherlands,France,0,1,World Cup qualifier,in the Netherlands,-21,21,1889,2013,-2,0,14,4,1910,1992,T2
6569,October 10,2016,Latvia,Hungary,0,2,World Cup qualifier,in Latvia,-18,18,1417,1707,-4,4,104,40,1435,1689,T2
6570,October 10,2016,Portugal,Faroe Islands,6,0,World Cup qualifier,in the Faroe Islands,4,-4,1929,1297,0,-2,10,132,1925,1301,T2
6571,October 10,2016,Greece,Estonia,2,0,World Cup qualifier,in Estonia,23,-23,1669,1436,5,-5,46,99,1646,1459,T2
6572,October 10,2016,Bosnia and Herzegovina,Cyprus,2,0,World Cup qualifier,in Bosnia and Herzegovina,4,-4,1755,1401,0,-2,29,107,1751,1405,T1
6573,October 10,2016,Gibraltar,Belgium,0,6,World Cup qualifier,in Portugal,-1,1,1102,1900,0,1,181,12,1103,1899,T1
6574,October 10,2016,Belarus,Luxembourg,1,1,World Cup qualifier,in Belarus,-18,18,1589,1247,-1,4,59,148,1607,1229,draw
6575,October 10,2016,Switzerland,Andorra,2,1,World Cup qualifier,in Andorra,0,0,1856,958,0,0,16,190,1856,958,T2
6576,October 11,2016,United States,New Zealand,1,1,Friendly,in the United States,-8,8,1774,1549,-4,2,26,72,1782,1541,draw
6577,October 11,2016,South Africa,Ghana,1,1,Friendly,in South Africa,-2,2,1593,1611,-2,-1,60,58,1595,1609,draw
6578,October 11,2016,Oman,Bahrain,2,2,Friendly,in Oman,-4,4,1464,1442,-2,0,94,98,1468,1438,draw
6579,October 11,2016,Morocco,Canada,4,0,Friendly,in Morocco,11,-11,1597,1520,3,0,59,77,1586,1531,T1
6580,October 11,2016,Panama,Mexico,0,1,Friendly,in the United States,-4,4,1662,1902,-1,1,48,12,1666,1898,T1
6581,October 11,2016,Malaysia,Afghanistan,1,1,Friendly,in Malaysia,-2,2,1120,1145,-1,0,175,170,1122,1143,draw
6582,October 11,2016,Lebanon,Equatorial Guinea,1,1,Friendly,in Lebanon,-4,4,1371,1346,-1,0,116,118,1375,1342,draw
6583,October 11,2016,Turkmenistan,Kyrgyzstan,0,1,Friendly,in Kyrgyzstan,-9,9,1275,1227,-4,6,144,152,1284,1218,T1
6584,October 11,2016,Singapore,Hong Kong,0,2,Friendly,in Hong Kong,-9,9,1124,1198,0,2,173,165,1133,1189,T1
6585,October 11,2016,East Timor,Taiwan,1,2,Asian Cup qualifier,in Taiwan,-9,9,689,823,-2,0,220,207,698,814,T1
6586,October 11,2016,Maldives,Laos,1,1,Asian Cup qualifier,in Laos,-5,5,952,782,0,0,193,211,957,777,draw
6587,October 11,2016,Uzbekistan,China,2,0,World Cup qualifier,in Uzbekistan,13,-13,1672,1524,2,-1,46,76,1659,1537,T1
6588,October 11,2016,United Arab Emirates,Saudi Arabia,0,3,World Cup qualifier,in Saudi Arabia,-27,27,1562,1592,-8,6,67,61,1589,1565,T1
6589,October 11,2016,Qatar,Syria,1,0,World Cup qualifier,in Qatar,15,-15,1552,1528,4,-1,71,74,1537,1543,T1
6590,October 11,2016,Thailand,Iraq,0,4,World Cup qualifier,in Iran,-31,31,1363,1483,-5,9,117,87,1394,1452,T1
6591,October 11,2016,Iran,South Korea,1,0,World Cup qualifier,in Iran,16,-16,1785,1778,5,-4,21,25,1769,1794,T1
6592,October 11,2016,Japan,Australia,1,1,World Cup qualifier,in Australia,5,-5,1742,1722,-1,-3,33,37,1737,1727,draw
6593,October 11,2016,Slovenia,England,0,0,World Cup qualifier,in Slovenia,10,-10,1641,1922,1,-2,53,11,1631,1932,draw
6594,October 11,2016,Slovakia,Scotland,3,0,World Cup qualifier,in Slovakia,24,-24,1744,1679,6,-2,32,44,1720,1703,T1
6595,October 11,2016,Armenia,Poland,1,2,World Cup qualifier,in Poland,-3,3,1480,1823,-3,1,89,18,1483,1820,T1
6596,October 11,2016,Norway,San Marino,4,1,World Cup qualifier,in Norway,1,-1,1586,879,0,0,63,203,1585,880,T1
6597,October 11,2016,Malta,Lithuania,0,2,World Cup qualifier,in Lithuania,-8,8,1222,1472,-2,2,154,91,1230,1464,T1
6598,October 11,2016,Romania,Kazakhstan,0,0,World Cup qualifier,in Kazakhstan,-12,12,1724,1413,-2,2,35,105,1736,1401,draw
6599,October 11,2016,Germany,Northern Ireland,2,0,World Cup qualifier,in Germany,4,-4,2038,1648,-1,0,3,51,2034,1652,T1
6600,October 11,2016,Montenegro,Denmark,1,0,World Cup qualifier,in Denmark,32,-32,1619,1708,4,-8,57,39,1587,1740,T2
6601,October 11,2016,Czechia,Azerbaijan,0,0,World Cup qualifier,in Czechia,-16,16,1691,1436,-3,4,43,99,1707,1420,draw
6602,October 11,2016,Puerto Rico,Curaçao,2,4,CONCACAF Champ &amp; Carib Champ qual,in Puerto Rico,-26,26,1022,1221,0,10,186,155,1048,1195,T2
6603,October 11,2016,Martinique,Trinidad and Tobago,2,0,CONCACAF Champ &amp; Carib Champ qual,in Martinique,28,-28,1502,1528,5,-4,84,74,1474,1556,T1
6604,October 11,2016,Jamaica,Guyana,4,2,CONCACAF Champ &amp; Carib Champ qual,in Guyana,15,-15,1512,1193,2,-4,82,166,1497,1208,T2
6605,October 11,2016,Venezuela,Brazil,0,2,World Cup qualifier,in Venezuela,-12,12,1673,2040,0,1,45,2,1685,2028,T2
6606,October 11,2016,Colombia,Uruguay,2,2,World Cup qualifier,in Colombia,-8,8,1953,1923,-1,1,7,10,1961,1915,draw
6607,October 11,2016,Peru,Chile,1,2,World Cup qualifier,in Chile,-9,9,1814,1958,-2,1,20,6,1823,1949,T1
6608,October 11,2016,Ecuador,Bolivia,2,2,World Cup qualifier,in Bolivia,-7,7,1847,1637,0,1,17,54,1854,1630,draw
6609,October 11,2016,Paraguay,Argentina,1,0,World Cup qualifier,in Argentina,37,-37,1763,2055,8,0,28,1,1726,2092,T2
6610,October 15,2016,Laos,Cambodia,1,2,Southeast Asian Championship qualifier,in Cambodia,-14,14,768,803,0,1,211,209,782,789,T1
6611,October 15,2016,Brunei,East Timor,2,1,Southeast Asian Championship qualifier,in Cambodia,25,-25,628,664,2,-4,228,224,603,689,T1
6612,October 18,2016,East Timor,Laos,1,2,Southeast Asian Championship qualifier,in Cambodia,-14,14,650,782,0,0,224,211,664,768,T1
6613,October 18,2016,Brunei,Cambodia,0,3,Southeast Asian Championship qualifier,in Cambodia,-12,12,616,815,0,1,228,208,628,803,T1
6614,October 21,2016,Laos,Brunei,4,3,Southeast Asian Championship qualifier,in Cambodia,11,-11,793,605,0,-2,211,230,782,616,T1
6615,October 21,2016,East Timor,Cambodia,2,3,Southeast Asian Championship qualifier,in Cambodia,-7,7,643,822,0,0,224,208,650,815,T1
6616,November 2,2016,Brunei,East Timor,4,0,Asian Solidarity Cup,in Malaysia,42,-42,647,601,6,-6,224,230,605,643,T1
6617,November 2,2016,Honduras,Belize,5,0,Friendly,in Honduras,2,-2,1564,1181,0,-1,67,169,1562,1183,T1
6618,November 3,2016,Mongolia,Macao,1,2,Asian Solidarity Cup,in Malaysia,-22,22,647,651,-1,4,224,223,669,629,T1
6619,November 3,2016,Laos,Sri Lanka,2,1,Asian Solidarity Cup,in Malaysia,17,-17,810,725,2,-1,209,215,793,742,T1
6620,November 4,2016,Myanmar,Indonesia,0,0,Friendly,in Myanmar,2,-2,1065,1214,0,-1,185,161,1063,1216,draw
6621,November 5,2016,Zimbabwe,Zambia,1,0,Friendly,in Zimbabwe,8,-8,1403,1414,4,-1,107,104,1395,1422,T1
6622,November 5,2016,East Timor,Nepal,0,0,Asian Solidarity Cup,in Malaysia,14,-14,615,884,2,-1,228,202,601,898,draw
6623,November 6,2016,North Korea,Taiwan,2,0,East Asian Cup qualifier,in Hong Kong,1,-1,1514,822,0,0,79,207,1513,823,T1
6624,November 6,2016,Hong Kong,Guam,3,2,East Asian Cup qualifier,in Hong Kong,3,-3,1201,868,0,0,165,204,1198,871,T1
6625,November 6,2016,Sri Lanka,Mongolia,0,2,Asian Solidarity Cup,in Malaysia,-37,37,688,684,-5,1,220,223,725,647,T1
6626,November 6,2016,Laos,Macao,1,4,Asian Solidarity Cup,in Malaysia,-50,50,760,701,-3,7,212,216,810,651,T1
6627,November 6,2016,Jordan,Iraq,0,0,Friendly,in Jordan,-4,4,1509,1487,-4,0,83,87,1513,1483,draw
6628,November 7,2016,Solomon Islands,Tahiti,0,1,World Cup qualifier,in Tahiti,-9,9,1112,1244,-3,2,177,149,1121,1235,T1
6629,November 8,2016,Vietnam,Indonesia,3,2,Friendly,in Vietnam,6,-6,1286,1208,1,-1,139,162,1280,1214,T1
6630,November 8,2016,Nepal,Brunei,3,0,Asian Solidarity Cup,in Malaysia,14,-14,898,633,1,0,201,225,884,647,T1
6631,November 8,2016,Uganda,Zambia,0,1,Friendly,in Uganda,-15,15,1486,1429,-2,2,87,102,1501,1414,T2
6632,November 9,2016,Guam,North Korea,0,2,East Asian Cup qualifier,in Hong Kong,-1,1,867,1515,0,0,204,79,868,1514,T1
6633,November 9,2016,Taiwan,Hong Kong,2,4,East Asian Cup qualifier,in Hong Kong,-4,4,818,1205,-1,1,208,164,822,1201,T1
6634,November 9,2016,Macao,Sri Lanka,1,1,Asian Solidarity Cup,in Malaysia,-1,1,700,689,-1,0,217,220,701,688,draw
6635,November 9,2016,Laos,Mongolia,3,0,Asian Solidarity Cup,in Malaysia,27,-27,787,657,1,-1,211,224,760,684,T1
6636,November 9,2016,Bahrain,United Arab Emirates,0,2,Friendly,in the United Arab Emirates,-7,7,1435,1569,-2,1,100,67,1442,1562,T1
6637,November 9,2016,Turkmenistan,Tajikistan,0,3,Friendly,in Tajikistan,-15,15,1260,1241,0,2,144,151,1275,1226,T1
6638,November 9,2016,Syria,Singapore,2,0,Friendly,in Malaysia,3,-3,1531,1121,0,0,74,173,1528,1124,T1
6639,November 9,2016,Philippines,Kyrgyzstan,1,0,Friendly,in the Philippines,7,-7,1260,1220,3,-3,144,155,1253,1227,T1
6640,November 9,2016,Netherlands,Belgium,1,1,Friendly,in the Netherlands,-3,3,1886,1903,0,1,14,12,1889,1900,draw
6641,November 9,2016,Belarus,Greece,1,0,Friendly,in Greece,15,-15,1604,1654,3,-2,59,49,1589,1669,T2
6642,November 9,2016,Haiti,French Guiana,2,5,CONCACAF Champ &amp; Carib Champ qual,in Haiti,-60,60,1453,1354,-16,16,96,118,1513,1294,T2
6643,November 10,2016,Jordan,Uzbekistan,0,1,Friendly,in Uzbekistan,-4,4,1505,1676,0,0,82,46,1509,1672,T1
6644,November 10,2016,Qatar,Russia,2,1,Friendly,in Qatar,11,-11,1563,1684,2,-3,69,44,1552,1695,T1
6645,November 10,2016,Lebanon,Palestine,1,1,Friendly,in Lebanon,-4,4,1367,1336,0,2,116,120,1371,1332,draw
6646,November 10,2016,Papua New Guinea,Iran,1,8,Friendly,in Malaysia,-1,1,1138,1786,0,0,171,21,1139,1785,T1
6647,November 10,2016,Bolivia,Venezuela,0,5,World Cup qualifier,in Venezuela,-25,25,1612,1698,-3,4,57,41,1637,1673,T1
6648,November 10,2016,Uruguay,Ecuador,2,1,World Cup qualifier,in Uruguay,11,-11,1934,1836,1,-1,9,18,1923,1847,T1
6649,November 10,2016,Peru,Paraguay,4,1,World Cup qualifier,in Paraguay,40,-40,1854,1723,3,-7,17,35,1814,1763,T2
6650,November 10,2016,Chile,Colombia,0,0,World Cup qualifier,in Colombia,5,-5,1963,1948,0,0,6,7,1958,1953,draw
6651,November 10,2016,Brazil,Argentina,3,0,World Cup qualifier,in Brazil,27,-27,2067,2028,1,-2,1,3,2040,2055,T1
6652,November 11,2016,Canada,South Korea,0,2,Friendly,in South Korea,-3,3,1517,1781,0,2,77,23,1520,1778,T1
6653,November 11,2016,Japan,Oman,4,0,Friendly,in Japan,4,-4,1746,1460,0,0,32,93,1742,1464,T1
6654,November 11,2016,Comoros,Togo,2,2,Friendly,in Tunisia,9,-9,972,1421,0,-2,189,103,963,1430,draw
6655,November 11,2016,Tunisia,Libya,1,0,World Cup qualifier,in Algeria,14,-14,1599,1469,5,-4,59,91,1585,1483,T1
6656,November 11,2016,Lithuania,Slovakia,0,4,World Cup qualifier,in Slovakia,-8,8,1464,1752,-2,2,92,29,1472,1744,T1
6657,November 11,2016,San Marino,Germany,0,8,World Cup qualifier,in San Marino,0,0,879,2038,0,0,203,2,879,2038,T2
6658,November 11,2016,Romania,Poland,0,3,World Cup qualifier,in Romania,-35,35,1689,1858,-9,4,43,15,1724,1823,T2
6659,November 11,2016,Azerbaijan,Northern Ireland,0,4,World Cup qualifier,in Northern Ireland,-11,11,1425,1659,-3,3,101,48,1436,1648,T1
6660,November 11,2016,Slovenia,Malta,1,0,World Cup qualifier,in Malta,5,-5,1646,1217,1,-6,52,159,1641,1222,T2
6661,November 11,2016,Sweden,France,1,2,World Cup qualifier,in France,-5,5,1751,2018,-3,0,31,4,1756,2013,T1
6662,November 11,2016,Scotland,England,0,3,World Cup qualifier,in England,-9,9,1670,1931,-2,1,47,10,1679,1922,T1
6663,November 11,2016,Denmark,Kazakhstan,4,1,World Cup qualifier,in Denmark,7,-7,1715,1406,2,0,37,105,1708,1413,T1
6664,November 11,2016,Czechia,Norway,2,1,World Cup qualifier,in Czechia,9,-9,1700,1577,3,-2,40,65,1691,1586,T1
6665,November 11,2016,Armenia,Montenegro,3,2,World Cup qualifier,in Armenia,22,-22,1502,1597,5,-4,83,60,1480,1619,T1
6666,November 11,2016,Mexico,United States,2,1,World Cup qualifier,in the United States,18,-18,1920,1756,1,-1,12,27,1902,1774,T2
6667,November 11,2016,Costa Rica,Trinidad and Tobago,2,0,World Cup qualifier,in Trinidad and Tobago,15,-15,1835,1513,0,-4,20,79,1820,1528,T2
6668,November 11,2016,Honduras,Panama,0,1,World Cup qualifier,in Honduras,-20,20,1544,1682,-5,2,73,45,1564,1662,T2
6669,November 12,2016,Guam,Taiwan,0,2,East Asian Cup qualifier,in Hong Kong,-34,34,833,852,-3,3,207,205,867,818,T1
6670,November 12,2016,Hong Kong,North Korea,0,1,East Asian Cup qualifier,in Hong Kong,-9,9,1196,1524,-1,3,165,75,1205,1515,T2
6671,November 12,2016,Nepal,Laos,2,2,Asian Solidarity Cup,in Malaysia,-6,6,892,793,0,0,201,211,898,787,draw
6672,November 12,2016,Macao,Brunei,1,1,Asian Solidarity Cup,in Malaysia,-4,4,696,637,0,0,217,225,700,633,draw
6673,November 12,2016,Mozambique,Kenya,0,1,Friendly,in Kenya,-6,6,1316,1383,0,1,126,112,1322,1377,T1
6674,November 12,2016,New Caledonia,New Zealand,0,2,World Cup qualifier,in New Zealand,-8,8,1316,1557,-1,2,126,69,1324,1549,T1
6675,November 12,2016,Uganda,Congo,1,0,World Cup qualifier,in Uganda,13,-13,1499,1437,1,0,86,97,1486,1450,T1
6676,November 12,2016,Senegal,South Africa,1,2,World Cup qualifier,in South Africa,-20,20,1675,1613,-4,6,46,56,1695,1593,T1
6677,November 12,2016,Nigeria,Algeria,3,1,World Cup qualifier,in Nigeria,23,-23,1667,1633,5,-4,48,53,1644,1656,T1
6678,November 12,2016,Morocco,Ivory Coast,0,0,World Cup qualifier,in Morocco,1,-1,1598,1722,-1,-1,61,35,1597,1723,draw
6679,November 12,2016,Mali,Gabon,0,0,World Cup qualifier,in Mali,-11,11,1551,1465,-2,4,71,91,1562,1454,draw
6680,November 12,2016,Burkina Faso,Cape Verde,2,0,World Cup qualifier,in Cape Verde,38,-38,1508,1432,7,-11,82,100,1470,1470,T2
6681,November 12,2016,Zambia,Cameroon,1,1,World Cup qualifier,in Cameroon,14,-14,1443,1620,4,-1,96,55,1429,1634,draw
6682,November 12,2016,Wales,Serbia,1,1,World Cup qualifier,in Wales,-8,8,1760,1735,0,0,26,33,1768,1727,draw
6683,November 12,2016,Finland,Ukraine,0,1,World Cup qualifier,in Ukraine,-6,6,1540,1758,-1,2,73,27,1546,1752,T1
6684,November 12,2016,Turkey,Kosovo,2,0,World Cup qualifier,in Turkey,3,-3,1785,1394,-1,-1,23,111,1782,1397,T1
6685,November 12,2016,Macedonia,Spain,0,4,World Cup qualifier,in Spain,-2,2,1402,1978,-1,0,107,5,1404,1976,T1
6686,November 12,2016,Italy,Liechtenstein,4,0,World Cup qualifier,in Liechtenstein,2,-2,1944,1180,0,-1,8,169,1942,1182,T2
6687,November 12,2016,Georgia,Moldova,1,1,World Cup qualifier,in Georgia,-13,13,1475,1342,-3,3,88,120,1488,1329,draw
6688,November 12,2016,Iceland,Croatia,0,2,World Cup qualifier,in Croatia,-16,16,1763,1874,0,0,25,15,1779,1858,T1
6689,November 12,2016,Austria,Ireland,0,1,World Cup qualifier,in Austria,-22,22,1687,1802,-4,3,42,21,1709,1780,T2
6690,November 12,2016,Israel,Albania,3,0,World Cup qualifier,in Albania,49,-49,1628,1581,10,-9,54,64,1579,1630,T2
6691,November 13,2016,Tahiti,Solomon Islands,0,1,World Cup qualifier,in the Solomon Islands,-22,22,1222,1134,-3,4,152,173,1244,1112,T1
6692,November 13,2016,Zimbabwe,Tanzania,3,0,Friendly,in Zimbabwe,9,-9,1412,1318,1,-1,105,125,1403,1327,T1
6693,November 13,2016,Afghanistan,Tajikistan,0,1,Friendly,in Tajikistan,-5,5,1140,1246,0,3,170,148,1145,1241,T1
6694,November 13,2016,Cambodia,Singapore,0,1,Friendly,in Singapore,-2,2,820,1123,0,-1,208,174,822,1121,T1
6695,November 13,2016,Democratic Republic of Congo,Guinea,2,1,World Cup qualifier,in Guinea,24,-24,1578,1496,4,-9,66,86,1554,1520,T2
6696,November 13,2016,Egypt,Ghana,2,0,World Cup qualifier,in Egypt,18,-18,1672,1593,3,-3,47,61,1654,1611,T1
6697,November 13,2016,Switzerland,Faroe Islands,2,0,World Cup qualifier,in Switzerland,1,-1,1857,1296,0,0,17,133,1856,1297,T1
6698,November 13,2016,Latvia,Portugal,1,4,World Cup qualifier,in Portugal,-2,2,1415,1931,0,1,104,10,1417,1929,T1
6699,November 13,2016,Hungary,Andorra,4,0,World Cup qualifier,in Hungary,1,-1,1708,957,0,-2,38,192,1707,958,T1
6700,November 13,2016,Netherlands,Luxembourg,3,1,World Cup qualifier,in Luxembourg,3,-3,1889,1244,0,-1,14,149,1886,1247,T2
6701,November 13,2016,Bosnia and Herzegovina,Greece,1,1,World Cup qualifier,in Greece,0,0,1755,1654,0,-1,29,51,1755,1654,draw
6702,November 13,2016,Cyprus,Gibraltar,3,1,World Cup qualifier,in Cyprus,5,-5,1406,1097,3,-2,106,183,1401,1102,T1
6703,November 13,2016,Belarus,Bulgaria,0,1,World Cup qualifier,in Bulgaria,-16,16,1588,1587,-4,2,63,64,1604,1571,T1
6704,November 13,2016,Belgium,Estonia,8,1,World Cup qualifier,in Belgium,3,-3,1906,1433,0,-1,13,99,1903,1436,T1
6705,November 13,2016,Haiti,Saint Kitts and Nevis,2,0,CONCACAF Champ &amp; Carib Champ qual,in Saint Kitts and Nevis,24,-24,1477,1264,7,-5,88,143,1453,1288,T2
6706,November 13,2016,Suriname,Jamaica,0,1,CONCACAF Champ &amp; Carib Champ qual,in Jamaica,-4,4,1215,1516,-4,2,160,78,1219,1512,T1
6707,November 14,2016,Oman,Myanmar,3,0,Friendly,in Myanmar,5,-5,1465,1060,2,0,92,185,1460,1065,T2
6708,November 14,2016,Malaysia,Papua New Guinea,2,1,Friendly,in Malaysia,8,-8,1128,1130,1,-2,174,173,1120,1138,T1
6709,November 14,2016,Laos,Brunei,3,2,Asian Solidarity Cup,in Malaysia,12,-12,805,625,1,-2,210,227,793,637,T1
6710,November 14,2016,Slovenia,Poland,1,1,Friendly,in Poland,7,-7,1653,1851,0,-2,52,18,1646,1858,draw
6711,November 15,2016,Mauritania,Tunisia,0,0,Friendly,in Tunisia,8,-8,1306,1591,1,-3,131,61,1298,1599,draw
6712,November 15,2016,South Africa,Mozambique,1,1,Friendly,in Mozambique,-5,5,1608,1321,-1,1,57,125,1613,1316,draw
6713,November 15,2016,Kenya,Liberia,1,0,Friendly,in Kenya,6,-6,1389,1316,0,-3,112,127,1383,1322,T1
6714,November 15,2016,Jordan,Lebanon,0,0,Friendly,in Jordan,-6,6,1499,1373,-1,0,83,116,1505,1367,draw
6715,November 15,2016,Comoros,Gabon,1,1,Friendly,in Tunisia,9,-9,981,1456,0,-2,189,94,972,1465,draw
6716,November 15,2016,Bahrain,Kyrgyzstan,0,0,Friendly,in Bahrain,-7,7,1428,1227,-2,2,100,152,1435,1220,draw
6717,November 15,2016,Nepal,Macao,1,0,Asian Solidarity Cup,in Malaysia,10,-10,902,686,0,-4,201,221,892,696,T1
6718,November 15,2016,New Zealand,New Caledonia,0,0,World Cup qualifier,in New Caledonia,-8,8,1549,1324,-2,2,72,124,1557,1316,draw
6719,November 15,2016,Iraq,United Arab Emirates,0,2,World Cup qualifier,in the United Arab Emirates,-16,16,1471,1585,-3,4,90,64,1487,1569,T1
6720,November 15,2016,Thailand,Australia,2,2,World Cup qualifier,in Thailand,13,-13,1376,1709,3,-1,114,36,1363,1722,draw
6721,November 15,2016,Syria,Iran,0,0,World Cup qualifier,in Malaysia,13,-13,1544,1773,1,-2,73,24,1531,1786,draw
6722,November 15,2016,Uzbekistan,South Korea,1,2,World Cup qualifier,in South Korea,-9,9,1667,1790,-3,2,48,22,1676,1781,T1
6723,November 15,2016,Japan,Saudi Arabia,2,1,World Cup qualifier,in Japan,8,-8,1754,1584,2,-3,30,65,1746,1592,T1
6724,November 15,2016,Qatar,China,0,0,World Cup qualifier,in China,3,-3,1566,1521,0,-1,69,76,1563,1524,draw
6725,November 15,2016,Serbia,Ukraine,0,2,Friendly,in Ukraine,-10,10,1725,1768,-1,2,34,25,1735,1758,T1
6726,November 15,2016,Romania,Russia,0,1,Friendly,in Russia,-7,7,1682,1691,-3,4,44,39,1689,1684,T1
6727,November 15,2016,Croatia,Northern Ireland,3,0,Friendly,in Northern Ireland,12,-12,1886,1647,0,-2,15,52,1874,1659,T2
6728,November 15,2016,Togo,Morocco,1,2,Friendly,in Morocco,-3,3,1418,1601,0,1,103,58,1421,1598,T1
6729,November 15,2016,Malta,Iceland,0,2,Friendly,in Malta,-2,2,1215,1765,-1,-2,159,27,1217,1763,T2
6730,November 15,2016,Germany,Italy,0,0,Friendly,in Italy,0,0,2038,1944,-1,1,3,7,2038,1944,draw
6731,November 15,2016,Hungary,Sweden,0,2,Friendly,in Hungary,-17,17,1691,1768,-1,6,39,25,1708,1751,T2
6732,November 15,2016,France,Ivory Coast,0,0,Friendly,in France,-8,8,2010,1730,0,2,4,33,2018,1722,draw
6733,November 15,2016,England,Spain,2,2,Friendly,in England,-2,2,1929,1980,0,-1,10,6,1931,1978,draw
6734,November 15,2016,Denmark,Czechia,1,1,Friendly,in Czechia,2,-2,1717,1698,2,1,35,38,1715,1700,draw
6735,November 15,2016,Austria,Slovakia,0,0,Friendly,in Austria,-1,1,1686,1753,0,-1,42,31,1687,1752,draw
6736,November 15,2016,Mexico,Panama,0,0,World Cup qualifier,in Panama,-8,8,1912,1690,0,3,12,41,1920,1682,draw
6737,November 15,2016,Trinidad and Tobago,Honduras,1,3,World Cup qualifier,in Honduras,-19,19,1494,1563,-7,2,86,70,1513,1544,T1
6738,November 15,2016,United States,Costa Rica,0,4,World Cup qualifier,in Costa Rica,-20,20,1736,1855,-4,3,32,17,1756,1835,T1
6739,November 15,2016,Peru,Brazil,0,2,World Cup qualifier,in Peru,-21,21,1833,2088,-3,0,20,1,1854,2067,T2
6740,November 15,2016,Venezuela,Ecuador,0,3,World Cup qualifier,in Ecuador,-14,14,1684,1850,-3,0,43,19,1698,1836,T1
6741,November 15,2016,Uruguay,Chile,1,3,World Cup qualifier,in Chile,-19,19,1915,1982,-2,1,11,5,1934,1963,T1
6742,November 15,2016,Bolivia,Paraguay,1,0,World Cup qualifier,in Bolivia,21,-21,1633,1702,4,-3,53,37,1612,1723,T1
6743,November 15,2016,Argentina,Colombia,3,0,World Cup qualifier,in Argentina,18,-18,2046,1930,1,-2,2,9,2028,1948,T1
6744,November 19,2016,Indonesia,Thailand,2,4,Southeast Asian Championship,in the Philippines,-17,17,1191,1393,-4,2,166,112,1208,1376,T1
6745,November 19,2016,Philippines,Singapore,0,0,Southeast Asian Championship,in the Philippines,-12,12,1248,1135,-3,3,147,172,1260,1123,draw
6746,November 19,2016,Estonia,Saint Kitts and Nevis,1,1,Friendly,in Saint Kitts and Nevis,-2,2,1431,1266,-1,0,99,143,1433,1264,draw
6747,November 20,2016,Myanmar,Vietnam,1,2,Southeast Asian Championship,in Myanmar,-13,13,1047,1299,0,5,185,133,1060,1286,T2
6748,November 20,2016,Cambodia,Malaysia,2,3,Southeast Asian Championship,in Myanmar,-6,6,814,1134,0,2,208,173,820,1128,T1
6749,November 22,2016,Singapore,Thailand,0,1,Southeast Asian Championship,in the Philippines,-7,7,1128,1400,-3,2,175,110,1135,1393,T1
6750,November 22,2016,Indonesia,Philippines,2,2,Southeast Asian Championship,in the Philippines,8,-8,1199,1240,2,-3,164,150,1191,1248,draw
6751,November 22,2016,Estonia,Antigua and Barbuda,1,0,Friendly,in Antigua and Barbuda,7,-7,1438,1205,2,-1,97,162,1431,1212,T2
6752,November 23,2016,Malaysia,Vietnam,0,1,Southeast Asian Championship,in Myanmar,-11,11,1123,1310,-3,4,175,129,1134,1299,T1
6753,November 23,2016,Cambodia,Myanmar,1,3,Southeast Asian Championship,in Myanmar,-8,8,806,1055,0,0,208,185,814,1047,T1
6754,November 25,2016,Thailand,Philippines,1,0,Southeast Asian Championship,in the Philippines,17,-17,1417,1223,6,-2,104,152,1400,1240,T2
6755,November 25,2016,Singapore,Indonesia,1,2,Southeast Asian Championship,in the Philippines,-16,16,1112,1215,-3,5,177,159,1128,1199,T1
6756,November 26,2016,Vietnam,Cambodia,2,1,Southeast Asian Championship,in Myanmar,2,-2,1312,804,1,-2,128,210,1310,806,T1
6757,November 26,2016,Malaysia,Myanmar,0,1,Southeast Asian Championship,in Myanmar,-18,18,1105,1073,-5,0,179,185,1123,1055,T1
6758,December 3,2016,Vietnam,Indonesia,1,2,Southeast Asian Championship,in Indonesia,-20,20,1292,1235,-9,8,137,151,1312,1215,T1
6759,December 4,2016,Myanmar,Thailand,0,2,Southeast Asian Championship,in Myanmar,-12,12,1061,1429,0,4,185,100,1073,1417,T2
6760,December 7,2016,Indonesia,Vietnam,2,2,Southeast Asian Championship,in Vietnam,8,-8,1243,1284,1,-2,150,139,1235,1292,draw
6761,December 8,2016,Myanmar,Thailand,0,4,Southeast Asian Championship,in Thailand,-5,5,1056,1434,0,1,185,99,1061,1429,T1
6762,December 14,2016,Indonesia,Thailand,2,1,Southeast Asian Championship,in Indonesia,25,-25,1268,1409,7,-7,143,106,1243,1434,T1
6763,December 17,2016,Thailand,Indonesia,2,0,Southeast Asian Championship,in Thailand,12,-12,1421,1256,3,-3,103,146,1409,1268,T1
6764,December 26,2016,Zimbabwe,Ivory Coast,0,0,Friendly,in Ivory Coast,8,-8,1420,1722,2,-1,104,34,1412,1730,draw
6765,December 27,2016,Trinidad and Tobago,Nicaragua,1,2,Friendly,in Nicaragua,-14,14,1480,1272,0,2,86,143,1494,1258,T1
6766,January 4,2017,Tunisia,Uganda,2,0,Friendly,in Tunisia,7,-7,1598,1492,2,-2,59,85,1591,1499,T1
6767,January 4,2017,Trinidad and Tobago,Suriname,1,2,CONCACAF Champ &amp; Carib Champ qual,in Trinidad and Tobago,-36,36,1454,1251,-9,12,95,148,1490,1215,T2
6768,January 5,2017,Democratic Republic of Congo,Cameroon,0,2,Friendly,in Cameroon,-9,9,1569,1629,-1,1,68,55,1578,1620,T1
6769,January 6,2017,Haiti,Suriname,4,2,CONCACAF Champ &amp; Carib Champ qual,in Trinidad and Tobago,13,-13,1490,1238,0,-4,86,152,1477,1251,T1
6770,January 7,2017,Mali,Burkina Faso,1,2,Friendly,in Morocco,-11,11,1540,1519,-2,3,73,77,1551,1508,T1
6771,January 7,2017,Algeria,Mauritania,3,1,Friendly,in Algeria,2,-2,1635,1304,0,0,53,131,1633,1306,T1
6772,January 8,2017,Libya,Senegal,1,2,Friendly,in Congo,-5,5,1464,1680,-1,0,91,45,1469,1675,T1
6773,January 8,2017,Sweden,Ivory Coast,1,2,Friendly,in the United Arab Emirates,-11,11,1757,1733,-3,1,28,33,1768,1722,T1
6774,January 8,2017,Egypt,Tunisia,1,0,Friendly,in Egypt,5,-5,1677,1593,0,-1,46,60,1672,1598,T1
6775,January 8,2017,Haiti,Trinidad and Tobago,4,3,CONCACAF Champ &amp; Carib Champ qual,in Trinidad and Tobago,24,-24,1514,1430,6,-4,80,99,1490,1454,T2
6776,January 9,2017,Finland,Morocco,1,0,Friendly,in the United Arab Emirates,12,-12,1552,1589,2,-3,71,61,1540,1601,T1
6777,January 10,2017,Cameroon,Zimbabwe,1,1,Friendly,in Cameroon,-7,7,1622,1427,-1,3,56,101,1629,1420,draw
6778,January 10,2017,Algeria,Mauritania,6,0,Friendly,in Algeria,3,-3,1638,1301,0,0,53,131,1635,1304,T1
6779,January 10,2017,China,Iceland,0,2,Friendly tournament,in China,-14,14,1507,1779,-5,2,81,24,1521,1765,T2
6780,January 11,2017,Croatia,Chile,1,1,Friendly tournament,in China,4,-4,1890,1978,1,-1,14,6,1886,1982,draw
6781,January 11,2017,Uganda,Ivory Coast,0,3,Friendly,in the United Arab Emirates,-7,7,1485,1740,0,1,86,32,1492,1733,T1
6782,January 11,2017,Senegal,Congo,2,0,Friendly,in Congo,9,-9,1689,1428,3,-2,42,99,1680,1437,T2
6783,January 13,2017,Belize,Panama,0,0,CONCACAF Champ q &amp; Central Am Cup,in Panama,19,-19,1200,1671,3,-5,165,46,1181,1690,draw
6784,January 13,2017,Nicaragua,Honduras,1,2,CONCACAF Champ q &amp; Central Am Cup,in Panama,-6,6,1256,1569,-1,2,145,68,1262,1563,T1
6785,January 13,2017,El Salvador,Costa Rica,0,0,CONCACAF Champ q &amp; Central Am Cup,in Panama,17,-17,1419,1838,4,-2,105,19,1402,1855,draw
6786,January 14,2017,Croatia,China,1,1,Friendly tournament,in China,-10,10,1880,1517,-1,4,15,77,1890,1507,draw
6787,January 14,2017,Saudi Arabia,Cambodia,7,2,Friendly,in the United Arab Emirates,0,0,1584,804,0,0,65,210,1584,804,T1
6788,January 14,2017,Guinea-Bissau,Gabon,1,1,African Nations Cup,in Gabon,17,-17,1297,1439,7,-2,133,95,1280,1456,draw
6789,January 14,2017,Burkina Faso,Cameroon,1,1,African Nations Cup,in Gabon,7,-7,1526,1615,1,0,75,56,1519,1622,draw
6790,January 15,2017,Iceland,Chile,0,1,Friendly tournament,in China,-7,7,1772,1985,-1,1,25,5,1779,1978,T1
6791,January 15,2017,Tunisia,Senegal,0,2,African Nations Cup,in Gabon,-27,27,1566,1716,-10,5,69,36,1593,1689,T1
6792,January 15,2017,Algeria,Zimbabwe,2,2,African Nations Cup,in Gabon,-14,14,1624,1441,-2,6,55,95,1638,1427,draw
6793,January 15,2017,Panama,Nicaragua,2,1,CONCACAF Champ q &amp; Central Am Cup,in Panama,2,-2,1673,1254,0,-2,46,147,1671,1256,T1
6794,January 15,2017,Honduras,El Salvador,2,1,CONCACAF Champ q &amp; Central Am Cup,in Panama,12,-12,1581,1407,3,-2,65,107,1569,1419,T1
6795,January 15,2017,Belize,Costa Rica,0,3,CONCACAF Champ q &amp; Central Am Cup,in Panama,-2,2,1198,1840,0,0,165,19,1200,1838,T1
6796,January 16,2017,Togo,Ivory Coast,0,0,African Nations Cup,in Gabon,18,-18,1436,1722,7,-2,98,34,1418,1740,draw
6797,January 16,2017,Democratic Republic of Congo,Morocco,1,0,African Nations Cup,in Gabon,26,-26,1595,1563,9,-10,59,70,1569,1589,T1
6798,January 17,2017,Moldova,Qatar,1,1,Friendly,in Qatar,7,-7,1349,1559,1,-2,119,70,1342,1566,draw
6799,January 17,2017,Uganda,Ghana,0,1,African Nations Cup,in Gabon,-17,17,1468,1610,-3,2,89,58,1485,1593,T1
6800,January 17,2017,Mali,Egypt,0,0,African Nations Cup,in Gabon,9,-9,1549,1668,2,-1,72,46,1540,1677,draw
6801,January 17,2017,Panama,Honduras,0,1,CONCACAF Champ q &amp; Central Am Cup,in Panama,-30,30,1643,1611,-6,8,52,57,1673,1581,T2
6802,January 17,2017,El Salvador,Belize,3,1,CONCACAF Champ q &amp; Central Am Cup,in Panama,14,-14,1421,1184,2,-3,105,168,1407,1198,T1
6803,January 17,2017,Nicaragua,Costa Rica,0,0,CONCACAF Champ q &amp; Central Am Cup,in Panama,19,-19,1273,1821,4,-1,143,20,1254,1840,draw
6804,January 18,2017,Gabon,Burkina Faso,1,1,African Nations Cup,in Gabon,-1,1,1438,1527,0,0,96,75,1439,1526,draw
6805,January 18,2017,Cameroon,Guinea-Bissau,2,1,African Nations Cup,in Gabon,7,-7,1622,1290,0,-4,56,137,1615,1297,T1
6806,January 19,2017,Algeria,Tunisia,1,2,African Nations Cup,in Gabon,-29,29,1595,1595,-5,8,60,60,1624,1566,T1
6807,January 19,2017,Senegal,Zimbabwe,2,0,African Nations Cup,in Gabon,13,-13,1729,1428,3,-5,33,100,1716,1441,T1
6808,January 20,2017,Morocco,Togo,3,1,African Nations Cup,in Gabon,24,-24,1587,1412,5,-10,64,107,1563,1436,T1
6809,January 20,2017,Ivory Coast,Democratic Republic of Congo,2,2,African Nations Cup,in Gabon,-9,9,1713,1604,-1,1,36,59,1722,1595,draw
6810,January 20,2017,El Salvador,Panama,0,1,CONCACAF Champ q &amp; Central Am Cup,in Panama,-5,5,1416,1648,0,1,105,51,1421,1643,T1
6811,January 20,2017,Belize,Nicaragua,1,3,CONCACAF Champ q &amp; Central Am Cup,in Panama,-22,22,1162,1295,-1,9,169,134,1184,1273,T1
6812,January 20,2017,Costa Rica,Honduras,1,1,CONCACAF Champ q &amp; Central Am Cup,in Panama,-11,11,1810,1622,0,1,20,55,1821,1611,draw
6813,January 21,2017,Mali,Ghana,0,1,African Nations Cup,in Gabon,-21,21,1528,1631,-2,3,74,54,1549,1610,T1
6814,January 21,2017,Uganda,Egypt,0,1,African Nations Cup,in Gabon,-12,12,1456,1680,-3,1,92,45,1468,1668,T1
6815,January 22,2017,Gabon,Cameroon,0,0,African Nations Cup,in Gabon,6,-6,1444,1616,1,-1,94,57,1438,1622,draw
6816,January 22,2017,Burkina Faso,Guinea-Bissau,2,0,African Nations Cup,in Gabon,15,-15,1542,1275,1,-5,74,143,1527,1290,T1
6817,January 22,2017,Canada,Bermuda,4,2,Friendly,in Bermuda,7,-7,1524,1199,1,-2,76,164,1517,1206,T2
6818,January 22,2017,Costa Rica,Panama,0,1,CONCACAF Champ q &amp; Central Am Cup,in Panama,-24,24,1786,1672,-2,5,22,46,1810,1648,T1
6819,January 22,2017,Belize,Honduras,0,1,CONCACAF Champ q &amp; Central Am Cup,in Panama,-3,3,1159,1625,0,0,169,56,1162,1622,T1
6820,January 22,2017,El Salvador,Nicaragua,1,0,CONCACAF Champ q &amp; Central Am Cup,in Panama,13,-13,1429,1282,6,-6,99,140,1416,1295,T1
6821,January 23,2017,Zimbabwe,Tunisia,2,4,African Nations Cup,in Gabon,-21,21,1407,1616,-7,4,107,57,1428,1595,T1
6822,January 23,2017,Senegal,Algeria,2,2,African Nations Cup,in Gabon,-9,9,1720,1604,-1,1,34,60,1729,1595,draw
6823,January 23,2017,Georgia,Uzbekistan,2,2,Friendly,in the United Arab Emirates,5,-5,1480,1662,0,-1,86,49,1475,1667,draw
6824,January 24,2017,Ivory Coast,Morocco,0,1,African Nations Cup,in Gabon,-34,34,1679,1621,-9,6,45,58,1713,1587,T1
6825,January 24,2017,Togo,Democratic Republic of Congo,1,3,African Nations Cup,in Gabon,-19,19,1393,1623,-6,3,112,57,1412,1604,T1
6826,January 25,2017,Mali,Uganda,1,1,African Nations Cup,in Gabon,-5,5,1523,1461,-2,0,77,92,1528,1456,draw
6827,January 25,2017,Ghana,Egypt,0,1,African Nations Cup,in Gabon,-21,21,1610,1701,-6,6,60,38,1631,1680,T1
6828,January 25,2017,Georgia,Jordan,0,1,Friendly,in the United Arab Emirates,-9,9,1471,1508,-1,2,87,82,1480,1499,T1
6829,January 25,2017,Brazil,Colombia,1,0,Friendly,in Brazil,4,-4,2092,1926,0,-1,1,10,2088,1930,T1
6830,January 28,2017,Senegal,Cameroon,0,0,African Nations Cup,in Gabon,-7,7,1713,1623,-1,2,35,56,1720,1616,draw
6831,January 28,2017,Burkina Faso,Tunisia,2,0,African Nations Cup,in Gabon,45,-45,1587,1571,10,-12,64,70,1542,1616,T1
6832,January 29,2017,Ghana,Democratic Republic of Congo,2,1,African Nations Cup,in Gabon,26,-26,1636,1597,6,-5,53,61,1610,1623,T1
6833,January 29,2017,Egypt,Morocco,1,0,African Nations Cup,in Gabon,19,-19,1720,1602,4,-2,34,60,1701,1621,T1
6834,January 29,2017,United States,Serbia,0,0,Friendly,in the United States,-3,3,1733,1728,0,0,32,33,1736,1725,draw
6835,February 1,2017,Burkina Faso,Egypt,1,1,African Nations Cup,in Gabon,9,-9,1596,1711,1,-2,63,36,1587,1720,draw
6836,February 2,2017,Cameroon,Ghana,2,0,African Nations Cup,in Gabon,39,-39,1662,1597,8,-7,49,60,1623,1636,T1
6837,February 3,2017,Jamaica,United States,0,1,Friendly,in the United States,-3,3,1513,1736,-1,0,80,32,1516,1733,T1
6838,February 4,2017,Burkina Faso,Ghana,1,0,African Nations Cup,in Gabon,25,-25,1621,1572,6,-9,57,69,1596,1597,T1
6839,February 5,2017,Egypt,Cameroon,1,2,African Nations Cup,in Gabon,-29,29,1682,1691,-8,10,44,39,1711,1662,T1
6840,February 8,2017,Iceland,Mexico,0,1,Friendly,in the United States,-6,6,1766,1918,-1,1,26,11,1772,1912,T1
6841,February 16,2017,Jamaica,Honduras,1,0,Friendly,in the United States,13,-13,1526,1612,5,-1,75,57,1513,1625,T1
6842,February 22,2017,San Marino,Andorra,0,2,Friendly,in San Marino,-16,16,863,973,0,2,203,190,879,957,T2
6843,February 22,2017,Honduras,Ecuador,1,3,Friendly,in Ecuador,-4,4,1608,1854,0,1,57,17,1612,1850,T1
6844,March 9,2017,Azerbaijan,Qatar,2,1,Friendly,in Qatar,16,-16,1441,1543,6,-3,96,74,1425,1559,T2
6845,March 10,2017,Barbados,Trinidad and Tobago,0,2,Friendly,in Trinidad and Tobago,-3,3,1133,1433,-1,1,172,98,1136,1430,T1
6846,March 11,2017,Djibouti,Burundi,0,7,Friendly,in Burundi,-1,1,751,1312,0,0,213,128,752,1311,T1
6847,March 13,2017,Burundi,Djibouti,1,0,Friendly,in Burundi,0,0,1312,751,0,0,128,213,1312,751,T1
6848,March 16,2017,Honduras,Nicaragua,2,0,Friendly,in Honduras,2,-2,1610,1280,0,0,57,140,1608,1282,T1
6849,March 18,2017,Iran,Iraq,0,1,Friendly,in Iran,-18,18,1755,1489,-4,1,28,86,1773,1471,T2
6850,March 19,2017,Moldova,San Marino,2,0,Friendly,in San Marino,3,-3,1352,860,0,0,119,203,1349,863,T2
6851,March 21,2017,Myanmar,Indonesia,3,1,Friendly,in Indonesia,25,-25,1081,1231,1,-6,184,152,1056,1256,T2
6852,March 22,2017,Vietnam,Taiwan,1,1,Friendly,in Vietnam,-9,9,1275,861,-3,2,142,203,1284,852,draw
6853,March 22,2017,Malaysia,Philippines,0,0,Friendly,in the Philippines,6,-6,1111,1217,3,-5,176,159,1105,1223,draw
6854,March 22,2017,Yemen,Palestine,0,1,Friendly,in Qatar,-6,6,1199,1342,-1,0,163,121,1205,1336,T1
6855,March 22,2017,Cambodia,India,2,3,Friendly,in Cambodia,-5,5,799,1106,-1,4,211,177,804,1101,T2
6856,March 22,2017,Madagascar,São Tomé and Príncipe,1,0,African Nations Cup qualifier,in São Tomé and Príncipe,18,-18,1262,1089,3,-5,145,182,1244,1107,T2
6857,March 22,2017,South Sudan,Djibouti,0,2,African Nations Cup qualifier,in Djibouti,-49,49,1065,800,-10,3,185,210,1114,751,T1
6858,March 22,2017,Canada,Scotland,1,1,Friendly,in Scotland,6,-6,1530,1664,1,-1,75,49,1524,1670,draw
6859,March 22,2017,England,Germany,0,1,Friendly,in Germany,-5,5,1924,2043,-1,0,10,3,1929,2038,T1
6860,March 22,2017,Czechia,Lithuania,3,0,Friendly,in Czechia,4,-4,1702,1460,1,-2,37,92,1698,1464,T1
6861,March 22,2017,Cyprus,Kazakhstan,3,1,Friendly,in Cyprus,11,-11,1417,1395,2,-3,105,110,1406,1406,T1
6862,March 22,2017,Curaçao,El Salvador,1,1,Friendly,in Curaçao,3,-3,1224,1426,2,-2,154,102,1221,1429,draw
6863,March 23,2017,Papua New Guinea,Tahiti,1,3,World Cup qualifier,in Papua New Guinea,-31,31,1099,1253,-6,7,179,148,1130,1222,T2
6864,March 23,2017,Senegal,Nigeria,1,1,Friendly,in England,-1,1,1712,1668,-1,0,36,48,1713,1667,draw
6865,March 23,2017,Kenya,Uganda,1,1,Friendly,in Kenya,-1,1,1388,1462,0,0,113,91,1389,1461,draw
6866,March 23,2017,Hong Kong,Jordan,0,4,Friendly,in Jordan,-3,3,1193,1511,0,1,165,81,1196,1508,T1
6867,March 23,2017,Bahrain,Tajikistan,1,1,Friendly,in Bahrain,-7,7,1421,1253,-3,0,103,148,1428,1246,draw
6868,March 23,2017,Singapore,Afghanistan,1,2,Friendly,in Qatar,-9,9,1103,1149,-3,0,178,170,1112,1140,T1
6869,March 23,2017,United Arab Emirates,Japan,0,2,World Cup qualifier,in the United Arab Emirates,-24,24,1561,1778,-6,7,71,23,1585,1754,T2
6870,March 23,2017,Saudi Arabia,Thailand,3,0,World Cup qualifier,in Thailand,29,-29,1613,1392,9,-8,57,112,1584,1421,T2
6871,March 23,2017,Syria,Uzbekistan,1,0,World Cup qualifier,in Malaysia,27,-27,1571,1635,4,-3,69,53,1544,1662,T1
6872,March 23,2017,Qatar,Iran,0,1,World Cup qualifier,in Qatar,-14,14,1529,1769,-2,4,76,24,1543,1755,T2
6873,March 23,2017,Iraq,Australia,1,1,World Cup qualifier,in Iran,11,-11,1500,1698,1,-2,85,38,1489,1709,draw
6874,March 23,2017,South Korea,China,0,1,World Cup qualifier,in China,-29,29,1761,1546,-6,5,27,74,1790,1517,T1
6875,March 23,2017,Venezuela,Peru,2,2,World Cup qualifier,in Venezuela,3,-3,1687,1830,1,0,42,19,1684,1833,draw
6876,March 23,2017,Brazil,Uruguay,4,1,World Cup qualifier,in Uruguay,27,-27,2119,1888,0,-2,1,14,2092,1915,T2
6877,March 23,2017,Paraguay,Ecuador,2,1,World Cup qualifier,in Paraguay,23,-23,1725,1831,3,-1,34,18,1702,1854,T1
6878,March 23,2017,Colombia,Bolivia,1,0,World Cup qualifier,in Colombia,4,-4,1930,1629,0,0,9,54,1926,1633,T1
6879,March 23,2017,Argentina,Chile,1,0,World Cup qualifier,in Argentina,11,-11,2057,1974,0,-1,2,6,2046,1985,T1
6880,March 24,2017,Tunisia,Cameroon,0,1,Friendly,in Tunisia,-9,9,1562,1700,-1,1,70,38,1571,1691,T2
6881,March 24,2017,Russia,Ivory Coast,0,2,Friendly,in Russia,-20,20,1671,1699,-7,7,46,39,1691,1679,T2
6882,March 24,2017,Burkina Faso,Morocco,0,2,Friendly,in Morocco,-12,12,1609,1614,-2,5,58,56,1621,1602,T1
6883,March 24,2017,Benin,Mauritania,0,1,Friendly,in Mauritania,-10,10,1386,1311,-5,2,113,129,1396,1301,T1
6884,March 24,2017,Libya,Togo,0,0,Friendly,in Egypt,-2,2,1462,1395,1,3,89,108,1464,1393,draw
6885,March 24,2017,Gabon,Guinea,2,2,Friendly,in France,1,-1,1445,1495,-1,0,95,86,1444,1496,draw
6886,March 24,2017,Mauritius,Comoros,0,2,African Nations Cup qualifier,in the Comoros,-31,31,1067,1012,-4,2,184,187,1098,981,T1
6887,March 24,2017,Turkey,Finland,2,0,World Cup qualifier,in Turkey,8,-8,1793,1544,1,-2,21,74,1785,1552,T1
6888,March 24,2017,Israel,Spain,1,4,World Cup qualifier,in Spain,-5,5,1623,1985,0,0,55,5,1628,1980,T1
6889,March 24,2017,Liechtenstein,Macedonia,0,3,World Cup qualifier,in Liechtenstein,-23,23,1157,1425,-1,5,169,102,1180,1402,T2
6890,March 24,2017,Kosovo,Iceland,1,2,World Cup qualifier,in Albania,-4,4,1390,1770,-1,2,111,24,1394,1766,T2
6891,March 24,2017,Italy,Albania,2,0,World Cup qualifier,in Italy,4,-4,1948,1577,0,0,7,66,1944,1581,T1
6892,March 24,2017,Wales,Ireland,0,0,World Cup qualifier,in Ireland,8,-8,1768,1794,2,0,26,20,1760,1802,draw
6893,March 24,2017,Georgia,Serbia,1,3,World Cup qualifier,in Georgia,-17,17,1454,1745,-6,0,94,33,1471,1728,T2
6894,March 24,2017,Ukraine,Croatia,0,1,World Cup qualifier,in Croatia,-9,9,1759,1889,-3,2,28,13,1768,1880,T1
6895,March 24,2017,Moldova,Austria,0,2,World Cup qualifier,in Austria,-5,5,1347,1691,0,2,119,41,1352,1686,T1
6896,March 24,2017,Haiti,Nicaragua,3,1,CONCACAF Championship qualifier,in Haiti,8,-8,1522,1272,0,-4,80,143,1514,1280,T1
6897,March 24,2017,Honduras,United States,0,6,World Cup qualifier,in the United States,-18,18,1592,1754,-5,1,63,31,1610,1736,T1
6898,March 24,2017,Trinidad and Tobago,Panama,1,0,World Cup qualifier,in Trinidad and Tobago,28,-28,1461,1644,7,-5,91,52,1433,1672,T1
6899,March 24,2017,Mexico,Costa Rica,2,0,World Cup qualifier,in Mexico,12,-12,1930,1774,2,-2,9,23,1918,1786,T1
6900,March 25,2017,Fiji,New Zealand,0,2,World Cup qualifier,in Fiji,-14,14,1225,1563,-3,2,154,70,1239,1549,T2
6901,March 25,2017,Botswana,Tanzania,0,2,Friendly,in Tanzania,-10,10,1284,1328,-3,2,138,124,1294,1318,T1
6902,March 25,2017,Guinea-Bissau,South Africa,1,3,Friendly,in South Africa,-2,2,1273,1610,-1,0,142,59,1275,1608,T1
6903,March 25,2017,Angola,Mozambique,0,2,Friendly,in Mozambique,-7,7,1213,1328,-5,1,161,124,1220,1321,T1
6904,March 25,2017,Switzerland,Latvia,1,0,World Cup qualifier,in Switzerland,2,-2,1859,1413,1,1,15,105,1857,1415,T1
6905,March 25,2017,Belarus,Sweden,0,4,World Cup qualifier,in Sweden,-13,13,1575,1770,-3,5,67,24,1588,1757,T1
6906,March 25,2017,Hungary,Portugal,0,3,World Cup qualifier,in Portugal,-9,9,1682,1940,-2,0,43,8,1691,1931,T1
6907,March 25,2017,France,Luxembourg,3,1,World Cup qualifier,in Luxembourg,1,-1,2011,1243,0,0,4,150,2010,1244,T2
6908,March 25,2017,Estonia,Cyprus,0,0,World Cup qualifier,in Cyprus,4,-4,1442,1413,1,0,97,105,1438,1417,draw
6909,March 25,2017,Netherlands,Bulgaria,0,2,World Cup qualifier,in Bulgaria,-46,46,1843,1633,-4,11,17,54,1889,1587,T1
6910,March 25,2017,Gibraltar,Bosnia and Herzegovina,0,5,World Cup qualifier,in Bosnia and Herzegovina,-1,1,1096,1756,0,0,180,30,1097,1755,T1
6911,March 25,2017,Belgium,Greece,1,1,World Cup qualifier,in Belgium,-15,15,1891,1669,0,2,12,47,1906,1654,draw
6912,March 25,2017,Andorra,Faroe Islands,0,0,World Cup qualifier,in Andorra,11,-11,984,1285,0,-3,190,136,973,1296,draw
6913,March 26,2017,Zimbabwe,Zambia,0,0,Friendly,in Zimbabwe,-2,2,1405,1445,0,1,107,95,1407,1443,draw
6914,March 26,2017,Democratic Republic of Congo,Kenya,1,2,Friendly,in Kenya,-13,13,1584,1401,-2,4,64,108,1597,1388,T1
6915,March 26,2017,Turkmenistan,Taiwan,3,1,Asian Cup qualifier,in Taiwan,9,-9,1269,852,2,-2,144,205,1260,861,T2
6916,March 26,2017,Madagascar,São Tomé and Príncipe,3,2,African Nations Cup qualifier,in Madagascar,7,-7,1269,1082,1,0,144,181,1262,1089,T1
6917,March 26,2017,Slovenia,Scotland,0,1,World Cup qualifier,in Scotland,-14,14,1639,1678,-2,4,52,45,1653,1664,T1
6918,March 26,2017,San Marino,Czechia,0,6,World Cup qualifier,in San Marino,-1,1,859,1703,0,0,204,37,860,1702,T2
6919,March 26,2017,Romania,Denmark,0,0,World Cup qualifier,in Romania,-4,4,1678,1721,-2,0,45,35,1682,1717,draw
6920,March 26,2017,Northern Ireland,Norway,2,0,World Cup qualifier,in Northern Ireland,16,-16,1663,1561,1,-6,50,71,1647,1577,T1
6921,March 26,2017,Poland,Montenegro,2,1,World Cup qualifier,in Montenegro,12,-12,1863,1585,1,-1,15,63,1851,1597,T2
6922,March 26,2017,Malta,Slovakia,1,3,World Cup qualifier,in Malta,-4,4,1211,1757,-1,2,161,30,1215,1753,T2
6923,March 26,2017,Lithuania,England,0,2,World Cup qualifier,in England,-2,2,1458,1926,0,0,92,11,1460,1924,T1
6924,March 26,2017,Azerbaijan,Germany,1,4,World Cup qualifier,in Azerbaijan,-4,4,1437,2047,0,0,98,3,1441,2043,T2
6925,March 26,2017,Armenia,Kazakhstan,2,0,World Cup qualifier,in Armenia,14,-14,1516,1381,2,-5,81,113,1502,1395,T1
6926,March 26,2017,Martinique,Barbados,1,2,Friendly,in Barbados,-16,16,1486,1149,-3,2,86,170,1502,1133,T1
6927,March 27,2017,Moldova,Turkey,1,3,Friendly,in Turkey,-1,1,1346,1794,0,1,119,20,1347,1793,T1
6928,March 27,2017,Mauritania,Congo,2,1,Friendly,in Mauritania,10,-10,1321,1418,2,-4,127,104,1311,1428,T1
6929,March 27,2017,Ivory Coast,Senegal,1,1,Friendly,in France,0,0,1699,1712,0,0,39,36,1699,1712,draw
6930,March 27,2017,Central African Republic,Gambia,1,2,Friendly,in Morocco,-10,10,1285,1290,-3,5,136,134,1295,1280,T1
6931,March 28,2017,Tanzania,Burundi,2,1,Friendly,in Tanzania,7,-7,1335,1305,2,-3,122,132,1328,1312,T1
6932,March 28,2017,Angola,South Africa,0,0,Friendly,in South Africa,9,-9,1222,1601,5,-2,155,61,1213,1610,draw
6933,March 28,2017,Belgium,Russia,3,3,Friendly,in Russia,-3,3,1888,1674,0,-1,12,48,1891,1671,draw
6934,March 28,2017,Sweden,Portugal,3,2,Friendly,in Portugal,17,-17,1787,1923,3,-3,21,11,1770,1940,T2
6935,March 28,2017,Italy,Netherlands,2,1,Friendly,in the Netherlands,10,-10,1958,1833,-1,-1,8,18,1948,1843,T2
6936,March 28,2017,Mozambique,Lesotho,1,0,Friendly,in Mozambique,5,-5,1333,1214,-1,-5,125,161,1328,1219,T1
6937,March 28,2017,Morocco,Tunisia,1,0,Friendly,in Morocco,6,-6,1620,1556,-1,0,58,70,1614,1562,T1
6938,March 28,2017,Macedonia,Belarus,3,0,Friendly,in Macedonia,20,-20,1445,1555,5,-5,96,71,1425,1575,T1
6939,March 28,2017,Luxembourg,Cape Verde,0,2,Friendly,in Luxembourg,-11,11,1232,1443,1,0,149,99,1243,1432,T2
6940,March 28,2017,Iceland,Ireland,1,0,Friendly,in Ireland,13,-13,1783,1781,2,-4,22,24,1770,1794,T2
6941,March 28,2017,Guyana,Martinique,0,0,Friendly,in Guyana,5,-5,1198,1481,0,1,165,85,1193,1486,draw
6942,March 28,2017,Guinea,Cameroon,2,1,Friendly,in Belgium,15,-15,1510,1685,2,-2,83,40,1495,1700,T1
6943,March 28,2017,Georgia,Latvia,5,0,Friendly,in Georgia,12,-12,1466,1401,5,-2,89,107,1454,1413,T1
6944,March 28,2017,France,Spain,0,2,Friendly,in France,-20,20,1991,2005,-1,2,5,3,2011,1985,T2
6945,March 28,2017,Estonia,Croatia,3,0,Friendly,in Estonia,31,-31,1473,1858,10,-3,87,16,1442,1889,T1
6946,March 28,2017,Togo,Egypt,0,3,Friendly,in Egypt,-3,3,1392,1685,0,3,109,40,1395,1682,T1
6947,March 28,2017,Finland,Austria,1,1,Friendly,in Austria,6,-6,1550,1685,2,1,72,40,1544,1691,draw
6948,March 28,2017,Albania,Bosnia and Herzegovina,1,2,Friendly,in Albania,-8,8,1569,1764,-1,2,66,29,1577,1756,T2
6949,March 28,2017,Yemen,Tajikistan,2,1,Asian Cup qualifier,in Qatar,23,-23,1222,1230,8,-3,155,151,1199,1253,T1
6950,March 28,2017,Philippines,Nepal,4,1,Asian Cup qualifier,in the Philippines,6,-6,1223,896,4,0,154,201,1217,902,T1
6951,March 28,2017,Bahrain,Singapore,0,0,Asian Cup qualifier,in Bahrain,-17,17,1404,1120,-3,3,106,175,1421,1103,draw
6952,March 28,2017,Bhutan,Oman,0,14,Asian Cup qualifier,in Oman,-1,1,608,1466,0,-1,229,89,609,1465,T1
6953,March 28,2017,Maldives,Palestine,0,3,Asian Cup qualifier,in the Maldives,-11,11,941,1353,-4,2,197,119,952,1342,T2
6954,March 28,2017,Jordan,Cambodia,7,0,Asian Cup qualifier,in Jordan,1,-1,1512,798,1,1,81,210,1511,799,T1
6955,March 28,2017,Afghanistan,Vietnam,1,1,Asian Cup qualifier,in Tajikistan,7,-7,1156,1268,0,-4,170,145,1149,1275,draw
6956,March 28,2017,Hong Kong,Lebanon,0,2,Asian Cup qualifier,in Lebanon,-10,10,1183,1383,-2,3,167,113,1193,1373,T1
6957,March 28,2017,Macao,Kyrgyzstan,0,1,Asian Cup qualifier,in Kyrgyzstan,-1,1,685,1228,-1,1,222,152,686,1227,T1
6958,March 28,2017,India,Myanmar,1,0,Asian Cup qualifier,in Myanmar,24,-24,1130,1057,1,-3,174,185,1106,1081,T2
6959,March 28,2017,South Sudan,Djibouti,6,0,African Nations Cup qualifier,in South Sudan,9,-9,1074,791,2,-2,183,212,1065,800,T1
6960,March 28,2017,Comoros,Mauritius,1,1,African Nations Cup qualifier,in Mauritius,8,-8,1020,1059,0,0,187,184,1012,1067,draw
6961,March 28,2017,Fiji,New Zealand,0,2,World Cup qualifier,in New Zealand,-4,4,1221,1567,-3,2,157,67,1225,1563,T1
6962,March 28,2017,Qatar,Uzbekistan,0,1,World Cup qualifier,in Uzbekistan,-9,9,1520,1644,-3,0,79,53,1529,1635,T1
6963,March 28,2017,Syria,South Korea,0,1,World Cup qualifier,in South Korea,-6,6,1565,1767,0,0,68,28,1571,1761,T1
6964,March 28,2017,Saudi Arabia,Iraq,1,0,World Cup qualifier,in Saudi Arabia,9,-9,1622,1491,1,0,57,84,1613,1500,T1
6965,March 28,2017,Japan,Thailand,4,0,World Cup qualifier,in Japan,4,-4,1782,1388,-1,-1,23,111,1778,1392,T1
6966,March 28,2017,China,Iran,0,1,World Cup qualifier,in Iran,-5,5,1541,1774,-1,1,74,25,1546,1769,T1
6967,March 28,2017,Australia,United Arab Emirates,2,0,World Cup qualifier,in Australia,12,-12,1710,1549,3,-2,37,73,1698,1561,T1
6968,March 28,2017,Haiti,Nicaragua,0,3,CONCACAF Championship qualifier,in Nicaragua,-49,49,1473,1321,-7,16,87,127,1522,1272,T1
6969,March 28,2017,Mexico,Trinidad and Tobago,1,0,World Cup qualifier,in Trinidad and Tobago,4,-4,1934,1457,0,-3,9,94,1930,1461,T2
6970,March 28,2017,Panama,United States,1,1,World Cup qualifier,in Panama,1,-1,1645,1753,-1,0,52,32,1644,1754,draw
6971,March 28,2017,Honduras,Costa Rica,1,1,World Cup qualifier,in Honduras,5,-5,1597,1769,0,-3,62,26,1592,1774,draw
6972,March 28,2017,Peru,Uruguay,2,1,World Cup qualifier,in Peru,18,-18,1848,1870,2,1,17,13,1830,1888,T1
6973,March 28,2017,Colombia,Ecuador,2,0,World Cup qualifier,in Ecuador,30,-30,1960,1801,2,-1,7,19,1930,1831,T2
6974,March 28,2017,Venezuela,Chile,1,3,World Cup qualifier,in Chile,-6,6,1681,1980,-2,0,44,6,1687,1974,T1
6975,March 28,2017,Brazil,Paraguay,3,0,World Cup qualifier,in Brazil,4,-4,2123,1721,0,0,1,34,2119,1725,T1
6976,March 28,2017,Argentina,Bolivia,0,2,World Cup qualifier,in Bolivia,-52,52,2005,1681,-1,11,3,44,2057,1629,T1
6977,March 28,2017,Tahiti,Papua New Guinea,1,2,World Cup qualifier,in Tahiti,-32,32,1221,1131,-9,6,157,173,1253,1099,T2
6978,April 26,2017,Guadeloupe,Martinique,1,4,Friendly,in Martinique,-5,5,1275,1486,0,0,141,85,1280,1481,T1
6979,April 29,2017,Monaco,Vatican,0,0,Friendly,in Italy,-6,6,903,692,-1,2,200,219,909,686,draw
6980,April 29,2017,Grenada,Trinidad and Tobago,2,2,Friendly,in Grenada,6,-6,1126,1451,0,-1,175,95,1120,1457,draw
6981,May 6,2017,Saint Kitts and Nevis,Barbados,2,1,Friendly,in Saint Kitts and Nevis,4,-4,1270,1145,3,0,143,171,1266,1149,T1
6982,May 17,2017,Guadeloupe,Dominica,2,2,Friendly,in Guadeloupe,-8,8,1267,966,-5,0,146,191,1275,958,draw
6983,May 25,2017,Fiji,Solomon Islands,1,1,Friendly,in Fiji,-5,5,1216,1139,-2,0,159,172,1221,1134,draw
6984,May 26,2017,Lesotho,Swaziland,0,1,Friendly,in Swaziland,-4,4,1210,1339,-1,0,162,122,1214,1335,T1
6985,May 27,2017,Honduras,El Salvador,2,2,Friendly,in the United States,-5,5,1592,1431,0,0,62,101,1597,1426,draw
6986,May 27,2017,Mexico,Croatia,1,2,Friendly,in the United States,-12,12,1922,1870,-2,3,11,13,1934,1858,T1
6987,May 28,2017,Swaziland,Lesotho,0,1,Friendly,in Swaziland,-16,16,1323,1226,-4,9,126,153,1339,1210,T2
6988,May 28,2017,Fiji,Solomon Islands,1,0,Friendly,in Fiji,5,-5,1221,1134,1,0,158,172,1216,1139,T1
6989,May 31,2017,Morocco,Netherlands,1,2,Friendly,in Morocco,-7,7,1613,1840,0,0,58,18,1620,1833,T2
6990,May 31,2017,San Marino,Italy,0,8,Friendly,in Italy,0,0,859,1958,0,0,204,8,859,1958,T1
6991,June 1,2017,Switzerland,Belarus,1,0,Friendly,in Switzerland,2,-2,1861,1553,0,0,16,71,1859,1555,T1
6992,June 1,2017,Togo,Nigeria,0,3,Friendly,in France,-6,6,1386,1674,-2,2,111,48,1392,1668,T1
6993,June 1,2017,Jordan,Iraq,0,1,Friendly,in Iraq,-8,8,1504,1499,-2,0,83,84,1512,1491,T1
6994,June 1,2017,Mexico,Ireland,3,1,Friendly,in the United States,9,-9,1931,1772,2,-1,9,25,1922,1781,T1
6995,June 2,2017,Syria,Oman,1,1,Friendly,in Oman,0,0,1565,1466,1,0,67,89,1565,1466,draw
6996,June 2,2017,Northern Ireland,New Zealand,1,0,Friendly,in Northern Ireland,5,-5,1668,1562,0,-1,51,68,1663,1567,T1
6997,June 2,2017,France,Paraguay,5,0,Friendly,in France,4,-4,1995,1717,0,-1,5,35,1991,1721,T1
6998,June 2,2017,Bolivia,Nicaragua,1,0,Friendly,in Nicaragua,4,-4,1685,1317,4,-1,40,128,1681,1321,T2
6999,June 2,2017,Chile,Burkina Faso,3,0,Friendly,in Chile,2,-2,1982,1607,0,0,6,59,1980,1609,T1
7000,June 3,2017,Uganda,Ethiopia,0,0,Friendly,in Ethiopia,-2,2,1460,1303,-1,0,92,133,1462,1301,draw
7001,June 3,2017,Portugal,Cyprus,4,0,Friendly,in Portugal,1,-1,1924,1412,0,0,11,104,1923,1413,T1
7002,June 3,2017,United States,Venezuela,1,1,Friendly,in the United States,-5,5,1748,1686,0,5,32,40,1753,1681,draw
7003,June 4,2017,Comoros,Togo,0,2,Friendly,in France,-3,3,1017,1389,0,1,187,110,1020,1386,T1
7004,June 4,2017,Ivory Coast,Netherlands,0,5,Friendly,in the Netherlands,-8,8,1691,1848,0,1,39,17,1699,1840,T1
7005,June 4,2017,Montenegro,Iran,1,2,Friendly,in Montenegro,-7,7,1578,1781,-1,-1,64,25,1585,1774,T2
7006,June 4,2017,Luxembourg,Albania,2,1,Friendly,in Luxembourg,16,-16,1248,1553,1,-4,148,70,1232,1569,T1
7007,June 4,2017,Mauritania,Lesotho,0,1,Friendly,in South Africa,-13,13,1308,1239,-3,4,130,149,1321,1226,T1
7008,June 4,2017,Uruguay,Ireland,1,3,Friendly,in Ireland,-15,15,1855,1787,-3,4,16,21,1870,1772,T1
7009,June 4,2017,Gabon,Zambia,0,0,Friendly,in Gabon,-3,3,1442,1448,-3,0,99,96,1445,1445,draw
7010,June 4,2017,Saint Kitts and Nevis,Armenia,0,5,Friendly,in Armenia,-5,5,1265,1521,-4,1,146,79,1270,1516,T1
7011,June 5,2017,Senegal,Uganda,0,0,Friendly,in Senegal,-8,8,1704,1468,-1,3,37,89,1712,1460,draw
7012,June 5,2017,Macedonia,Turkey,0,0,Friendly,in Macedonia,6,-6,1451,1788,2,0,95,20,1445,1794,draw
7013,June 5,2017,Sierra Leone,Liberia,0,1,Friendly,in Liberia,-9,9,1363,1325,0,3,117,125,1372,1316,T1
7014,June 5,2017,Hungary,Russia,0,3,Friendly,in Hungary,-23,23,1659,1697,-6,9,51,39,1682,1674,T2
7015,June 5,2017,Libya,Egypt,0,1,Friendly,in Egypt,-3,3,1459,1688,-1,0,92,41,1462,1685,T1
7016,June 5,2017,Botswana,Democratic Republic of Congo,0,2,Friendly,in Morocco,-5,5,1279,1589,0,0,140,63,1284,1584,T1
7017,June 5,2017,Czechia,Belgium,1,2,Friendly,in Belgium,-3,3,1700,1891,0,0,38,12,1703,1888,T1
7018,June 6,2017,Uzbekistan,Thailand,2,0,Friendly,in Uzbekistan,3,-3,1647,1385,1,0,52,111,1644,1388,T1
7019,June 6,2017,Malta,Ukraine,1,0,Friendly,in Austria,19,-19,1230,1740,10,-3,152,33,1211,1759,T2
7020,June 6,2017,Singapore,Myanmar,1,1,Friendly,in Singapore,-4,4,1116,1061,0,1,176,184,1120,1057,draw
7021,June 6,2017,Qatar,North Korea,2,2,Friendly,in Qatar,-3,3,1517,1527,0,1,80,76,1520,1524,draw
7022,June 6,2017,Moldova,Israel,1,1,Friendly,in Israel,8,-8,1354,1615,1,-1,119,57,1346,1623,draw
7023,June 6,2017,Nepal,India,0,2,Friendly,in India,-4,4,892,1134,0,2,201,172,896,1130,T1
7024,June 6,2017,Denmark,Germany,1,1,Friendly,in Denmark,6,-6,1727,2041,0,0,34,2,1721,2047,draw
7025,June 6,2017,Palestine,Bahrain,2,0,Friendly,in Bahrain,21,-21,1374,1383,3,-6,116,112,1353,1404,T2
7026,June 6,2017,Guinea,Algeria,1,2,Friendly,in Algeria,-5,5,1505,1609,0,1,82,59,1510,1604,T1
7027,June 6,2017,Maldives,Afghanistan,1,2,Friendly,in the United Arab Emirates,-4,4,937,1160,0,2,197,168,941,1156,T1
7028,June 7,2017,New Caledonia,Fiji,2,2,World Cup qualifier,in Fiji,0,0,1324,1221,0,1,126,158,1324,1221,draw
7029,June 7,2017,United Arab Emirates,Laos,4,0,Friendly,in Malaysia,1,-1,1550,804,1,0,72,209,1549,805,T1
7030,June 7,2017,Spain,Colombia,2,2,Friendly,in Spain,-4,4,2001,1964,-1,-1,4,8,2005,1960,draw
7031,June 7,2017,Syria,Japan,1,1,Friendly,in Japan,7,-7,1572,1775,0,-1,66,25,1565,1782,draw
7032,June 7,2017,Italy,Uruguay,3,0,Friendly,in France,12,-12,1970,1843,1,-2,7,18,1958,1855,T1
7033,June 7,2017,Iraq,South Korea,0,0,Friendly,in the United Arab Emirates,6,-6,1505,1761,2,-1,82,29,1499,1767,draw
7034,June 7,2017,Jordan,Hong Kong,0,0,Friendly,in Hong Kong,-6,6,1498,1189,-1,0,84,167,1504,1183,draw
7035,June 7,2017,Gambia,Ghana,1,2,Friendly,in Ghana,-2,2,1288,1574,-1,0,136,65,1290,1572,T1
7036,June 7,2017,Saint Kitts and Nevis,Georgia,0,3,Friendly,in Georgia,-5,5,1260,1471,0,1,146,89,1265,1466,T1
7037,June 7,2017,Finland,Liechtenstein,1,1,Friendly,in Finland,-9,9,1541,1166,-2,2,74,168,1550,1157,draw
7038,June 7,2017,Philippines,China,1,8,Friendly,in China,-4,4,1219,1545,-4,1,160,73,1223,1541,T1
7039,June 7,2017,Nicaragua,Bolivia,2,3,Friendly,in Bolivia,-1,1,1316,1686,0,1,128,42,1317,1685,T1
7040,June 8,2017,Cambodia,Indonesia,0,2,Friendly,in Cambodia,-4,4,794,1235,-1,0,211,151,798,1231,T2
7041,June 8,2017,Australia,Saudi Arabia,3,2,World Cup qualifier,in Australia,10,-10,1720,1612,1,-2,35,58,1710,1622,T1
7042,June 8,2017,Peru,Paraguay,1,0,Friendly,in Peru,4,-4,1852,1713,0,-1,16,36,1848,1717,T1
7043,June 8,2017,Bermuda,Grenada,2,2,Friendly,in Grenada,1,-1,1200,1125,0,0,164,175,1199,1126,draw
7044,June 8,2017,Ecuador,Venezuela,1,1,Friendly,in the United States,-3,3,1798,1689,0,1,19,41,1801,1686,draw
7045,June 8,2017,United States,Trinidad and Tobago,2,0,World Cup qualifier,in the United States,6,-6,1754,1445,0,-2,31,97,1748,1451,T1
7046,June 8,2017,Mexico,Honduras,3,0,World Cup qualifier,in Mexico,5,-5,1936,1587,0,-1,9,63,1931,1592,T1
7047,June 8,2017,Panama,Costa Rica,0,0,World Cup qualifier,in Costa Rica,11,-11,1656,1758,1,-3,52,29,1645,1769,draw
7048,June 9,2017,Russia,Chile,1,1,Friendly,in Russia,5,-5,1702,1977,1,1,38,5,1697,1982,draw
7049,June 9,2017,Argentina,Brazil,1,0,Friendly,in Australia,13,-13,2018,2110,0,0,3,1,2005,2123,T1
7050,June 9,2017,Madagascar,Sudan,3,1,African Nations Cup qualifier,in Sudan,40,-40,1309,1245,13,-11,129,148,1269,1285,T2
7051,June 9,2017,Libya,Seychelles,5,1,African Nations Cup qualifier,in Egypt,4,-4,1463,954,0,0,92,192,1459,958,T1
7052,June 9,2017,Papua New Guinea,Solomon Islands,2,3,World Cup qualifier,in the Solomon Islands,-14,14,1117,1148,-1,1,175,171,1131,1134,T1
7053,June 9,2017,France,Sweden,1,2,World Cup qualifier,in Sweden,-26,26,1969,1813,-2,2,7,19,1995,1787,T1
7054,June 9,2017,Netherlands,Luxembourg,5,0,World Cup qualifier,in the Netherlands,1,-1,1849,1247,0,1,17,147,1848,1248,T1
7055,June 9,2017,Portugal,Latvia,3,0,World Cup qualifier,in Latvia,6,-6,1930,1395,1,-1,10,107,1924,1401,T2
7056,June 9,2017,Faroe Islands,Switzerland,0,2,World Cup qualifier,in the Faroe Islands,-4,4,1281,1865,-2,1,139,14,1285,1861,T2
7057,June 9,2017,Belgium,Estonia,2,0,World Cup qualifier,in Estonia,8,-8,1899,1465,0,-4,12,91,1891,1473,T2
7058,June 9,2017,Cyprus,Gibraltar,2,1,World Cup qualifier,in Portugal,6,-6,1418,1090,1,0,103,180,1412,1096,T1
7059,June 9,2017,Bosnia and Herzegovina,Greece,0,0,World Cup qualifier,in Bosnia and Herzegovina,-10,10,1754,1679,-3,3,30,46,1764,1669,draw
7060,June 9,2017,Belarus,Bulgaria,2,1,World Cup qualifier,in Belarus,19,-19,1572,1614,4,-1,66,56,1553,1633,T1
7061,June 9,2017,Hungary,Andorra,0,1,World Cup qualifier,in Andorra,-39,39,1620,1023,-3,4,54,186,1659,984,T1
7062,June 10,2017,Taiwan,Singapore,2,1,Asian Cup qualifier,in Singapore,36,-36,888,1080,3,-5,202,181,852,1116,T2
7063,June 10,2017,Zambia,Mozambique,0,1,African Nations Cup qualifier,in Zambia,-31,31,1417,1364,-7,6,103,118,1448,1333,T2
7064,June 10,2017,Tanzania,Lesotho,1,1,African Nations Cup qualifier,in Tanzania,-10,10,1325,1249,-4,2,126,147,1335,1239,draw
7065,June 10,2017,Sierra Leone,Kenya,2,1,African Nations Cup qualifier,in Sierra Leone,16,-16,1379,1385,3,-4,115,110,1363,1401,T1
7066,June 10,2017,Equatorial Guinea,Senegal,0,3,African Nations Cup qualifier,in Senegal,-5,5,1341,1709,-1,0,122,37,1346,1704,T1
7067,June 10,2017,Nigeria,South Africa,0,2,African Nations Cup qualifier,in Nigeria,-44,44,1630,1645,-5,9,54,52,1674,1601,T2
7068,June 10,2017,Niger,Swaziland,0,0,African Nations Cup qualifier,in Niger,-4,4,1289,1327,-1,2,136,125,1293,1323,draw
7069,June 10,2017,Mali,Gabon,2,1,African Nations Cup qualifier,in Mali,10,-10,1533,1432,2,1,76,98,1523,1442,T1
7070,June 10,2017,Malawi,Comoros,1,0,African Nations Cup qualifier,in Malawi,3,-3,1338,1014,-1,0,123,188,1335,1017,T1
7071,June 10,2017,Ivory Coast,Guinea,2,3,African Nations Cup qualifier,in Ivory Coast,-34,34,1657,1539,-9,7,49,75,1691,1505,T2
7072,June 10,2017,Namibia,Guinea-Bissau,0,1,African Nations Cup qualifier,in Guinea-Bissau,-20,20,1354,1293,-3,6,119,135,1374,1273,T1
7073,June 10,2017,Democratic Republic of Congo,Congo,3,1,African Nations Cup qualifier,in the Democratic Republic of the Congo,10,-10,1599,1408,0,-1,62,104,1589,1418,T1
7074,June 10,2017,Cameroon,Morocco,1,0,African Nations Cup qualifier,in Cameroon,11,-11,1696,1602,4,-4,40,61,1685,1613,T1
7075,June 10,2017,Burundi,South Sudan,3,0,African Nations Cup qualifier,in Burundi,9,-9,1314,1065,3,0,130,183,1305,1074,T1
7076,June 10,2017,Angola,Burkina Faso,1,3,African Nations Cup qualifier,in Burkina Faso,-3,3,1219,1610,-3,1,159,59,1222,1607,T1
7077,June 10,2017,Mauritania,Botswana,1,0,African Nations Cup qualifier,in Botswana,24,-24,1332,1255,7,-6,124,146,1308,1279,T2
7078,June 10,2017,Malta,Slovenia,0,2,World Cup qualifier,in Slovenia,-3,3,1227,1642,-2,0,154,53,1230,1639,T1
7079,June 10,2017,Scotland,England,2,2,World Cup qualifier,in Scotland,8,-8,1686,1918,4,0,43,11,1678,1926,draw
7080,June 10,2017,Poland,Romania,3,1,World Cup qualifier,in Poland,10,-10,1873,1668,2,-1,13,48,1863,1678,T1
7081,June 10,2017,Czechia,Norway,1,1,World Cup qualifier,in Norway,-2,2,1698,1563,0,1,39,68,1700,1561,draw
7082,June 10,2017,Montenegro,Armenia,4,1,World Cup qualifier,in Montenegro,20,-20,1598,1501,1,-4,63,83,1578,1521,T1
7083,June 10,2017,Lithuania,Slovakia,1,2,World Cup qualifier,in Lithuania,-10,10,1448,1767,-2,2,95,27,1458,1757,T2
7084,June 10,2017,Kazakhstan,Denmark,1,3,World Cup qualifier,in Kazakhstan,-12,12,1369,1739,-3,0,117,34,1381,1727,T2
7085,June 10,2017,Germany,San Marino,7,0,World Cup qualifier,in Germany,0,0,2041,859,0,-1,2,205,2041,859,T1
7086,June 10,2017,Azerbaijan,Northern Ireland,0,1,World Cup qualifier,in Azerbaijan,-13,13,1424,1681,0,4,100,46,1437,1668,T2
7087,June 10,2017,Grenada,Bermuda,1,2,Friendly,in Grenada,-11,11,1114,1211,-1,1,175,163,1125,1200,T2
7088,June 11,2017,Liberia,Zimbabwe,0,3,African Nations Cup qualifier,in Zimbabwe,-18,18,1307,1423,-6,4,132,101,1325,1405,T1
7089,June 11,2017,Egypt,Tunisia,0,1,African Nations Cup qualifier,in Tunisia,-22,22,1666,1578,-6,4,48,66,1688,1556,T1
7090,June 11,2017,Ghana,Ethiopia,5,0,African Nations Cup qualifier,in Ghana,8,-8,1582,1295,0,0,65,134,1574,1303,T1
7091,June 11,2017,Rwanda,Central African Republic,1,2,African Nations Cup qualifier,in Central African Republic,-16,16,1292,1301,-3,6,136,133,1308,1285,T1
7092,June 11,2017,Cape Verde,Uganda,0,1,African Nations Cup qualifier,in Cape Verde,-24,24,1419,1492,-5,4,102,85,1443,1468,T2
7093,June 11,2017,Gambia,Benin,0,1,African Nations Cup qualifier,in Benin,-10,10,1278,1396,-2,3,140,106,1288,1386,T1
7094,June 11,2017,Togo,Algeria,0,1,African Nations Cup qualifier,in Algeria,-5,5,1384,1614,-2,4,110,56,1389,1609,T1
7095,June 11,2017,New Caledonia,Fiji,2,1,World Cup qualifier,in New Caledonia,9,-9,1333,1212,4,-5,124,162,1324,1221,T1
7096,June 11,2017,Wales,Serbia,1,1,World Cup qualifier,in Serbia,4,-4,1772,1741,0,-1,26,33,1768,1745,draw
7097,June 11,2017,Moldova,Georgia,2,2,World Cup qualifier,in Moldova,1,-1,1355,1470,0,-1,119,89,1354,1471,draw
7098,June 11,2017,Macedonia,Spain,1,2,World Cup qualifier,in Macedonia,-3,3,1448,2004,0,0,94,4,1451,2001,T2
7099,June 11,2017,Turkey,Kosovo,4,1,World Cup qualifier,in Albania,6,-6,1794,1384,-1,-3,22,110,1788,1390,T2
7100,June 11,2017,Liechtenstein,Italy,0,5,World Cup qualifier,in Italy,0,0,1166,1970,0,0,168,6,1166,1970,T1
7101,June 11,2017,Albania,Israel,3,0,World Cup qualifier,in Israel,50,-50,1603,1565,11,-13,60,69,1553,1615,T2
7102,June 11,2017,Ireland,Austria,1,1,World Cup qualifier,in Ireland,-10,10,1777,1695,-2,4,24,41,1787,1685,draw
7103,June 11,2017,Croatia,Iceland,0,1,World Cup qualifier,in Iceland,-19,19,1851,1802,-2,3,16,20,1870,1783,T1
7104,June 11,2017,Ukraine,Finland,2,1,World Cup qualifier,in Finland,14,-14,1754,1527,2,-3,31,77,1740,1541,T2
7105,June 11,2017,United States,Mexico,1,1,World Cup qualifier,in Mexico,13,-13,1767,1923,3,-1,27,10,1754,1936,draw
7106,June 12,2017,Latvia,Estonia,1,2,Friendly,in Latvia,-11,11,1384,1476,-2,4,109,87,1395,1465,T2
7107,June 12,2017,New Zealand,Belarus,0,1,Friendly,in Belarus,-7,7,1555,1579,0,1,71,66,1562,1572,T1
7108,June 12,2017,Iran,Uzbekistan,2,0,World Cup qualifier,in Iran,12,-12,1793,1635,0,-2,23,53,1781,1647,T1
7109,June 13,2017,South Africa,Zambia,1,2,Friendly,in South Africa,-17,17,1628,1434,-3,7,54,97,1645,1417,T2
7110,June 13,2017,Argentina,Singapore,6,0,Friendly,in Singapore,0,0,2018,1080,0,0,3,181,2018,1080,T2
7111,June 13,2017,Chile,Romania,2,3,Friendly,in Romania,-15,15,1962,1683,-3,2,8,45,1977,1668,T1
7112,June 13,2017,Peru,Jamaica,3,1,Friendly,in Peru,2,-2,1854,1524,0,0,15,79,1852,1526,T1
7113,June 13,2017,Sweden,Norway,1,1,Friendly,in Norway,-4,4,1809,1567,0,1,19,69,1813,1563,draw
7114,June 13,2017,Puerto Rico,Indonesia,0,0,Friendly,in Indonesia,7,-7,1029,1228,1,-1,186,152,1022,1235,draw
7115,June 13,2017,France,England,3,2,Friendly,in France,6,-6,1975,1912,2,0,5,11,1969,1918,T1
7116,June 13,2017,El Salvador,Ecuador,0,3,Friendly,in the United States,-4,4,1427,1802,-1,1,99,20,1431,1798,T1
7117,June 13,2017,Colombia,Cameroon,4,0,Friendly,in Spain,7,-7,1971,1689,2,-1,6,41,1964,1696,T1
7118,June 13,2017,Curaçao,Canada,1,2,Friendly,in Canada,-2,2,1222,1532,1,-1,154,77,1224,1530,T1
7119,June 13,2017,Brazil,Australia,4,0,Friendly,in Australia,6,-6,2116,1714,0,0,1,35,2110,1720,T2
7120,June 13,2017,Jordan,Vietnam,0,0,Asian Cup qualifier,in Vietnam,-7,7,1491,1275,-1,1,85,141,1498,1268,draw
7121,June 13,2017,Bahrain,Turkmenistan,2,1,Asian Cup qualifier,in Turkmenistan,19,-19,1402,1250,6,-5,106,146,1383,1269,T2
7122,June 13,2017,Philippines,Tajikistan,4,3,Asian Cup qualifier,in Tajikistan,26,-26,1245,1204,9,-12,149,164,1219,1230,T2
7123,June 13,2017,Oman,Palestine,1,2,Asian Cup qualifier,in Palestine,-20,20,1446,1394,-4,8,95,108,1466,1374,T1
7124,June 13,2017,Yemen,Nepal,0,0,Asian Cup qualifier,in Nepal,-12,12,1210,904,-5,1,161,200,1222,892,draw
7125,June 13,2017,Lebanon,Malaysia,2,1,Asian Cup qualifier,in Malaysia,11,-11,1394,1100,4,-1,108,177,1383,1111,T2
7126,June 13,2017,Myanmar,Macao,4,0,Asian Cup qualifier,in Macao,13,-13,1074,672,1,-1,183,223,1061,685,T2
7127,June 13,2017,Kyrgyzstan,India,0,1,Asian Cup qualifier,in India,-20,20,1208,1154,-9,2,162,171,1228,1134,T1
7128,June 13,2017,Hong Kong,North Korea,1,1,Asian Cup qualifier,in Hong Kong,12,-12,1201,1515,2,-4,165,81,1189,1527,draw
7129,June 13,2017,Afghanistan,Cambodia,0,1,Asian Cup qualifier,in Cambodia,-33,33,1127,827,-4,3,173,208,1160,794,T1
7130,June 13,2017,Bhutan,Maldives,0,2,Asian Cup qualifier,in Bhutan,-13,13,595,950,-1,4,230,193,608,937,T2
7131,June 13,2017,Solomon Islands,Papua New Guinea,2,1,World Cup qualifier,in Papua New Guinea,24,-24,1172,1093,3,-4,168,178,1148,1117,T2
7132,June 13,2017,Thailand,United Arab Emirates,1,1,World Cup qualifier,in Thailand,4,-4,1389,1546,-3,-1,110,73,1385,1550,draw
7133,June 13,2017,Syria,China,2,2,World Cup qualifier,in Malaysia,-2,2,1570,1547,0,1,68,72,1572,1545,draw
7134,June 13,2017,South Korea,Qatar,2,3,World Cup qualifier,in Qatar,-28,28,1733,1545,-5,6,34,74,1761,1517,T1
7135,June 13,2017,Iraq,Japan,1,1,World Cup qualifier,in Iran,13,-13,1518,1762,2,-3,80,28,1505,1775,draw
7136,June 13,2017,Panama,Honduras,2,2,World Cup qualifier,in Panama,-9,9,1647,1596,0,0,50,64,1656,1587,draw
7137,June 13,2017,Trinidad and Tobago,Costa Rica,1,2,World Cup qualifier,in Costa Rica,-3,3,1442,1761,0,1,96,29,1445,1758,T1
7138,June 17,2017,French Guiana,Barbados,3,0,Friendly,in French Guiana,5,-5,1359,1140,1,0,119,172,1354,1145,T1
7139,June 17,2017,Curaçao,Nicaragua,0,0,Friendly,in Curaçao,0,0,1222,1316,0,0,154,128,1222,1316,draw
7140,June 17,2017,New Zealand,Russia,0,2,Confederations Cup,in Russia,-15,15,1540,1717,-3,3,74,35,1555,1702,T1
7141,June 18,2017,Cameroon,Chile,0,2,Confederations Cup,in Russia,-13,13,1676,1975,-6,3,47,5,1689,1962,T1
7142,June 18,2017,Portugal,Mexico,2,2,Confederations Cup,in Russia,-1,1,1929,1924,0,0,9,10,1930,1923,draw
7143,June 19,2017,Germany,Australia,3,2,Confederations Cup,in Russia,7,-7,2048,1707,0,-2,2,38,2041,1714,T1
7144,June 21,2017,Russia,Portugal,0,1,Confederations Cup,in Russia,-17,17,1700,1946,-3,0,38,9,1717,1929,T2
7145,June 21,2017,Mexico,New Zealand,2,1,Confederations Cup,in Russia,5,-5,1929,1535,0,-1,10,75,1924,1540,T1
7146,June 22,2017,Chile,Germany,1,1,Confederations Cup,in Russia,5,-5,1980,2043,0,0,5,2,1975,2048,draw
7147,June 22,2017,Cameroon,Australia,1,1,Confederations Cup,in Russia,2,-2,1678,1705,0,0,47,37,1676,1707,draw
7148,June 22,2017,Curaçao,Martinique,2,1,Caribbean Championship,in Martinique,36,-36,1258,1450,10,-6,144,92,1222,1486,T2
7149,June 22,2017,French Guiana,Jamaica,1,1,Caribbean Championship,in Martinique,9,-9,1368,1515,1,-1,118,80,1359,1524,draw
7150,June 24,2017,Mexico,Russia,2,1,Confederations Cup,in Russia,16,-16,1945,1684,0,-5,10,43,1929,1700,T2
7151,June 24,2017,New Zealand,Portugal,0,4,Confederations Cup,in Russia,-8,8,1527,1954,-2,0,77,9,1535,1946,T1
7152,June 25,2017,Malawi,Tanzania,0,2,COSAFA Cup,in South Africa,-31,31,1307,1356,-8,7,131,120,1338,1325,T1
7153,June 25,2017,Angola,Mauritius,1,0,COSAFA Cup,in South Africa,11,-11,1230,1048,3,0,153,185,1219,1059,T1
7154,June 25,2017,Cameroon,Germany,1,3,Confederations Cup,in Russia,-8,8,1670,2051,0,0,47,2,1678,2043,T1
7155,June 25,2017,Australia,Chile,1,1,Confederations Cup,in Russia,16,-16,1721,1964,2,-3,35,8,1705,1980,draw
7156,June 25,2017,Martinique,French Guiana,0,1,Caribbean Championship,in Martinique,-30,30,1420,1398,-10,11,102,107,1450,1368,T2
7157,June 25,2017,Jamaica,Curaçao,1,2,Caribbean Championship,in Martinique,-33,33,1482,1291,-5,7,85,137,1515,1258,T1
7158,June 26,2017,Zimbabwe,Mozambique,4,0,COSAFA Cup,in South Africa,31,-31,1454,1333,9,-4,92,123,1423,1364,T1
7159,June 26,2017,Madagascar,Seychelles,2,0,COSAFA Cup,in South Africa,7,-7,1316,947,2,-2,127,194,1309,954,T1
7160,June 27,2017,Malawi,Mauritius,0,0,COSAFA Cup,in South Africa,-13,13,1294,1061,-3,0,134,185,1307,1048,draw
7161,June 27,2017,Angola,Tanzania,0,0,COSAFA Cup,in South Africa,7,-7,1237,1349,0,-2,153,121,1230,1356,draw
7162,June 28,2017,Mozambique,Seychelles,2,1,COSAFA Cup,in South Africa,4,-4,1337,943,0,-3,123,197,1333,947,T1
7163,June 28,2017,Madagascar,Zimbabwe,0,0,COSAFA Cup,in South Africa,8,-8,1324,1446,0,-2,127,94,1316,1454,draw
7164,June 28,2017,Saint Vincent and the Grenadines,Saint Lucia,1,2,Windward Islands Championship,in Grenada,-15,15,1091,1120,-3,2,178,174,1106,1105,T1
7165,June 28,2017,Dominica,Grenada,1,1,Windward Islands Championship,in Grenada,9,-9,975,1105,0,-1,191,175,966,1114,draw
7166,June 28,2017,Ghana,Mexico,0,1,Friendly,in the United States,-2,2,1580,1947,0,0,65,10,1582,1945,T1
7167,June 28,2017,Chile,Portugal,0,0,Confederations Cup,in Russia,-1,1,1963,1955,0,0,8,9,1964,1954,draw
7168,June 29,2017,Mauritius,Tanzania,1,1,COSAFA Cup,in South Africa,14,-14,1075,1335,2,-2,183,123,1061,1349,draw
7169,June 29,2017,Angola,Malawi,0,0,COSAFA Cup,in South Africa,3,-3,1240,1291,1,-2,152,136,1237,1294,draw
7170,June 29,2017,Mexico,Germany,1,4,Confederations Cup,in Russia,-31,31,1916,2082,0,0,10,2,1947,2051,T1
7171,June 30,2017,Zimbabwe,Seychelles,6,0,COSAFA Cup,in South Africa,4,-4,1450,939,2,0,92,197,1446,943,T1
7172,June 30,2017,Madagascar,Mozambique,4,1,COSAFA Cup,in South Africa,36,-36,1360,1301,8,-9,119,131,1324,1337,T1
7173,June 30,2017,Saint Lucia,Grenada,0,2,Windward Islands Championship,in Grenada,-17,17,1103,1122,-1,2,175,173,1120,1105,T1
7174,June 30,2017,Barbados,Dominica,1,2,Windward Islands Championship,in Grenada,-22,22,1118,997,-2,1,174,190,1140,975,T1
7175,July 1,2017,Botswana,Zambia,1,2,COSAFA Cup,in South Africa,-11,11,1244,1445,-5,1,151,96,1255,1434,T1
7176,July 1,2017,Namibia,Lesotho,0,0,COSAFA Cup,in South Africa,-6,6,1348,1255,0,2,121,146,1354,1249,draw
7177,July 1,2017,United States,Ghana,2,1,Friendly,in the United States,3,-3,1770,1577,0,-2,26,67,1767,1580,T1
7178,July 1,2017,Paraguay,Mexico,1,2,Friendly,in the United States,-5,5,1708,1921,-1,0,37,10,1713,1916,T1
7179,July 2,2017,Swaziland,Zimbabwe,1,2,COSAFA Cup,in South Africa,-13,13,1314,1463,-1,2,127,90,1327,1450,T1
7180,July 2,2017,Tanzania,South Africa,1,0,COSAFA Cup,in South Africa,36,-36,1371,1592,5,-10,118,64,1335,1628,T2
7181,July 2,2017,Portugal,Mexico,2,1,Confederations Cup,in Russia,23,-23,1978,1898,4,-2,5,12,1955,1921,T1
7182,July 2,2017,Chile,Germany,0,1,Confederations Cup,in Russia,-17,17,1946,2099,-1,0,9,2,1963,2082,T1
7183,July 3,2017,Nicaragua,Canada,3,1,Friendly,in the United States,23,-23,1339,1509,2,-5,124,81,1316,1532,T1
7184,July 3,2017,Saint Vincent and the Grenadines,Grenada,3,4,Windward Islands Championship,in Grenada,-10,10,1081,1132,-2,1,180,172,1091,1122,T1
7185,July 3,2017,Barbados,Saint Lucia,1,1,Windward Islands Championship,in Grenada,-1,1,1117,1104,0,0,174,175,1118,1103,draw
7186,July 4,2017,Swaziland,Namibia,0,1,COSAFA Cup,in South Africa,-18,18,1296,1366,-5,2,132,120,1314,1348,T1
7187,July 4,2017,Botswana,South Africa,0,2,COSAFA Cup,in South Africa,-4,4,1240,1596,0,1,151,63,1244,1592,T1
7188,July 4,2017,Barbados,Saint Vincent and the Grenadines,2,4,Windward Islands Championship,in Grenada,-25,25,1092,1106,-4,6,178,174,1117,1081,T1
7189,July 4,2017,Dominica,Saint Lucia,0,0,Windward Islands Championship,in Grenada,4,-4,1001,1100,0,0,190,175,997,1104,draw
7190,July 5,2017,Lesotho,Zimbabwe,3,4,COSAFA Cup,in South Africa,-9,9,1246,1472,-2,1,148,89,1255,1463,T1
7191,July 5,2017,Tanzania,Zambia,2,4,COSAFA Cup,in South Africa,-24,24,1347,1469,-4,5,122,91,1371,1445,T1
7192,July 6,2017,Grenada,Barbados,0,2,Windward Islands Championship,in Grenada,-31,31,1101,1123,-3,5,175,173,1132,1092,T2
7193,July 6,2017,Saint Vincent and the Grenadines,Dominica,2,2,Windward Islands Championship,in Grenada,-4,4,1102,1005,0,1,174,189,1106,1001,draw
7194,July 7,2017,South Africa,Namibia,1,0,COSAFA Cup,in South Africa,5,-5,1601,1361,2,0,61,119,1596,1366,T1
7195,July 7,2017,Tanzania,Lesotho,0,0,COSAFA Cup,in South Africa,-6,6,1341,1252,0,2,122,146,1347,1246,draw
7196,July 7,2017,Costa Rica,Honduras,1,0,CONCACAF Championship,in the United States,14,-14,1775,1582,4,-1,25,64,1761,1596,T1
7197,July 7,2017,Canada,French Guiana,4,2,CONCACAF Championship,in the United States,26,-26,1535,1372,6,-10,75,117,1509,1398,T1
7198,July 8,2017,United States,Panama,1,1,CONCACAF Championship,in the United States,-14,14,1756,1661,-2,1,29,49,1770,1647,draw
7199,July 8,2017,Martinique,Nicaragua,2,0,CONCACAF Championship,in the United States,29,-29,1449,1310,8,-3,94,127,1420,1339,T1
7200,July 9,2017,Zambia,Zimbabwe,1,3,COSAFA Cup,in South Africa,-30,30,1439,1502,-7,7,98,82,1469,1472,T1
7201,July 9,2017,Mexico,El Salvador,3,1,CONCACAF Championship,in the United States,5,-5,1903,1422,1,-2,11,102,1898,1427,T1
7202,July 9,2017,Jamaica,Curaçao,2,0,CONCACAF Championship,in the United States,19,-19,1501,1272,2,-6,83,142,1482,1291,T1
7203,July 11,2017,Honduras,French Guiana,0,0,CONCACAF Championship,in the United States,-14,14,1568,1386,-4,6,68,111,1582,1372,draw
7204,July 11,2017,Canada,Costa Rica,1,1,CONCACAF Championship,in the United States,15,-15,1550,1760,4,-3,71,28,1535,1775,draw
7205,July 12,2017,Martinique,United States,2,3,CONCACAF Championship,in the United States,-4,4,1445,1760,-3,1,96,28,1449,1756,T1
7206,July 12,2017,Nicaragua,Panama,1,2,CONCACAF Championship,in the United States,-6,6,1304,1667,-2,1,129,48,1310,1661,T1
7207,July 13,2017,Mexico,Jamaica,0,0,CONCACAF Championship,in the United States,-21,21,1882,1522,-1,4,12,79,1903,1501,draw
7208,July 13,2017,El Salvador,Curaçao,2,0,CONCACAF Championship,in the United States,22,-22,1444,1250,5,-4,97,146,1422,1272,T1
7209,July 14,2017,Thailand,North Korea,3,0,King's Cup,in Thailand,28,-28,1417,1487,5,-5,105,86,1389,1515,T1
7210,July 14,2017,French Guiana,Costa Rica,0,3,CONCACAF Championship,in the United States,-9,9,1377,1769,-6,2,117,26,1386,1760,T1
7211,July 14,2017,Honduras,Canada,0,0,CONCACAF Championship,in the United States,-1,1,1567,1551,0,0,68,71,1568,1550,draw
7212,July 15,2017,United States,Nicaragua,3,0,CONCACAF Championship,in the United States,3,-3,1763,1301,1,0,28,129,1760,1304,T1
7213,July 15,2017,Panama,Martinique,3,0,CONCACAF Championship,in the United States,19,-19,1686,1426,7,-4,41,100,1667,1445,T1
7214,July 16,2017,Curaçao,Mexico,0,2,CONCACAF Championship,in the United States,-2,2,1248,1884,-1,0,147,12,1250,1882,T1
7215,July 16,2017,El Salvador,Jamaica,1,1,CONCACAF Championship,in the United States,6,-6,1450,1516,3,-1,93,80,1444,1522,draw
7216,July 19,2017,El Salvador,United States,0,2,CONCACAF Championship,in the United States,-6,6,1444,1769,-3,1,96,27,1450,1763,T1
7217,July 19,2017,Panama,Costa Rica,0,1,CONCACAF Championship,in the United States,-19,19,1667,1788,-7,2,48,24,1686,1769,T1
7218,July 20,2017,Mexico,Honduras,1,0,CONCACAF Championship,in the United States,7,-7,1891,1560,0,-2,12,70,1884,1567,T1
7219,July 20,2017,Canada,Jamaica,1,2,CONCACAF Championship,in the United States,-28,28,1523,1544,-8,6,79,74,1551,1516,T1
7220,July 22,2017,United States,Costa Rica,2,0,CONCACAF Championship,in the United States,29,-29,1798,1759,5,-5,22,29,1769,1788,T1
7221,July 23,2017,Mexico,Jamaica,0,1,CONCACAF Championship,in the United States,-44,44,1847,1588,-5,10,17,64,1891,1544,T1
7222,July 26,2017,Jamaica,United States,1,2,CONCACAF Championship,in the United States,-7,7,1581,1805,0,2,64,20,1588,1798,T1
7223,July 26,2017,Ecuador,Trinidad and Tobago,3,1,Friendly,in Ecuador,2,-2,1804,1440,-1,0,21,97,1802,1442,T1
7224,July 28,2017,Vanuatu,Solomon Islands,0,0,Friendly,in the Solomon Islands,2,-2,1193,1170,0,0,167,168,1191,1172,draw
7225,August 16,2017,Andorra,Qatar,0,1,Friendly,in England,-1,1,1022,1546,0,1,187,73,1023,1545,T1
7226,August 19,2017,India,Mauritius,2,1,Friendly tournament,in India,8,-8,1162,1067,1,-1,170,184,1154,1075,T1
7227,August 22,2017,Mauritius,Saint Kitts and Nevis,1,1,Friendly tournament,in India,8,-8,1075,1252,1,-1,183,144,1067,1260,draw
7228,August 22,2017,Malaysia,Syria,1,2,Friendly,in Malaysia,-2,2,1098,1572,-1,0,177,68,1100,1570,T2
7229,August 23,2017,Qatar,Turkmenistan,2,1,Friendly,in Qatar,2,-2,1548,1248,1,0,72,146,1546,1250,T1
7230,August 24,2017,Saint Kitts and Nevis,India,1,1,Friendly tournament,in India,0,0,1252,1162,0,0,144,170,1252,1162,draw
7231,August 24,2017,Jamaica,Trinidad and Tobago,2,1,Friendly,in Trinidad and Tobago,9,-9,1590,1431,0,-2,64,99,1581,1440,T2
7232,August 25,2017,Uzbekistan,Kyrgyzstan,5,0,Friendly,in Uzbekistan,2,-2,1637,1206,0,0,52,162,1635,1208,T1
7233,August 26,2017,Iraq,Syria,1,1,Friendly,in Malaysia,2,-2,1520,1570,0,0,80,68,1518,1572,draw
7234,August 29,2017,Myanmar,Malaysia,1,0,Friendly,in Myanmar,8,-8,1082,1090,4,-1,180,178,1074,1098,T1
7235,August 29,2017,Jordan,Bahrain,0,0,Friendly,in Bahrain,0,0,1491,1402,0,0,85,107,1491,1402,draw
7236,August 29,2017,Saudi Arabia,United Arab Emirates,1,2,World Cup qualifier,in the United Arab Emirates,-18,18,1594,1564,-6,3,63,71,1612,1546,T1
7237,August 30,2017,Afghanistan,Oman,0,2,Friendly,in Oman,-2,2,1125,1448,0,2,172,93,1127,1446,T1
7238,August 31,2017,Togo,Niger,2,0,Friendly,in Morocco,11,-11,1395,1278,3,-3,109,140,1384,1289,T1
7239,August 31,2017,Singapore,Hong Kong,1,1,Friendly,in Singapore,1,-1,1081,1200,0,0,182,165,1080,1201,draw
7240,August 31,2017,Iraq,Thailand,2,1,World Cup qualifier,in Thailand,20,-20,1540,1397,5,-2,75,107,1520,1417,T2
7241,August 31,2017,Syria,Qatar,3,1,World Cup qualifier,in Malaysia,28,-28,1598,1520,6,-7,62,80,1570,1548,T1
7242,August 31,2017,South Korea,Iran,0,0,World Cup qualifier,in South Korea,-2,2,1731,1795,0,2,34,22,1733,1793,draw
7243,August 31,2017,Australia,Japan,0,2,World Cup qualifier,in Japan,-18,18,1703,1780,-2,3,37,25,1721,1762,T1
7244,August 31,2017,China,Uzbekistan,1,0,World Cup qualifier,in China,19,-19,1566,1618,5,-3,69,55,1547,1637,T1
7245,August 31,2017,Uganda,Egypt,1,0,World Cup qualifier,in Uganda,24,-24,1516,1642,3,-1,81,50,1492,1666,T1
7246,August 31,2017,Guinea,Libya,3,2,World Cup qualifier,in Guinea,11,-11,1550,1452,2,-1,73,92,1539,1463,T1
7247,August 31,2017,Switzerland,Andorra,3,0,World Cup qualifier,in Switzerland,0,0,1865,1022,0,0,13,187,1865,1022,T1
7248,August 31,2017,Faroe Islands,Portugal,1,5,World Cup qualifier,in Portugal,-1,1,1280,1979,1,-1,138,6,1281,1978,T1
7249,August 31,2017,Luxembourg,Belarus,1,0,World Cup qualifier,in Luxembourg,32,-32,1279,1547,9,-9,139,74,1247,1579,T1
7250,August 31,2017,Hungary,Latvia,3,1,World Cup qualifier,in Hungary,8,-8,1628,1376,0,-5,54,117,1620,1384,T1
7251,August 31,2017,Greece,Estonia,0,0,World Cup qualifier,in Greece,-14,14,1665,1490,-2,1,48,86,1679,1476,draw
7252,August 31,2017,Netherlands,France,0,4,World Cup qualifier,in France,-16,16,1833,1991,-2,1,18,5,1849,1975,T1
7253,August 31,2017,Cyprus,Bosnia and Herzegovina,3,2,World Cup qualifier,in Cyprus,32,-32,1450,1722,11,-5,93,35,1418,1754,T1
7254,August 31,2017,Bulgaria,Sweden,3,2,World Cup qualifier,in Bulgaria,25,-25,1639,1784,3,-5,52,24,1614,1809,T1
7255,August 31,2017,Gibraltar,Belgium,0,9,World Cup qualifier,in Belgium,-1,1,1089,1900,-1,1,179,10,1090,1899,T1
7256,August 31,2017,Venezuela,Colombia,0,0,World Cup qualifier,in Venezuela,10,-10,1699,1961,2,-1,38,8,1689,1971,draw
7257,August 31,2017,Argentina,Uruguay,0,0,World Cup qualifier,in Uruguay,-4,4,2014,1847,0,2,3,16,2018,1843,draw
7258,August 31,2017,Bolivia,Peru,1,2,World Cup qualifier,in Peru,-7,7,1679,1861,-4,0,45,14,1686,1854,T1
7259,August 31,2017,Chile,Paraguay,0,3,World Cup qualifier,in Chile,-61,61,1885,1769,-2,9,11,28,1946,1708,T2
7260,August 31,2017,Brazil,Ecuador,2,0,World Cup qualifier,in Brazil,5,-5,2121,1799,0,0,1,21,2116,1804,T1
7261,September 1,2017,Solomon Islands,New Zealand,1,6,World Cup qualifier,in New Zealand,-5,5,1165,1532,-1,1,169,76,1170,1527,T1
7262,September 1,2017,Tunisia,Democratic Republic of Congo,2,1,World Cup qualifier,in Tunisia,16,-16,1594,1583,4,-4,62,65,1578,1599,T1
7263,September 1,2017,Cameroon,Nigeria,0,4,World Cup qualifier,in Nigeria,-31,31,1639,1661,-5,6,51,47,1670,1630,T1
7264,September 1,2017,Mali,Morocco,0,6,World Cup qualifier,in Morocco,-23,23,1510,1625,-6,4,82,55,1533,1602,T1
7265,September 1,2017,Ghana,Congo,1,1,World Cup qualifier,in Ghana,-13,13,1564,1421,-4,2,71,103,1577,1408,draw
7266,September 1,2017,South Africa,Cape Verde,1,2,World Cup qualifier,in Cape Verde,-25,25,1576,1444,-8,8,68,96,1601,1419,T1
7267,September 1,2017,Slovenia,Slovakia,0,1,World Cup qualifier,in Slovakia,-9,9,1633,1776,-3,1,53,28,1642,1767,T1
7268,September 1,2017,Northern Ireland,San Marino,3,0,World Cup qualifier,in San Marino,1,-1,1682,858,0,0,44,205,1681,859,T2
7269,September 1,2017,Armenia,Romania,0,1,World Cup qualifier,in Romania,-7,7,1494,1690,0,1,84,42,1501,1683,T1
7270,September 1,2017,Norway,Azerbaijan,2,0,World Cup qualifier,in Norway,12,-12,1579,1412,2,-3,66,105,1567,1424,T1
7271,September 1,2017,England,Malta,4,0,World Cup qualifier,in Malta,2,-2,1914,1225,0,0,9,155,1912,1227,T2
7272,September 1,2017,Lithuania,Scotland,0,3,World Cup qualifier,in Lithuania,-22,22,1426,1708,-6,4,100,37,1448,1686,T2
7273,September 1,2017,Montenegro,Kazakhstan,3,0,World Cup qualifier,in Kazakhstan,23,-23,1621,1346,6,-3,56,121,1598,1369,T2
7274,September 1,2017,Denmark,Poland,4,0,World Cup qualifier,in Denmark,41,-41,1780,1832,8,-6,25,18,1739,1873,T1
7275,September 1,2017,Germany,Czechia,2,1,World Cup qualifier,in Czechia,6,-6,2105,1692,0,-2,2,41,2099,1698,T2
7276,September 1,2017,Costa Rica,United States,2,0,World Cup qualifier,in the United States,42,-42,1801,1763,10,-12,20,31,1759,1805,T2
7277,September 1,2017,Honduras,Trinidad and Tobago,2,1,World Cup qualifier,in Trinidad and Tobago,18,-18,1578,1413,5,-4,67,104,1560,1431,T2
7278,September 1,2017,Mexico,Panama,1,0,World Cup qualifier,in Mexico,7,-7,1854,1660,2,-1,14,48,1847,1667,T1
7279,September 2,2017,Botswana,Tanzania,0,2,Friendly,in Tanzania,-7,7,1233,1348,-2,1,153,121,1240,1341,T1
7280,September 2,2017,Mozambique,Kenya,1,1,Friendly,in Mozambique,0,0,1301,1385,0,0,129,112,1301,1385,draw
7281,September 2,2017,Fiji,Indonesia,0,0,Friendly,in Indonesia,3,-3,1215,1225,0,0,159,154,1212,1228,draw
7282,September 2,2017,Algeria,Zambia,1,3,World Cup qualifier,in Zambia,-36,36,1578,1475,-7,8,65,90,1614,1439,T1
7283,September 2,2017,Senegal,Burkina Faso,0,0,World Cup qualifier,in Senegal,-10,10,1699,1620,-2,2,38,57,1709,1610,draw
7284,September 2,2017,Ivory Coast,Gabon,3,0,World Cup qualifier,in Gabon,23,-23,1680,1409,4,-6,45,105,1657,1432,T2
7285,September 2,2017,Wales,Austria,1,0,World Cup qualifier,in Wales,11,-11,1783,1684,6,-2,23,42,1772,1695,T1
7286,September 2,2017,Ukraine,Turkey,2,0,World Cup qualifier,in Ukraine,25,-25,1779,1769,6,-6,26,29,1754,1794,T1
7287,September 2,2017,Spain,Italy,3,0,World Cup qualifier,in Spain,22,-22,2026,1948,1,-1,3,8,2004,1970,T1
7288,September 2,2017,Serbia,Moldova,3,0,World Cup qualifier,in Serbia,4,-4,1745,1351,0,0,33,120,1741,1355,T1
7289,September 2,2017,Israel,Macedonia,0,1,World Cup qualifier,in Israel,-31,31,1534,1479,-7,5,77,89,1565,1448,T2
7290,September 2,2017,Ireland,Georgia,1,1,World Cup qualifier,in Georgia,-11,11,1766,1481,-4,2,31,88,1777,1470,draw
7291,September 2,2017,Iceland,Finland,0,1,World Cup qualifier,in Finland,-29,29,1773,1556,-9,5,28,72,1802,1527,T1
7292,September 2,2017,Albania,Liechtenstein,2,0,World Cup qualifier,in Albania,3,-3,1606,1163,1,-1,59,169,1603,1166,T1
7293,September 2,2017,Jamaica,Canada,0,2,Friendly,in Canada,-14,14,1576,1537,-3,2,67,76,1590,1523,T1
7294,September 3,2017,Benin,Equatorial Guinea,2,1,Friendly,in Equatorial Guinea,11,-11,1407,1330,2,-2,106,125,1396,1341,T2
7295,September 3,2017,Netherlands,Bulgaria,3,1,World Cup qualifier,in the Netherlands,9,-9,1842,1630,0,-2,17,53,1833,1639,T1
7296,September 3,2017,Latvia,Switzerland,0,3,World Cup qualifier,in Latvia,-7,7,1369,1872,0,0,117,12,1376,1865,T2
7297,September 3,2017,Hungary,Portugal,0,1,World Cup qualifier,in Hungary,-8,8,1620,1987,-2,1,56,5,1628,1979,T2
7298,September 3,2017,Belgium,Greece,2,1,World Cup qualifier,in Greece,13,-13,1913,1652,0,-2,10,49,1900,1665,T2
7299,September 3,2017,Gibraltar,Bosnia and Herzegovina,0,4,World Cup qualifier,in Portugal,-2,2,1087,1724,0,0,179,35,1089,1722,T2
7300,September 3,2017,France,Luxembourg,0,0,World Cup qualifier,in France,-20,20,1971,1299,-1,7,6,132,1991,1279,draw
7301,September 3,2017,Faroe Islands,Andorra,1,0,World Cup qualifier,in the Faroe Islands,5,-5,1285,1017,-1,0,139,187,1280,1022,T1
7302,September 3,2017,Cyprus,Estonia,0,1,World Cup qualifier,in Estonia,-12,12,1438,1502,-3,3,98,83,1450,1490,T1
7303,September 3,2017,Croatia,Kosovo,1,0,World Cup qualifier,in Croatia,1,-1,1852,1383,0,0,15,113,1851,1384,T1
7304,September 3,2017,Sweden,Belarus,4,0,World Cup qualifier,in Belarus,23,-23,1807,1524,3,-4,19,78,1784,1547,T2
7305,September 4,2017,Togo,Malawi,0,1,Friendly,in Morocco,-13,13,1382,1304,-4,8,113,129,1395,1291,T1
7306,September 4,2017,Guinea,Libya,0,1,World Cup qualifier,in Tunisia,-25,25,1525,1477,-4,5,77,89,1550,1452,T1
7307,September 4,2017,Nigeria,Cameroon,1,1,World Cup qualifier,in Cameroon,4,-4,1665,1635,0,-2,47,53,1661,1639,draw
7308,September 4,2017,Lithuania,Slovenia,0,4,World Cup qualifier,in Slovenia,-11,11,1415,1644,-3,2,102,50,1426,1633,T1
7309,September 4,2017,Scotland,Malta,2,0,World Cup qualifier,in Scotland,2,-2,1710,1223,0,-1,36,155,1708,1225,T1
7310,September 4,2017,Kazakhstan,Poland,0,3,World Cup qualifier,in Poland,-2,2,1344,1834,0,0,122,18,1346,1832,T1
7311,September 4,2017,Northern Ireland,Czechia,2,0,World Cup qualifier,in Northern Ireland,22,-22,1704,1670,7,-6,37,46,1682,1692,T1
7312,September 4,2017,Montenegro,Romania,1,0,World Cup qualifier,in Montenegro,18,-18,1639,1672,3,-4,52,45,1621,1690,T1
7313,September 4,2017,Germany,Norway,6,0,World Cup qualifier,in Germany,2,-2,2107,1577,0,-2,2,66,2105,1579,T1
7314,September 4,2017,Slovakia,England,1,2,World Cup qualifier,in England,-8,8,1768,1922,-3,0,30,9,1776,1914,T1
7315,September 4,2017,San Marino,Azerbaijan,1,5,World Cup qualifier,in Azerbaijan,-2,2,856,1414,0,1,205,103,858,1412,T1
7316,September 4,2017,Armenia,Denmark,1,4,World Cup qualifier,in Armenia,-18,18,1476,1798,-5,2,90,22,1494,1780,T2
7317,September 5,2017,Niger,Mauritania,2,0,Friendly,in Morocco,17,-17,1295,1315,5,-1,135,125,1278,1332,T1
7318,September 5,2017,Singapore,Turkmenistan,1,1,Asian Cup qualifier,in Singapore,4,-4,1085,1244,2,-2,180,149,1081,1248,draw
7319,September 5,2017,Yemen,Philippines,2,2,Asian Cup qualifier,in the Philippines,7,-7,1217,1238,3,-2,158,151,1210,1245,draw
7320,September 5,2017,Maldives,Oman,0,5,Asian Cup qualifier,in Oman,-2,2,948,1450,-1,-1,193,96,950,1448,T1
7321,September 5,2017,North Korea,Lebanon,2,2,Asian Cup qualifier,in North Korea,-10,10,1477,1404,-3,3,89,106,1487,1394,draw
7322,September 5,2017,Nepal,Tajikistan,1,2,Asian Cup qualifier,in Nepal,-10,10,894,1214,-1,3,201,161,904,1204,T2
7323,September 5,2017,Malaysia,Hong Kong,1,1,Asian Cup qualifier,in Malaysia,1,-1,1091,1199,0,0,178,165,1090,1200,draw
7324,September 5,2017,Macao,India,0,2,Asian Cup qualifier,in Macao,-6,6,666,1168,0,1,223,169,672,1162,T2
7325,September 5,2017,Jordan,Afghanistan,4,1,Asian Cup qualifier,in Jordan,4,-4,1495,1121,-1,-1,86,173,1491,1125,T1
7326,September 5,2017,Vietnam,Cambodia,2,1,Asian Cup qualifier,in Cambodia,5,-5,1280,822,1,0,141,208,1275,827,T2
7327,September 5,2017,Bhutan,Palestine,0,2,Asian Cup qualifier,in Bhutan,-1,1,594,1395,0,1,230,108,595,1394,T2
7328,September 5,2017,Taiwan,Bahrain,0,5,Asian Cup qualifier,in Bahrain,-2,2,886,1404,0,1,202,106,888,1402,T1
7329,September 5,2017,Solomon Islands,New Zealand,2,2,World Cup qualifier,in the Solomon Islands,13,-13,1178,1519,0,-2,168,78,1165,1532,draw
7330,September 5,2017,Uzbekistan,South Korea,0,0,World Cup qualifier,in Uzbekistan,1,-1,1619,1730,1,0,57,34,1618,1731,draw
7331,September 5,2017,Saudi Arabia,Japan,1,0,World Cup qualifier,in Saudi Arabia,25,-25,1619,1755,4,-6,57,31,1594,1780,T1
7332,September 5,2017,Qatar,China,1,2,World Cup qualifier,in Qatar,-23,23,1497,1589,-6,5,85,64,1520,1566,T2
7333,September 5,2017,United Arab Emirates,Iraq,0,1,World Cup qualifier,in Jordan,-21,21,1543,1561,-3,3,73,70,1564,1540,T1
7334,September 5,2017,Iran,Syria,2,2,World Cup qualifier,in Iran,-14,14,1781,1612,-2,0,25,60,1795,1598,draw
7335,September 5,2017,Australia,Thailand,2,1,World Cup qualifier,in Australia,4,-4,1707,1393,0,-1,38,109,1703,1397,T1
7336,September 5,2017,South Africa,Cape Verde,1,2,World Cup qualifier,in South Africa,-32,32,1544,1476,-5,5,72,91,1576,1444,T2
7337,September 5,2017,Mali,Morocco,0,0,World Cup qualifier,in Mali,1,-1,1511,1624,3,0,79,55,1510,1625,draw
7338,September 5,2017,Gabon,Ivory Coast,2,1,World Cup qualifier,in Ivory Coast,36,-36,1445,1644,8,-7,97,50,1409,1680,T2
7339,September 5,2017,Egypt,Uganda,1,0,World Cup qualifier,in Egypt,9,-9,1651,1507,2,-1,49,81,1642,1516,T1
7340,September 5,2017,Tunisia,Democratic Republic of Congo,2,2,World Cup qualifier,in the Democratic Republic of the Congo,5,-5,1599,1578,-1,-3,62,66,1594,1583,draw
7341,September 5,2017,Congo,Ghana,1,5,World Cup qualifier,in Congo,-33,33,1388,1597,-9,7,110,63,1421,1564,T2
7342,September 5,2017,Senegal,Burkina Faso,2,2,World Cup qualifier,in Burkina Faso,1,-1,1700,1619,-2,-1,41,57,1699,1620,draw
7343,September 5,2017,Algeria,Zambia,0,1,World Cup qualifier,in Algeria,-31,31,1547,1506,-7,9,71,82,1578,1475,T2
7344,September 5,2017,Turkey,Croatia,1,0,World Cup qualifier,in Turkey,19,-19,1788,1833,4,-3,24,18,1769,1852,T1
7345,September 5,2017,Wales,Moldova,2,0,World Cup qualifier,in Moldova,8,-8,1791,1343,1,-2,23,122,1783,1351,T2
7346,September 5,2017,Macedonia,Albania,1,1,World Cup qualifier,in Macedonia,2,-2,1481,1604,0,-2,88,61,1479,1606,draw
7347,September 5,2017,Spain,Liechtenstein,8,0,World Cup qualifier,in Liechtenstein,1,-1,2027,1162,0,-1,3,170,2026,1163,T2
7348,September 5,2017,Israel,Italy,0,1,World Cup qualifier,in Italy,-2,2,1532,1950,0,0,75,8,1534,1948,T1
7349,September 5,2017,Serbia,Ireland,1,0,World Cup qualifier,in Ireland,27,-27,1772,1739,6,-2,27,33,1745,1766,T2
7350,September 5,2017,Iceland,Ukraine,2,0,World Cup qualifier,in Iceland,22,-22,1795,1757,5,-4,22,30,1773,1779,T1
7351,September 5,2017,Finland,Kosovo,1,0,World Cup qualifier,in Albania,11,-11,1567,1372,3,-4,69,116,1556,1383,T1
7352,September 5,2017,Georgia,Austria,1,1,World Cup qualifier,in Austria,14,-14,1495,1670,1,-3,86,44,1481,1684,draw
7353,September 5,2017,Trinidad and Tobago,Panama,0,3,World Cup qualifier,in Panama,-8,8,1405,1668,-1,2,105,46,1413,1660,T1
7354,September 5,2017,Honduras,United States,1,1,World Cup qualifier,in Honduras,5,-5,1583,1758,-1,3,65,29,1578,1763,draw
7355,September 5,2017,Costa Rica,Mexico,1,1,World Cup qualifier,in Costa Rica,-3,3,1798,1857,0,-1,20,15,1801,1854,draw
7356,September 5,2017,Paraguay,Uruguay,1,2,World Cup qualifier,in Paraguay,-21,21,1748,1868,-4,3,32,13,1769,1847,T2
7357,September 5,2017,Ecuador,Peru,1,2,World Cup qualifier,in Ecuador,-22,22,1777,1883,-5,2,26,11,1799,1861,T2
7358,September 5,2017,Colombia,Brazil,1,1,World Cup qualifier,in Colombia,3,-3,1964,2118,0,0,7,1,1961,2121,draw
7359,September 5,2017,Bolivia,Chile,1,0,World Cup qualifier,in Bolivia,26,-26,1705,1859,5,-3,39,14,1679,1885,T1
7360,September 5,2017,Venezuela,Argentina,1,1,World Cup qualifier,in Argentina,17,-17,1716,1997,3,0,36,4,1699,2014,draw
7361,September 30,2017,Ethiopia,Botswana,0,2,Friendly,in Botswana,-13,13,1282,1246,-5,5,140,148,1295,1233,T1
7362,October 2,2017,Macao,Laos,3,1,Friendly,in Macao,17,-17,683,787,1,-2,222,212,666,804,T1
7363,October 4,2017,Uganda,Madagascar,1,2,Friendly,in Uganda,-16,16,1491,1376,-6,3,87,116,1507,1360,T2
7364,October 4,2017,Oman,Jordan,1,1,Friendly,in the United Arab Emirates,1,-1,1451,1494,0,0,96,86,1450,1495,draw
7365,October 4,2017,Cambodia,Indonesia,1,3,Friendly,in Indonesia,-2,2,820,1227,0,0,208,154,822,1225,T1
7366,October 5,2017,Taiwan,Mongolia,4,2,Friendly,in Taiwan,4,-4,890,653,0,0,202,224,886,657,T1
7367,October 5,2017,Qatar,Singapore,3,1,Friendly,in Qatar,1,-1,1498,1084,0,0,84,180,1497,1085,T1
7368,October 5,2017,Thailand,Myanmar,3,1,Friendly,in Myanmar,7,-7,1400,1075,1,-2,108,183,1393,1082,T2
7369,October 5,2017,Kenya,Iraq,1,2,Friendly,in Iraq,-3,3,1382,1564,0,0,111,70,1385,1561,T1
7370,October 5,2017,Togo,Iran,0,2,Friendly,in Iran,-2,2,1380,1783,-1,0,113,25,1382,1781,T1
7371,October 5,2017,Laos,Hong Kong,0,4,Friendly,in Hong Kong,-2,2,785,1201,0,0,212,165,787,1199,T1
7372,October 5,2017,Syria,Australia,1,1,World Cup qualifier,in Malaysia,5,-5,1617,1702,0,-1,60,39,1612,1707,draw
7373,October 5,2017,Scotland,Slovakia,1,0,World Cup qualifier,in Scotland,18,-18,1728,1750,2,-4,35,32,1710,1768,T1
7374,October 5,2017,San Marino,Norway,0,8,World Cup qualifier,in San Marino,-3,3,853,1580,0,1,205,66,856,1577,T2
7375,October 5,2017,Kazakhstan,Romania,1,3,World Cup qualifier,in Romania,-5,5,1339,1677,-1,-1,122,44,1344,1672,T1
7376,October 5,2017,Northern Ireland,Germany,1,3,World Cup qualifier,in Northern Ireland,-9,9,1695,2116,-1,1,41,1,1704,2107,T2
7377,October 5,2017,Denmark,Montenegro,1,0,World Cup qualifier,in Montenegro,17,-17,1815,1622,1,-3,19,55,1798,1639,T2
7378,October 5,2017,Malta,Lithuania,1,1,World Cup qualifier,in Malta,5,-5,1228,1410,1,0,154,102,1223,1415,draw
7379,October 5,2017,Slovenia,England,0,1,World Cup qualifier,in England,-4,4,1640,1926,-1,0,51,9,1644,1922,T1
7380,October 5,2017,Czechia,Azerbaijan,2,1,World Cup qualifier,in Azerbaijan,12,-12,1682,1402,1,-4,43,107,1670,1414,T2
7381,October 5,2017,Armenia,Poland,1,6,World Cup qualifier,in Armenia,-15,15,1461,1849,-3,1,94,16,1476,1834,T2
7382,October 5,2017,Uruguay,Venezuela,0,0,World Cup qualifier,in Venezuela,-3,3,1865,1719,-1,-1,14,37,1868,1716,draw
7383,October 5,2017,Colombia,Paraguay,1,2,World Cup qualifier,in Colombia,-34,34,1930,1782,-1,6,8,26,1964,1748,T2
7384,October 5,2017,Ecuador,Chile,1,2,World Cup qualifier,in Chile,-10,10,1767,1869,-2,1,28,13,1777,1859,T1
7385,October 5,2017,Bolivia,Brazil,0,0,World Cup qualifier,in Bolivia,14,-14,1719,2104,2,-1,37,2,1705,2118,draw
7386,October 5,2017,Peru,Argentina,0,0,World Cup qualifier,in Argentina,11,-11,1894,1986,0,-1,11,5,1883,1997,draw
7387,October 6,2017,New Zealand,Japan,1,2,Friendly,in Japan,-3,3,1516,1758,0,2,78,29,1519,1755,T1
7388,October 6,2017,Mauritania,Comoros,0,1,Friendly,in Tunisia,-17,17,1298,1031,-8,2,133,186,1315,1014,T1
7389,October 6,2017,Mali,Ivory Coast,0,0,World Cup qualifier,in Mali,2,-2,1513,1642,0,0,79,50,1511,1644,draw
7390,October 6,2017,Turkey,Iceland,0,3,World Cup qualifier,in Turkey,-44,44,1744,1839,-8,4,32,18,1788,1795,T2
7391,October 6,2017,Spain,Albania,3,0,World Cup qualifier,in Spain,3,-3,2030,1601,0,0,3,61,2027,1604,T1
7392,October 6,2017,Liechtenstein,Israel,0,1,World Cup qualifier,in Liechtenstein,-7,7,1155,1539,-1,1,171,74,1162,1532,T2
7393,October 6,2017,Ukraine,Kosovo,2,0,World Cup qualifier,in Albania,6,-6,1763,1366,2,-1,28,118,1757,1372,T2
7394,October 6,2017,Italy,Macedonia,1,1,World Cup qualifier,in Italy,-19,19,1931,1500,0,4,7,84,1950,1481,draw
7395,October 6,2017,Moldova,Ireland,0,2,World Cup qualifier,in Ireland,-3,3,1340,1742,0,0,121,33,1343,1739,T1
7396,October 6,2017,Wales,Georgia,1,0,World Cup qualifier,in Georgia,10,-10,1801,1485,1,-3,22,88,1791,1495,T2
7397,October 6,2017,Finland,Croatia,1,1,World Cup qualifier,in Croatia,16,-16,1583,1817,4,-1,65,19,1567,1833,draw
7398,October 6,2017,Serbia,Austria,2,3,World Cup qualifier,in Austria,-20,20,1752,1690,-3,3,30,42,1772,1670,T1
7399,October 6,2017,United States,Panama,4,0,World Cup qualifier,in the United States,19,-19,1777,1649,3,-3,26,49,1758,1668,T1
7400,October 6,2017,Mexico,Trinidad and Tobago,3,1,World Cup qualifier,in Mexico,2,-2,1859,1403,0,-2,15,106,1857,1405,T1
7401,October 7,2017,Tanzania,Malawi,1,1,Friendly,in Tanzania,-4,4,1344,1308,0,1,120,127,1348,1304,draw
7402,October 7,2017,Saudi Arabia,Jamaica,5,2,Friendly,in Saudi Arabia,11,-11,1630,1565,2,-1,55,70,1619,1576,T1
7403,October 7,2017,South Korea,Russia,2,4,Friendly,in Russia,-13,13,1717,1697,-4,2,38,41,1730,1684,T1
7404,October 7,2017,Uganda,Ghana,0,0,World Cup qualifier,in Uganda,0,0,1491,1597,1,1,86,62,1491,1597,draw
7405,October 7,2017,Burkina Faso,South Africa,1,3,World Cup qualifier,in South Africa,-28,28,1591,1572,-8,3,65,69,1619,1544,T1
7406,October 7,2017,Nigeria,Zambia,1,0,World Cup qualifier,in Nigeria,7,-7,1672,1499,0,-2,46,83,1665,1506,T1
7407,October 7,2017,Gabon,Morocco,0,3,World Cup qualifier,in Morocco,-12,12,1433,1636,-1,0,98,54,1445,1624,T1
7408,October 7,2017,Libya,Democratic Republic of Congo,1,2,World Cup qualifier,in Tunisia,-14,14,1463,1592,-3,4,92,64,1477,1578,T2
7409,October 7,2017,Tunisia,Guinea,4,1,World Cup qualifier,in Guinea,38,-38,1637,1487,9,-11,53,87,1599,1525,T2
7410,October 7,2017,Senegal,Cape Verde,2,0,World Cup qualifier,in Cape Verde,20,-20,1720,1456,5,-3,35,94,1700,1476,T2
7411,October 7,2017,Cameroon,Algeria,2,0,World Cup qualifier,in Cameroon,15,-15,1650,1532,3,-4,49,75,1635,1547,T1
7412,October 7,2017,Switzerland,Hungary,5,2,World Cup qualifier,in Switzerland,8,-8,1880,1612,0,-4,12,60,1872,1620,T1
7413,October 7,2017,Luxembourg,Sweden,0,8,World Cup qualifier,in Sweden,-3,3,1296,1810,-1,0,133,21,1299,1807,T1
7414,October 7,2017,Gibraltar,Estonia,0,6,World Cup qualifier,in Portugal,-7,7,1080,1509,-2,2,181,80,1087,1502,T2
7415,October 7,2017,Latvia,Faroe Islands,0,0,World Cup qualifier,in the Faroe Islands,1,-1,1370,1284,0,0,117,139,1369,1285,draw
7416,October 7,2017,Cyprus,Greece,1,2,World Cup qualifier,in Cyprus,-14,14,1424,1666,-1,0,100,47,1438,1652,T2
7417,October 7,2017,Bulgaria,France,0,1,World Cup qualifier,in Bulgaria,-8,8,1622,1979,-3,0,56,6,1630,1971,T2
7418,October 7,2017,Bosnia and Herzegovina,Belgium,3,4,World Cup qualifier,in Bosnia and Herzegovina,-15,15,1709,1928,-3,1,39,9,1724,1913,T2
7419,October 7,2017,Belarus,Netherlands,1,3,World Cup qualifier,in Belarus,-13,13,1511,1855,-1,1,78,16,1524,1842,T2
7420,October 7,2017,Andorra,Portugal,0,2,World Cup qualifier,in Andorra,0,0,1017,1987,0,0,188,4,1017,1987,T2
7421,October 7,2017,Grenada,Guyana,1,0,Friendly,in Grenada,10,-10,1111,1188,1,-1,174,167,1101,1198,T1
7422,October 7,2017,Honduras,Costa Rica,1,1,World Cup qualifier,in Costa Rica,14,-14,1597,1784,3,0,62,23,1583,1798,draw
7423,October 8,2017,Kenya,Thailand,0,1,Friendly,in Thailand,-7,7,1375,1407,-5,6,116,102,1382,1400,T1
7424,October 8,2017,El Salvador,Canada,1,0,Friendly,in the United States,13,-13,1457,1524,3,-1,94,75,1444,1537,T1
7425,October 8,2017,Egypt,Congo,2,1,World Cup qualifier,in Egypt,4,-4,1655,1384,0,0,48,110,1651,1388,T1
7426,October 8,2017,Scotland,Slovenia,2,2,World Cup qualifier,in Slovenia,1,-1,1729,1639,0,0,34,52,1728,1640,draw
7427,October 8,2017,Malta,Slovakia,0,3,World Cup qualifier,in Slovakia,-2,2,1226,1752,-1,1,155,30,1228,1750,T1
7428,October 8,2017,Montenegro,Poland,2,4,World Cup qualifier,in Poland,-8,8,1614,1857,-3,1,59,16,1622,1849,T1
7429,October 8,2017,Northern Ireland,Norway,0,1,World Cup qualifier,in Norway,-21,21,1674,1601,-3,7,45,61,1695,1580,T1
7430,October 8,2017,Lithuania,England,0,1,World Cup qualifier,in Lithuania,-3,3,1407,1929,0,1,102,9,1410,1926,T2
7431,October 8,2017,Armenia,Kazakhstan,1,1,World Cup qualifier,in Kazakhstan,-1,1,1460,1340,0,1,93,121,1461,1339,draw
7432,October 8,2017,Germany,Azerbaijan,5,1,World Cup qualifier,in Germany,1,-1,2117,1401,0,-1,1,108,2116,1402,T1
7433,October 8,2017,Romania,Denmark,1,1,World Cup qualifier,in Denmark,12,-12,1689,1803,2,-1,43,21,1677,1815,draw
7434,October 8,2017,San Marino,Czechia,0,5,World Cup qualifier,in Czechia,0,0,853,1682,0,0,205,44,853,1682,T1
7435,October 9,2017,Mauritius,Equatorial Guinea,1,3,Friendly,in Equatorial Guinea,-3,3,1072,1333,-1,2,184,122,1075,1330,T1
7436,October 9,2017,Ireland,Wales,1,0,World Cup qualifier,in Wales,29,-29,1771,1772,6,-4,27,26,1742,1801,T2
7437,October 9,2017,Ukraine,Croatia,0,2,World Cup qualifier,in Ukraine,-34,34,1729,1851,-5,1,33,18,1763,1817,T2
7438,October 9,2017,Georgia,Serbia,0,1,World Cup qualifier,in Serbia,-4,4,1481,1756,0,0,88,30,1485,1752,T1
7439,October 9,2017,Austria,Moldova,1,0,World Cup qualifier,in Moldova,8,-8,1698,1332,1,-3,41,124,1690,1340,T2
7440,October 9,2017,Macedonia,Liechtenstein,4,0,World Cup qualifier,in Macedonia,5,-5,1505,1150,1,0,81,171,1500,1155,T1
7441,October 9,2017,Israel,Spain,0,1,World Cup qualifier,in Israel,-4,4,1535,2034,0,0,73,3,1539,2030,T2
7442,October 9,2017,Iceland,Kosovo,2,0,World Cup qualifier,in Iceland,2,-2,1841,1364,-1,0,19,118,1839,1366,T1
7443,October 9,2017,Turkey,Finland,2,2,World Cup qualifier,in Finland,-3,3,1741,1586,0,0,32,68,1744,1583,draw
7444,October 9,2017,Albania,Italy,0,1,World Cup qualifier,in Albania,-8,8,1593,1939,-3,0,64,7,1601,1931,T2
7445,October 10,2017,Ghana,Saudi Arabia,3,0,Friendly,in Saudi Arabia,24,-24,1621,1606,6,-7,56,62,1597,1630,T2
7446,October 10,2017,Iran,Russia,1,1,Friendly,in Russia,0,0,1783,1697,1,0,22,42,1783,1697,draw
7447,October 10,2017,Curaçao,Qatar,2,1,Friendly,in Qatar,18,-18,1266,1480,3,-4,144,88,1248,1498,T2
7448,October 10,2017,Cape Verde,Mozambique,0,1,Friendly,in Portugal,-14,14,1442,1315,-1,4,96,125,1456,1301,T1
7449,October 10,2017,Morocco,South Korea,3,1,Friendly,in Switzerland,18,-18,1654,1699,4,-2,50,40,1636,1717,T1
7450,October 10,2017,Japan,Haiti,3,3,Friendly,in Japan,-8,8,1750,1481,0,5,29,86,1758,1473,draw
7451,October 10,2017,Benin,Gabon,1,0,Friendly,in France,11,-11,1418,1422,-2,-4,104,102,1407,1433,T1
7452,October 10,2017,Vietnam,Cambodia,5,0,Asian Cup qualifier,in Vietnam,3,-3,1283,817,2,0,139,208,1280,820,T1
7453,October 10,2017,Singapore,Turkmenistan,1,2,Asian Cup qualifier,in Turkmenistan,-7,7,1077,1251,-1,2,180,148,1084,1244,T1
7454,October 10,2017,Tajikistan,Nepal,3,0,Asian Cup qualifier,in Tajikistan,6,-6,1220,888,4,-1,157,202,1214,894,T1
7455,October 10,2017,Taiwan,Bahrain,2,1,Asian Cup qualifier,in Taiwan,37,-37,927,1367,4,-12,198,117,890,1404,T1
7456,October 10,2017,Yemen,Philippines,1,1,Asian Cup qualifier,in Qatar,1,-1,1218,1237,-1,-1,159,153,1217,1238,draw
7457,October 10,2017,Palestine,Bhutan,10,0,Asian Cup qualifier,in Palestine,1,-1,1396,593,1,-1,108,231,1395,594,T1
7458,October 10,2017,Kyrgyzstan,Myanmar,2,2,Asian Cup qualifier,in Myanmar,-2,2,1204,1077,-2,3,165,180,1206,1075,draw
7459,October 10,2017,Oman,Maldives,3,1,Asian Cup qualifier,in the Maldives,5,-5,1456,943,3,-3,94,196,1451,948,T2
7460,October 10,2017,Lebanon,North Korea,5,0,Asian Cup qualifier,in Lebanon,37,-37,1441,1440,8,-9,97,98,1404,1477,T1
7461,October 10,2017,Malaysia,Hong Kong,0,2,Asian Cup qualifier,in Hong Kong,-14,14,1077,1215,-2,4,180,161,1091,1201,T1
7462,October 10,2017,Afghanistan,Jordan,3,3,Asian Cup qualifier,in Tajikistan,16,-16,1137,1478,1,-4,172,89,1121,1494,draw
7463,October 10,2017,Australia,Syria,2,1,World Cup qualifier,in Australia,10,-10,1712,1607,2,-3,38,61,1702,1617,T1
7464,October 10,2017,Switzerland,Portugal,0,2,World Cup qualifier,in Portugal,-14,14,1866,2001,-2,-1,14,5,1880,1987,T1
7465,October 10,2017,Netherlands,Sweden,2,0,World Cup qualifier,in the Netherlands,18,-18,1873,1792,4,-1,13,21,1855,1810,T1
7466,October 10,2017,Bulgaria,Luxembourg,1,1,World Cup qualifier,in Luxembourg,-11,11,1611,1307,-4,4,60,129,1622,1296,draw
7467,October 10,2017,Andorra,Latvia,0,4,World Cup qualifier,in Latvia,-5,5,1012,1375,0,2,188,115,1017,1370,T1
7468,October 10,2017,Faroe Islands,Hungary,0,1,World Cup qualifier,in Hungary,-3,3,1281,1615,-2,2,141,58,1284,1612,T1
7469,October 10,2017,Greece,Gibraltar,4,0,World Cup qualifier,in Greece,1,-1,1667,1079,-1,2,48,179,1666,1080,T1
7470,October 10,2017,France,Belarus,2,1,World Cup qualifier,in France,1,-1,1980,1510,0,-1,6,79,1979,1511,T1
7471,October 10,2017,Bosnia and Herzegovina,Estonia,2,1,World Cup qualifier,in Estonia,14,-14,1723,1495,3,-3,36,83,1709,1509,T2
7472,October 10,2017,Cyprus,Belgium,0,4,World Cup qualifier,in Belgium,-2,2,1422,1930,-2,1,102,9,1424,1928,T1
7473,October 10,2017,Trinidad and Tobago,United States,2,1,World Cup qualifier,in Trinidad and Tobago,33,-33,1436,1744,8,-7,99,32,1403,1777,T1
7474,October 10,2017,Costa Rica,Panama,1,2,World Cup qualifier,in Panama,-22,22,1762,1671,-3,3,25,47,1784,1649,T1
7475,October 10,2017,Mexico,Honduras,2,3,World Cup qualifier,in Honduras,-29,29,1830,1626,-4,7,19,55,1859,1597,T1
7476,October 10,2017,Uruguay,Bolivia,4,2,World Cup qualifier,in Uruguay,12,-12,1877,1707,2,-3,12,39,1865,1719,T1
7477,October 10,2017,Peru,Colombia,1,1,World Cup qualifier,in Peru,-4,4,1890,1934,0,0,11,8,1894,1930,draw
7478,October 10,2017,Paraguay,Venezuela,0,1,World Cup qualifier,in Paraguay,-29,29,1753,1748,-3,6,27,30,1782,1719,T2
7479,October 10,2017,Ecuador,Argentina,1,3,World Cup qualifier,in Ecuador,-20,20,1747,2006,-3,1,31,4,1767,1986,T2
7480,October 10,2017,Brazil,Chile,3,0,World Cup qualifier,in Brazil,9,-9,2113,1860,0,-2,2,15,2104,1869,T1
7481,October 11,2017,India,Macao,4,1,Asian Cup qualifier,in India,2,-2,1170,681,0,0,169,222,1168,683,T1
7482,October 24,2017,Grenada,Panama,0,5,Friendly,in Grenada,-3,3,1108,1674,0,2,174,45,1111,1671,T2
7483,October 28,2017,Bermuda,Barbados,2,3,Friendly,in Bermuda,-15,15,1196,1138,-2,1,165,172,1211,1123,T2
7484,November 7,2017,Latvia,Saudi Arabia,0,2,Friendly,in Portugal,-6,6,1369,1612,-1,2,116,60,1375,1606,T1
7485,November 8,2017,Nicaragua,Dominican Republic,0,3,Friendly,in Nicaragua,-26,26,1275,1242,-11,9,142,151,1301,1216,T2
7486,November 8,2017,Zimbabwe,Lesotho,0,1,Friendly,in Lesotho,-14,14,1488,1266,-3,2,84,144,1502,1252,T1
7487,November 8,2017,Benin,Congo,1,1,Friendly,in Congo,2,-2,1420,1382,0,0,104,109,1418,1384,draw
7488,November 8,2017,Czechia,Iceland,2,1,Friendly tournament,in Qatar,21,-21,1703,1820,4,-1,40,19,1682,1841,T1
7489,November 9,2017,Lebanon,Singapore,1,0,Friendly,in Singapore,4,-4,1445,1073,1,-3,96,183,1441,1077,T2
7490,November 9,2017,Netherlands,Scotland,1,0,Friendly,in Scotland,9,-9,1882,1720,1,-2,12,36,1873,1729,T2
7491,November 9,2017,Romania,Turkey,2,0,Friendly,in Romania,13,-13,1702,1728,3,-1,41,34,1689,1741,T1
7492,November 9,2017,Hungary,Luxembourg,1,2,Friendly,in Luxembourg,-15,15,1600,1322,-5,4,63,125,1615,1307,T1
7493,November 9,2017,Panama,Iran,1,2,Friendly,in Austria,-7,7,1667,1790,-1,0,46,22,1674,1783,T1
7494,November 9,2017,Hong Kong,Bahrain,0,2,Friendly,in Hong Kong,-13,13,1202,1380,-3,6,164,111,1215,1367,T2
7495,November 9,2017,Finland,Estonia,3,0,Friendly,in Finland,9,-9,1595,1486,4,-3,64,85,1586,1495,T1
7496,November 9,2017,Myanmar,Cambodia,2,1,Friendly,in Cambodia,6,-6,1083,811,2,0,178,208,1077,817,T2
7497,November 9,2017,Armenia,Belarus,4,1,Friendly,in Armenia,15,-15,1475,1495,2,-2,90,81,1460,1510,T1
7498,November 9,2017,Switzerland,Northern Ireland,1,0,World Cup qualifier,in Northern Ireland,15,-15,1881,1659,1,-2,13,47,1866,1674,T2
7499,November 9,2017,Greece,Croatia,1,4,World Cup qualifier,in Croatia,-11,11,1656,1862,0,2,48,15,1667,1851,T1
7500,November 10,2017,Ukraine,Slovakia,2,1,Friendly,in Ukraine,8,-8,1737,1744,-1,-4,34,32,1729,1752,T1
7501,November 10,2017,Haiti,United Arab Emirates,1,0,Friendly,in the United Arab Emirates,14,-14,1495,1529,5,-2,81,74,1481,1543,T2
7502,November 10,2017,South Korea,Colombia,2,1,Friendly,in South Korea,14,-14,1713,1920,4,-1,38,9,1699,1934,T1
7503,November 10,2017,Saudi Arabia,Portugal,0,3,Friendly,in Portugal,-2,2,1610,2003,-1,0,60,5,1612,2001,T1
7504,November 10,2017,Poland,Uruguay,0,0,Friendly,in Poland,-2,2,1855,1879,0,0,17,14,1857,1877,draw
7505,November 10,2017,Georgia,Cyprus,1,0,Friendly,in Georgia,6,-6,1487,1416,1,-2,85,104,1481,1422,T1
7506,November 10,2017,Wales,France,0,2,Friendly,in France,-4,4,1768,1984,-1,0,24,6,1772,1980,T1
7507,November 10,2017,Germany,England,0,0,Friendly,in England,-2,2,2115,1931,-1,3,2,7,2117,1929,draw
7508,November 10,2017,Serbia,China,2,0,Friendly,in China,12,-12,1768,1577,2,0,24,68,1756,1589,T2
7509,November 10,2017,Japan,Brazil,1,3,Friendly,in France,-3,3,1747,2116,0,1,29,1,1750,2113,T1
7510,November 10,2017,Belgium,Mexico,3,3,Friendly,in Belgium,-5,5,1925,1835,1,0,8,18,1930,1830,draw
7511,November 10,2017,Malaysia,North Korea,1,4,Asian Cup qualifier,in Thailand,-8,8,1069,1448,-3,2,184,96,1077,1440,T1
7512,November 10,2017,South Africa,Senegal,0,2,World Cup qualifier,in South Africa,-26,26,1546,1746,-2,5,71,31,1572,1720,T2
7513,November 10,2017,Nigeria,Algeria,1,1,World Cup qualifier,in Algeria,-2,2,1670,1534,0,1,45,73,1672,1532,draw
7514,November 10,2017,Italy,Sweden,0,1,World Cup qualifier,in Sweden,-23,23,1916,1815,-3,1,10,20,1939,1792,T1
7515,November 10,2017,Honduras,Australia,0,0,World Cup qualifier,in Honduras,-1,1,1625,1713,0,0,55,38,1626,1712,draw
7516,November 11,2017,Zimbabwe,Namibia,1,3,Friendly,in Namibia,-16,16,1472,1377,-7,5,91,114,1488,1361,T1
7517,November 11,2017,Lesotho,Malawi,1,1,Friendly,in Malawi,4,-4,1270,1304,2,-1,142,130,1266,1308,draw
7518,November 11,2017,Madagascar,Comoros,1,1,Friendly,in France,-8,8,1368,1039,-3,0,118,186,1376,1031,draw
7519,November 11,2017,Trinidad and Tobago,Grenada,2,2,Friendly,in Trinidad and Tobago,-8,8,1428,1116,0,0,99,174,1436,1108,draw
7520,November 11,2017,Spain,Costa Rica,5,0,Friendly,in Spain,4,-4,2038,1758,0,0,3,26,2034,1762,T1
7521,November 11,2017,Russia,Argentina,0,1,Friendly,in Russia,-5,5,1692,2011,0,0,44,4,1697,2006,T2
7522,November 11,2017,Norway,Macedonia,0,2,Friendly,in Macedonia,-15,15,1586,1520,-5,2,67,77,1601,1505,T1
7523,November 11,2017,Dominican Republic,Nicaragua,1,0,Friendly,in the Dominican Republic,8,-8,1250,1267,2,-1,149,143,1242,1275,T1
7524,November 11,2017,Qatar,Czechia,0,1,Friendly tournament,in Qatar,-10,10,1470,1713,-4,3,92,38,1480,1703,T2
7525,November 11,2017,Peru,New Zealand,0,0,World Cup qualifier,in New Zealand,-13,13,1877,1529,-3,2,14,74,1890,1516,draw
7526,November 11,2017,Cameroon,Zambia,2,2,World Cup qualifier,in Zambia,-3,3,1647,1502,0,0,51,80,1650,1499,draw
7527,November 11,2017,Libya,Tunisia,0,0,World Cup qualifier,in Tunisia,13,-13,1476,1624,5,0,87,54,1463,1637,draw
7528,November 11,2017,Ivory Coast,Morocco,0,2,World Cup qualifier,in Ivory Coast,-37,37,1605,1691,-10,5,62,45,1642,1654,T2
7529,November 11,2017,Gabon,Mali,0,0,World Cup qualifier,in Gabon,-1,1,1421,1514,0,-1,102,78,1422,1513,draw
7530,November 11,2017,Democratic Republic of Congo,Guinea,3,1,World Cup qualifier,in the Democratic Republic of the Congo,14,-14,1606,1473,5,-5,61,90,1592,1487,T1
7531,November 11,2017,Ireland,Denmark,0,0,World Cup qualifier,in Denmark,7,-7,1778,1796,0,0,23,21,1771,1803,draw
7532,November 12,2017,Mauritius,Togo,0,6,Friendly,in Togo,-4,4,1068,1384,-1,2,184,109,1072,1380,T1
7533,November 12,2017,Benin,Tanzania,1,1,Friendly,in Benin,-5,5,1415,1349,-1,0,104,120,1420,1344,draw
7534,November 12,2017,Malta,Estonia,0,3,Friendly,in Malta,-10,10,1216,1496,-4,4,160,81,1226,1486,T2
7535,November 12,2017,Egypt,Ghana,1,1,World Cup qualifier,in Ghana,4,-4,1659,1617,0,-1,50,56,1655,1621,draw
7536,November 12,2017,Uganda,Congo,1,1,World Cup qualifier,in Congo,-1,1,1490,1383,-1,-1,84,110,1491,1382,draw
7537,November 12,2017,Switzerland,Northern Ireland,0,0,World Cup qualifier,in Switzerland,-15,15,1866,1674,-2,2,14,46,1881,1659,draw
7538,November 12,2017,Croatia,Greece,0,0,World Cup qualifier,in Greece,-6,6,1856,1662,-1,0,16,49,1862,1656,draw
7539,November 13,2017,Turkey,Albania,2,3,Friendly,in Turkey,-16,16,1712,1609,-5,6,40,59,1728,1593,T2
7540,November 13,2017,Mexico,Poland,1,0,Friendly,in Poland,13,-13,1848,1842,1,-1,17,18,1835,1855,T2
7541,November 13,2017,Latvia,Kosovo,3,4,Friendly,in Kosovo,-7,7,1362,1371,-2,2,119,117,1369,1364,T1
7542,November 13,2017,Iraq,Syria,1,1,Friendly,in Iraq,-2,2,1562,1609,0,1,70,59,1564,1607,draw
7543,November 13,2017,Iran,Venezuela,1,0,Friendly,in the Netherlands,9,-9,1799,1739,1,-5,21,33,1790,1748,T1
7544,November 13,2017,Georgia,Belarus,2,2,Friendly,in Georgia,-3,3,1484,1498,0,1,85,81,1487,1495,draw
7545,November 13,2017,Bulgaria,Saudi Arabia,1,0,Friendly,in Portugal,10,-10,1621,1600,3,-4,55,63,1611,1610,T1
7546,November 13,2017,Armenia,Cyprus,3,2,Friendly,in Armenia,6,-6,1481,1410,2,-1,86,104,1475,1416,T1
7547,November 13,2017,North Korea,Malaysia,4,1,Asian Cup qualifier,in Thailand,7,-7,1455,1062,1,-2,95,185,1448,1069,T1
7548,November 13,2017,Italy,Sweden,0,0,World Cup qualifier,in Italy,-10,10,1906,1825,0,1,10,19,1916,1815,draw
7549,November 14,2017,Panama,Wales,1,1,Friendly,in Wales,5,-5,1672,1763,0,0,48,24,1667,1768,draw
7550,November 14,2017,United Arab Emirates,Uzbekistan,1,0,Friendly,in the United Arab Emirates,10,-10,1539,1609,2,-3,72,59,1529,1619,T1
7551,November 14,2017,Trinidad and Tobago,Guyana,1,1,Friendly,in Trinidad and Tobago,-8,8,1420,1196,-2,3,101,164,1428,1188,draw
7552,November 14,2017,South Korea,Serbia,1,1,Friendly,in South Korea,-1,1,1712,1769,-2,1,39,23,1713,1768,draw
7553,November 14,2017,Norway,Slovakia,0,1,Friendly,in Slovakia,-4,4,1582,1748,0,3,67,28,1586,1744,T1
7554,November 14,2017,Russia,Spain,3,3,Friendly,in Russia,6,-6,1698,2032,1,0,43,3,1692,2038,draw
7555,November 14,2017,Romania,Netherlands,0,3,Friendly,in Romania,-14,14,1688,1896,-4,0,46,11,1702,1882,T2
7556,November 14,2017,United States,Portugal,1,1,Friendly,in Portugal,8,-8,1752,1995,5,1,26,4,1744,2003,draw
7557,November 14,2017,Argentina,Nigeria,2,4,Friendly,in Russia,-26,26,1985,1696,-2,3,6,44,2011,1670,T1
7558,November 14,2017,Hungary,Costa Rica,1,0,Friendly,in Hungary,12,-12,1612,1746,5,-4,58,30,1600,1758,T1
7559,November 14,2017,Germany,France,2,2,Friendly,in Germany,-6,6,2109,1990,0,1,2,5,2115,1984,draw
7560,November 14,2017,Gabon,Botswana,0,0,Friendly,in Gabon,-7,7,1414,1253,-1,2,103,148,1421,1246,draw
7561,November 14,2017,England,Brazil,0,0,Friendly,in England,2,-2,1933,2114,0,0,7,1,1931,2116,draw
7562,November 14,2017,China,Colombia,0,4,Friendly,in China,-7,7,1570,1927,0,0,68,9,1577,1920,T2
7563,November 14,2017,Belgium,Japan,1,0,Friendly,in Belgium,3,-3,1928,1744,0,-3,8,31,1925,1747,T1
7564,November 14,2017,Uruguay,Austria,1,2,Friendly,in Austria,-12,12,1867,1710,-1,2,13,41,1879,1698,T1
7565,November 14,2017,Central African Republic,Algeria,0,3,Friendly,in Algeria,-4,4,1297,1538,-1,0,132,73,1301,1534,T1
7566,November 14,2017,Qatar,Iceland,1,1,Friendly tournament,in Qatar,9,-9,1479,1811,5,-1,87,21,1470,1820,draw
7567,November 14,2017,Vietnam,Afghanistan,0,0,Asian Cup qualifier,in Vietnam,-12,12,1271,1149,-3,1,141,172,1283,1137,draw
7568,November 14,2017,Turkmenistan,Taiwan,2,1,Asian Cup qualifier,in Turkmenistan,3,-3,1254,924,1,0,147,198,1251,927,T1
7569,November 14,2017,Tajikistan,Yemen,0,0,Asian Cup qualifier,in Tajikistan,-6,6,1214,1224,-4,3,161,156,1220,1218,draw
7570,November 14,2017,Bahrain,Singapore,3,0,Asian Cup qualifier,in Singapore,16,-16,1396,1057,3,-3,109,185,1380,1073,T2
7571,November 14,2017,Maldives,Palestine,1,8,Asian Cup qualifier,in Palestine,-4,4,939,1400,0,0,196,108,943,1396,T1
7572,November 14,2017,Nepal,Philippines,0,0,Asian Cup qualifier,in Nepal,12,-12,900,1225,0,-1,202,155,888,1237,draw
7573,November 14,2017,Macao,Kyrgyzstan,3,4,Asian Cup qualifier,in Macao,-3,3,678,1207,0,1,222,162,681,1204,T2
7574,November 14,2017,India,Myanmar,2,2,Asian Cup qualifier,in India,-10,10,1160,1093,0,1,169,177,1170,1083,draw
7575,November 14,2017,Hong Kong,Lebanon,0,1,Asian Cup qualifier,in Hong Kong,-12,12,1190,1457,-3,4,167,93,1202,1445,T2
7576,November 14,2017,Cambodia,Jordan,0,1,Asian Cup qualifier,in Cambodia,-1,1,810,1479,0,0,208,87,811,1478,T2
7577,November 14,2017,Bhutan,Oman,2,4,Asian Cup qualifier,in Bhutan,-1,1,592,1457,0,1,231,93,593,1456,T2
7578,November 14,2017,Senegal,South Africa,2,1,World Cup qualifier,in Senegal,6,-6,1752,1540,4,0,26,71,1746,1546,T1
7579,November 14,2017,Cape Verde,Burkina Faso,0,4,World Cup qualifier,in Burkina Faso,-14,14,1428,1605,0,3,98,63,1442,1591,T1
7580,November 14,2017,Ireland,Denmark,1,5,World Cup qualifier,in Ireland,-46,46,1732,1842,-11,4,34,18,1778,1796,T2
7581,November 15,2017,Australia,Honduras,3,1,World Cup qualifier,in Australia,15,-15,1728,1610,2,-5,35,58,1713,1625,T1
7582,November 15,2017,Peru,New Zealand,2,0,World Cup qualifier,in Peru,4,-4,1881,1525,0,0,12,75,1877,1529,T1
7583,November 19,2017,Estonia,Fiji,2,0,Friendly,in Fiji,8,-8,1504,1207,2,-1,80,161,1496,1215,T2
7584,November 23,2017,Vanuatu,Estonia,0,1,Friendly,in Vanuatu,-5,5,1188,1509,-1,0,167,80,1193,1504,T2
7585,November 25,2017,Guyana,Indonesia,1,2,Friendly,in Indonesia,-6,6,1190,1233,-1,0,165,154,1196,1227,T1
7586,November 26,2017,Estonia,New Caledonia,1,1,Friendly,in New Caledonia,-2,2,1507,1335,0,0,80,122,1509,1333,draw
7587,December 1,2017,Philippines,Laos,3,1,Friendly tournament,in Taiwan,3,-3,1228,782,0,0,155,212,1225,785,T1
7588,December 2,2017,Vanuatu,New Caledonia,2,1,Pacific Mini Games,in Vanuatu,23,-23,1211,1312,5,-5,162,127,1188,1335,T1
7589,December 2,2017,Solomon Islands,Tonga,8,0,Pacific Mini Games,in Vanuatu,3,-3,1181,561,0,-2,168,234,1178,564,T1
7590,December 2,2017,Fiji,Tuvalu,8,0,Pacific Mini Games,in Vanuatu,6,-6,1213,720,0,-1,161,215,1207,726,T1
7591,December 2,2017,Grenada,Saint Kitts and Nevis,0,1,Friendly,in Saint Kitts and Nevis,-4,4,1112,1256,0,3,174,146,1116,1252,T1
7592,December 3,2017,Philippines,Taiwan,0,3,Friendly tournament,in Taiwan,-40,40,1188,964,-12,6,167,192,1228,924,T1
7593,December 3,2017,Laos,East Timor,2,1,Friendly tournament,in Taiwan,8,-8,790,607,0,-1,212,229,782,615,T1
7594,December 3,2017,Tanzania,Libya,0,0,CECAFA Cup,in Kenya,7,-7,1356,1469,0,-3,120,92,1349,1476,draw
7595,December 3,2017,Rwanda,Kenya,0,2,CECAFA Cup,in Kenya,-16,16,1276,1391,-4,6,140,110,1292,1375,T1
7596,December 4,2017,East Timor,Taiwan,1,3,Friendly tournament,in Taiwan,-3,3,604,967,0,0,229,192,607,964,T1
7597,December 4,2017,Uganda,Burundi,0,0,CECAFA Cup,in Kenya,-9,9,1481,1323,-1,2,85,124,1490,1314,draw
7598,December 5,2017,Laos,Taiwan,0,2,Friendly tournament,in Taiwan,-8,8,782,975,0,0,212,192,790,967,T1
7599,December 5,2017,Philippines,East Timor,0,1,Friendly tournament,in Taiwan,-29,29,1159,633,-2,4,169,225,1188,604,T1
7600,December 5,2017,Tuvalu,New Caledonia,2,1,Pacific Mini Games,in Vanuatu,39,-39,759,1273,1,-12,214,139,720,1312,T1
7601,December 5,2017,Rwanda,Zanzibar,1,3,CECAFA Cup,in Kenya,-29,29,1247,1318,-10,10,150,126,1276,1289,T1
7602,December 5,2017,Kenya,Libya,0,0,CECAFA Cup,in Kenya,-1,1,1390,1470,0,0,110,92,1391,1469,draw
7603,December 5,2017,Ethiopia,South Sudan,3,0,CECAFA Cup,in Kenya,16,-16,1298,1049,6,-2,131,185,1282,1065,T1
7604,December 6,2017,Tonga,Vanuatu,0,5,Pacific Mini Games,in Vanuatu,-1,1,560,1212,0,1,234,160,561,1211,T1
7605,December 6,2017,Solomon Islands,Fiji,0,0,Pacific Mini Games,in Vanuatu,2,-2,1183,1211,0,-1,167,161,1181,1213,draw
7606,December 7,2017,Zanzibar,Tanzania,2,1,CECAFA Cup,in Kenya,22,-22,1340,1334,5,-3,121,123,1318,1356,T1
7607,December 7,2017,Libya,Rwanda,0,0,CECAFA Cup,in Kenya,-11,11,1459,1258,0,5,92,145,1470,1247,draw
7608,December 7,2017,Burundi,Ethiopia,4,1,CECAFA Cup,in Kenya,32,-32,1355,1266,4,-12,120,143,1323,1298,T1
7609,December 8,2017,Uganda,South Sudan,5,1,CECAFA Cup,in Kenya,6,-6,1487,1043,1,0,84,185,1481,1049,T1
7610,December 9,2017,Vanuatu,Fiji,1,1,Pacific Mini Games,in Vanuatu,-6,6,1206,1217,-2,3,162,158,1212,1211,draw
7611,December 9,2017,Tuvalu,Solomon Islands,0,6,Pacific Mini Games,in Vanuatu,-7,7,752,1190,0,2,214,165,759,1183,T1
7612,December 9,2017,Tonga,New Caledonia,2,4,Pacific Mini Games,in Vanuatu,-1,1,559,1274,0,-1,234,139,560,1273,T1
7613,December 9,2017,Japan,North Korea,1,0,East Asian Cup,in Japan,4,-4,1748,1451,3,-1,28,97,1744,1455,T1
7614,December 9,2017,South Korea,China,2,2,East Asian Cup,in Japan,-8,8,1704,1578,-3,0,42,68,1712,1570,draw
7615,December 9,2017,Tanzania,Rwanda,1,2,CECAFA Cup,in Kenya,-24,24,1310,1282,-4,9,127,136,1334,1258,T1
7616,December 9,2017,Zanzibar,Kenya,0,0,CECAFA Cup,in Kenya,8,-8,1348,1382,0,-2,121,112,1340,1390,draw
7617,December 10,2017,Uganda,Ethiopia,1,1,CECAFA Cup,in Kenya,-11,11,1476,1277,-4,5,88,139,1487,1266,draw
7618,December 11,2017,Burundi,South Sudan,0,0,CECAFA Cup,in Kenya,-14,14,1341,1057,0,1,120,184,1355,1043,draw
7619,December 11,2017,Libya,Zanzibar,1,0,CECAFA Cup,in Kenya,14,-14,1473,1334,2,-1,90,122,1459,1348,T1
7620,December 11,2017,Kenya,Tanzania,1,0,CECAFA Cup,in Kenya,11,-11,1393,1299,2,-3,110,130,1382,1310,T1
7621,December 12,2017,Vanuatu,Tuvalu,10,0,Pacific Mini Games,in Vanuatu,4,-4,1210,748,0,0,162,214,1206,752,T1
7622,December 12,2017,New Caledonia,Solomon Islands,0,1,Pacific Mini Games,in Vanuatu,-25,25,1249,1215,-10,5,150,160,1274,1190,T1
7623,December 12,2017,Fiji,Tonga,4,0,Pacific Mini Games,in Vanuatu,2,-2,1219,557,1,0,157,234,1217,559,T1
7624,December 12,2017,South Korea,North Korea,1,0,East Asian Cup,in Japan,8,-8,1712,1443,3,0,39,97,1704,1451,T1
7625,December 12,2017,China,Japan,1,2,East Asian Cup,in Japan,-7,7,1571,1755,0,3,68,25,1578,1748,T1
7626,December 14,2017,Kenya,Burundi,1,0,CECAFA Cup,in Kenya,12,-12,1405,1329,3,-4,107,124,1393,1341,T1
7627,December 14,2017,Liechtenstein,Qatar,2,1,Friendly,in Qatar,18,-18,1168,1461,3,-6,168,92,1150,1479,T2
7628,December 15,2017,Solomon Islands,Vanuatu,2,3,Pacific Mini Games,in Vanuatu,-15,15,1200,1225,-4,7,164,155,1215,1210,T1
7629,December 15,2017,Tonga,Tuvalu,3,4,Pacific Mini Games,in Vanuatu,-10,10,547,758,0,0,234,214,557,748,T1
7630,December 15,2017,New Caledonia,Fiji,1,4,Pacific Mini Games,in Vanuatu,-38,38,1211,1257,-11,12,161,145,1249,1219,T1
7631,December 15,2017,Yemen,Oman,0,1,Friendly,in Oman,-3,3,1221,1460,-1,1,156,92,1224,1457,T1
7632,December 15,2017,Zanzibar,Uganda,2,1,CECAFA Cup,in Kenya,28,-28,1362,1448,2,-9,119,96,1334,1476,T1
7633,December 16,2017,Japan,South Korea,1,4,East Asian Cup,in Japan,-49,49,1706,1761,-17,14,42,25,1755,1712,T2
7634,December 16,2017,North Korea,China,1,1,East Asian Cup,in Japan,7,-7,1450,1564,1,-1,96,69,1443,1571,draw
7635,December 17,2017,United Arab Emirates,Iraq,1,0,Friendly,in the United Arab Emirates,8,-8,1547,1554,1,0,71,70,1539,1562,T1
7636,December 17,2017,Uganda,Burundi,2,1,CECAFA Cup,in Kenya,13,-13,1461,1316,6,-1,91,125,1448,1329,T1
7637,December 17,2017,Zanzibar,Kenya,2,2,CECAFA Cup,in Kenya,8,-8,1370,1397,1,-2,118,109,1362,1405,draw
7638,December 18,2017,Kuwait,Bahrain,0,0,Friendly,in Bahrain,1,-1,1476,1395,0,0,87,110,1475,1396,draw
7639,December 22,2017,United Arab Emirates,Oman,1,0,Gulf Cup,in Kuwait,15,-15,1562,1445,1,-4,70,97,1547,1460,T1
7640,December 22,2017,Saudi Arabia,Kuwait,2,1,Gulf Cup,in Kuwait,19,-19,1619,1457,10,-5,55,92,1600,1476,T2
7641,December 23,2017,Qatar,Yemen,4,0,Gulf Cup,in Kuwait,15,-15,1476,1206,3,-6,87,162,1461,1221,T1
7642,December 23,2017,Bahrain,Iraq,1,1,Gulf Cup,in Kuwait,9,-9,1404,1545,3,0,107,71,1395,1554,draw
7643,December 25,2017,Libya,Jordan,1,1,Friendly,in Jordan,3,-3,1476,1476,2,0,86,86,1473,1479,draw
7644,December 25,2017,Saudi Arabia,United Arab Emirates,0,0,Gulf Cup,in Kuwait,-3,3,1616,1565,-1,2,56,68,1619,1562,draw
7645,December 25,2017,Oman,Kuwait,1,0,Gulf Cup,in Kuwait,26,-26,1471,1431,6,-5,91,97,1445,1457,T2
7646,December 26,2017,Iraq,Qatar,2,1,Gulf Cup,in Kuwait,16,-16,1561,1460,0,-6,71,92,1545,1476,T1
7647,December 26,2017,Yemen,Bahrain,0,1,Gulf Cup,in Kuwait,-10,10,1196,1414,-2,4,164,103,1206,1404,T1
7648,December 28,2017,Saudi Arabia,Oman,0,2,Gulf Cup,in Kuwait,-42,42,1574,1513,-11,11,67,79,1616,1471,T1
7649,December 28,2017,United Arab Emirates,Kuwait,0,0,Gulf Cup,in Kuwait,-2,2,1563,1433,-2,0,70,97,1565,1431,draw
7650,December 29,2017,Yemen,Iraq,0,3,Gulf Cup,in Kuwait,-8,8,1188,1569,-3,3,167,68,1196,1561,T1
7651,January 2,2018,Oman,Bahrain,1,0,Gulf Cup,in Kuwait,15,-15,1528,1402,4,-5,75,107,1513,1417,T1
7652,January 2,2018,Iraq,United Arab Emirates,0,0,Gulf Cup,in Kuwait,0,0,1569,1563,0,0,68,71,1569,1563,draw
7653,January 5,2018,Oman,United Arab Emirates,0,0,Gulf Cup,in Kuwait,2,-2,1530,1561,0,0,75,71,1528,1563,draw
7654,January 7,2018,Sweden,Estonia,1,1,Friendly,in the United Arab Emirates,-7,7,1818,1514,0,2,20,79,1825,1507,draw
7655,January 11,2018,Finland,Jordan,2,1,Friendly,in the United Arab Emirates,7,-7,1602,1469,0,-3,65,90,1595,1476,T1
7656,January 14,2018,Indonesia,Iceland,1,4,Friendly,in Indonesia,-2,2,1231,1813,0,0,154,21,1233,1811,T2
7657,January 27,2018,Moldova,South Korea,0,1,Friendly,in Turkey,-2,2,1330,1763,0,1,123,24,1332,1761,T1
7658,January 28,2018,Bosnia and Herzegovina,United States,0,0,Friendly,in the United States,4,-4,1727,1748,0,-1,36,28,1723,1752,draw
7659,January 30,2018,South Korea,Jamaica,2,2,Friendly,in Turkey,-5,5,1758,1570,-1,1,25,68,1763,1565,draw
7660,January 30,2018,Azerbaijan,Moldova,0,0,Friendly,in Turkey,-2,2,1399,1332,-1,0,109,123,1401,1330,draw
7661,January 31,2018,Bosnia and Herzegovina,Mexico,0,1,Friendly,in the United States,-7,7,1720,1855,0,0,36,17,1727,1848,T1
7662,February 3,2018,South Korea,Latvia,1,0,Friendly,in Turkey,2,-2,1760,1360,0,0,25,120,1758,1362,T1
7663,February 26,2018,Saudi Arabia,Moldova,3,0,Friendly,in Saudi Arabia,4,-4,1578,1328,0,0,67,123,1574,1332,T1
7664,February 28,2018,Saudi Arabia,Iraq,1,4,Friendly,in Iraq,-13,13,1565,1582,-2,3,69,66,1578,1569,T1
7665,March 17,2018,Sierra Leone,Iran,0,4,Friendly,in Iran,-2,2,1377,1801,0,0,114,22,1379,1799,T1
7666,March 20,2018,New Caledonia,Tahiti,0,0,Friendly,in Tahiti,3,-3,1214,1218,1,-1,159,157,1211,1221,draw
7667,March 21,2018,Zambia,Zimbabwe,2,2,Friendly tournament,in Zambia,-5,5,1497,1477,-1,1,83,88,1502,1472,draw
7668,March 21,2018,Togo,Madagascar,0,0,Friendly,in France,0,0,1384,1368,0,0,111,119,1384,1368,draw
7669,March 21,2018,Laos,Cambodia,0,1,Friendly,in Laos,-12,12,770,822,0,0,212,208,782,810,T2
7670,March 21,2018,Kuwait,Jordan,0,1,Friendly,in Jordan,-6,6,1427,1475,-1,0,98,90,1433,1469,T1
7671,March 21,2018,Iraq,Qatar,2,3,Friendly tournament,in Iraq,-24,24,1558,1481,-5,6,71,86,1582,1457,T2
7672,March 21,2018,Bermuda,Antigua and Barbuda,2,3,Friendly,in Antigua and Barbuda,-7,7,1189,1212,-2,1,166,161,1196,1205,T1
7673,March 21,2018,Angola,South Africa,1,1,Friendly tournament,in Zambia,10,-10,1250,1530,2,-2,150,74,1240,1540,draw
7674,March 21,2018,Andorra,Liechtenstein,1,0,Friendly,in Spain,14,-14,1026,1154,0,-3,188,171,1012,1168,T1
7675,March 22,2018,Thailand,Gabon,0,0,King's Cup,in Thailand,-4,4,1403,1418,-1,1,106,102,1407,1414,draw
7676,March 22,2018,Slovakia,United Arab Emirates,2,1,King's Cup,in Thailand,8,-8,1756,1553,2,0,26,70,1748,1561,T1
7677,March 22,2018,Fiji,Philippines,2,3,Friendly,in the Philippines,-10,10,1247,1169,-6,1,151,168,1257,1159,T1
7678,March 22,2018,Cuba,Nicaragua,1,3,Friendly,in Nicaragua,-13,13,1296,1280,-4,4,131,138,1309,1267,T1
7679,March 22,2018,Malta,Luxembourg,0,1,Friendly,in Malta,-10,10,1206,1332,-4,1,162,123,1216,1322,T2
7680,March 22,2018,Mongolia,Malaysia,2,2,Friendly,in Malaysia,9,-9,662,1053,0,-2,224,185,653,1062,draw
7681,March 22,2018,Mauritius,Macao,1,0,Friendly,in Macao,3,-3,1071,675,1,-1,181,223,1068,678,T2
7682,March 22,2018,Kyrgyzstan,Myanmar,5,1,Asian Cup qualifier,in South Korea,26,-26,1233,1067,8,-5,154,182,1207,1093,T1
7683,March 22,2018,Faroe Islands,Latvia,1,1,Friendly,in Spain,2,-2,1283,1358,1,0,136,120,1281,1360,draw
7684,March 22,2018,Turks and Caicos,Dominican Republic,0,4,Friendly,in the Dominican Republic,-1,1,763,1251,0,1,213,149,764,1250,T1
7685,March 22,2018,Panama,Denmark,0,1,Friendly,in Denmark,-3,3,1669,1845,0,0,48,18,1672,1842,T1
7686,March 22,2018,China,Wales,0,6,Friendly tournament,in China,-23,23,1541,1786,-3,1,72,23,1564,1763,T2
7687,March 22,2018,Burkina Faso,Guinea-Bissau,2,0,Friendly,in France,4,-4,1609,1289,4,0,59,135,1605,1293,T1
7688,March 22,2018,Grenada,Belize,2,4,Friendly,in Belize,-9,9,1103,1168,0,0,174,169,1112,1159,T1
7689,March 22,2018,Bahrain,Palestine,0,0,Friendly,in Bahrain,-3,3,1399,1403,-1,2,108,106,1402,1400,draw
7690,March 22,2018,Tanzania,Algeria,1,4,Friendly,in Algeria,-4,4,1295,1542,-3,1,133,71,1299,1538,T1
7691,March 23,2018,Uruguay,Czechia,2,0,Friendly tournament,in China,13,-13,1880,1700,0,-5,13,43,1867,1713,T1
7692,March 23,2018,Turkey,Ireland,1,0,Friendly,in Turkey,8,-8,1720,1724,3,-1,36,35,1712,1732,T1
7693,March 23,2018,Tunisia,Iran,1,0,Friendly,in Tunisia,12,-12,1636,1789,1,0,52,22,1624,1801,T1
7694,March 23,2018,New Caledonia,Tahiti,3,4,Friendly,in Tahiti,-7,7,1207,1225,-2,2,161,156,1214,1218,T1
7695,March 23,2018,Singapore,Maldives,3,2,Friendly,in Singapore,4,-4,1061,935,0,-1,183,198,1057,939,T1
7696,March 23,2018,Senegal,Uzbekistan,1,1,Friendly,in Morocco,-4,4,1748,1613,-1,4,29,55,1752,1609,draw
7697,March 23,2018,Scotland,Costa Rica,0,1,Friendly,in Scotland,-12,12,1708,1758,-3,6,39,25,1720,1746,T2
7698,March 23,2018,Ukraine,Saudi Arabia,1,1,Friendly,in Spain,-5,5,1732,1570,0,1,33,67,1737,1565,draw
7699,March 23,2018,Brazil,Russia,3,0,Friendly,in Russia,5,-5,2119,1693,0,-2,1,45,2114,1698,T2
7700,March 23,2018,Egypt,Portugal,1,2,Friendly,in Switzerland,-3,3,1656,1998,1,0,49,4,1659,1995,T1
7701,March 23,2018,Poland,Nigeria,0,1,Friendly,in Poland,-16,16,1826,1712,0,6,19,38,1842,1696,T2
7702,March 23,2018,Peru,Croatia,2,0,Friendly,in the United States,14,-14,1895,1842,2,-2,10,18,1881,1856,T1
7703,March 23,2018,Australia,Norway,1,4,Friendly,in Norway,-20,20,1708,1602,-4,2,39,64,1728,1582,T1
7704,March 23,2018,Netherlands,England,0,1,Friendly,in the Netherlands,-12,12,1884,1945,-1,0,12,7,1896,1933,T2
7705,March 23,2018,Serbia,Morocco,1,2,Friendly,in Italy,-12,12,1757,1703,-2,4,26,41,1769,1691,T1
7706,March 23,2018,Mexico,Iceland,3,0,Friendly,in the United States,15,-15,1870,1798,2,0,15,21,1855,1813,T1
7707,March 23,2018,Mali,Japan,1,1,Friendly,in Belgium,5,-5,1519,1701,0,0,79,42,1514,1706,draw
7708,March 23,2018,Hungary,Kazakhstan,2,3,Friendly,in Hungary,-18,18,1594,1358,-9,1,66,120,1612,1340,T2
7709,March 23,2018,Guadeloupe,Trinidad and Tobago,0,1,Friendly,in Guadeloupe,-8,8,1259,1428,-1,4,144,97,1267,1420,T2
7710,March 23,2018,Greece,Switzerland,0,1,Friendly,in Greece,-7,7,1655,1873,-1,0,50,14,1662,1866,T2
7711,March 23,2018,Spain,Germany,1,1,Friendly,in Germany,5,-5,2037,2104,0,0,3,2,2032,2109,draw
7712,March 23,2018,Central African Republic,Gambia,1,1,Friendly,in The Gambia,2,-2,1299,1276,1,-1,129,140,1297,1278,draw
7713,March 23,2018,France,Colombia,2,3,Friendly,in France,-14,14,1976,1941,-1,1,6,8,1990,1927,T2
7714,March 23,2018,Macedonia,Finland,0,0,Friendly,in Turkey,2,-2,1522,1600,0,0,78,65,1520,1602,draw
7715,March 23,2018,Montenegro,Cyprus,0,0,Friendly,in Cyprus,-3,3,1611,1413,0,0,56,104,1614,1410,draw
7716,March 23,2018,Bolivia,Curaçao,1,1,Friendly,in Curaçao,-8,8,1699,1274,-3,3,44,141,1707,1266,draw
7717,March 23,2018,Bulgaria,Bosnia and Herzegovina,0,1,Friendly,in Bulgaria,-10,10,1611,1730,-2,2,56,34,1621,1720,T2
7718,March 23,2018,Azerbaijan,Belarus,0,1,Friendly,in Azerbaijan,-10,10,1389,1508,-2,0,110,82,1399,1498,T2
7719,March 23,2018,Austria,Slovenia,3,0,Friendly,in Austria,10,-10,1720,1629,4,-1,36,53,1710,1639,T1
7720,March 23,2018,Argentina,Italy,2,0,Friendly,in England,12,-12,1997,1894,1,-1,5,11,1985,1906,T1
7721,March 24,2018,South Africa,Zambia,2,0,Friendly tournament,in Zambia,27,-27,1557,1470,4,-6,70,89,1530,1497,T2
7722,March 24,2018,São Tomé and Príncipe,Uganda,1,3,Friendly,in Uganda,-2,2,1080,1463,0,1,178,91,1082,1461,T1
7723,March 24,2018,Sweden,Chile,1,2,Friendly,in Sweden,-12,12,1806,1872,0,1,20,15,1818,1860,T2
7724,March 24,2018,Qatar,Syria,2,2,Friendly tournament,in Iraq,5,-5,1486,1604,1,-3,85,62,1481,1609,draw
7725,March 24,2018,Northern Ireland,South Korea,2,1,Friendly,in Northern Ireland,10,-10,1684,1750,0,-4,47,28,1674,1760,T1
7726,March 24,2018,Guinea,Mauritania,0,2,Friendly,in Mauritania,-18,18,1455,1316,-3,5,94,125,1473,1298,T1
7727,March 24,2018,Kosovo,Madagascar,1,0,Friendly,in France,10,-10,1381,1358,4,0,113,119,1371,1368,T1
7728,March 24,2018,Comoros,Kenya,2,2,Friendly,in Morocco,8,-8,1047,1389,0,-1,186,110,1039,1397,draw
7729,March 24,2018,Togo,Ivory Coast,2,2,Friendly,in France,6,-6,1390,1599,2,-2,109,65,1384,1605,draw
7730,March 24,2018,Israel,Romania,1,2,Friendly,in Israel,-8,8,1527,1696,-3,1,76,45,1535,1688,T2
7731,March 24,2018,Lithuania,Georgia,0,4,Friendly,in Georgia,-10,10,1397,1494,-3,1,108,84,1407,1484,T1
7732,March 24,2018,New Zealand,Canada,0,1,Friendly,in Spain,-10,10,1515,1534,-4,3,80,74,1525,1524,T1
7733,March 24,2018,Lesotho,Botswana,0,1,Friendly,in Botswana,-8,8,1262,1261,0,4,143,144,1270,1253,T1
7734,March 24,2018,Estonia,Armenia,0,0,Friendly,in Armenia,2,-2,1516,1479,1,0,79,86,1514,1481,draw
7735,March 24,2018,Angola,Zimbabwe,2,2,Friendly tournament,in Zambia,9,-9,1259,1468,5,-2,145,90,1250,1477,draw
7736,March 25,2018,Thailand,Slovakia,2,3,King's Cup,in Thailand,-6,6,1397,1762,-2,2,107,24,1403,1756,T2
7737,March 25,2018,Cuba,Nicaragua,3,3,Friendly,in Nicaragua,2,-2,1298,1278,0,1,131,137,1296,1280,draw
7738,March 25,2018,Trinidad and Tobago,Martinique,0,0,Friendly,in Martinique,3,-3,1431,1423,-1,-1,98,101,1428,1426,draw
7739,March 25,2018,Kuwait,Cameroon,1,3,Friendly,in Kuwait,-10,10,1417,1657,-3,2,102,49,1427,1647,T2
7740,March 25,2018,Antigua and Barbuda,Jamaica,1,1,Friendly,in Jamaica,9,-9,1221,1561,2,-1,158,68,1212,1570,draw
7741,March 25,2018,Gibraltar,Latvia,1,0,Friendly,in Gibraltar,15,-15,1094,1343,2,-2,177,121,1079,1358,T1
7742,March 25,2018,Gabon,United Arab Emirates,1,0,King's Cup,in Thailand,21,-21,1439,1532,5,-3,97,74,1418,1553,T1
7743,March 25,2018,Faroe Islands,Liechtenstein,3,0,Friendly,in Spain,11,-11,1294,1143,1,-1,135,172,1283,1154,T1
7744,March 25,2018,Dominican Republic,Saint Kitts and Nevis,2,1,Friendly,in the Dominican Republic,7,-7,1258,1249,3,-3,147,150,1251,1256,T1
7745,March 25,2018,Congo,Guinea-Bissau,2,0,Friendly,in France,11,-11,1394,1278,3,-2,109,137,1383,1289,T1
7746,March 25,2018,Bermuda,Barbados,0,0,Friendly,in Barbados,1,-1,1190,1137,2,0,164,173,1189,1138,draw
7747,March 26,2018,Uruguay,Wales,1,0,Friendly tournament,in China,11,-11,1891,1775,0,0,13,23,1880,1786,T1
7748,March 26,2018,Netherlands,Portugal,3,0,Friendly,in Switzerland,23,-23,1907,1975,2,-2,10,6,1884,1998,T1
7749,March 26,2018,Malta,Finland,0,5,Friendly,in Turkey,-4,4,1202,1604,0,2,162,62,1206,1600,T1
7750,March 26,2018,Curaçao,Bolivia,1,0,Friendly,in Curaçao,17,-17,1291,1682,5,-3,136,47,1274,1699,T1
7751,March 26,2018,Czechia,China,4,1,Friendly tournament,in China,22,-22,1722,1519,7,-5,36,77,1700,1541,T2
7752,March 26,2018,Bulgaria,Kazakhstan,2,1,Friendly,in Hungary,4,-4,1615,1354,1,-1,55,120,1611,1358,T1
7753,March 26,2018,Norway,Albania,1,0,Friendly,in Albania,13,-13,1615,1596,8,-6,55,65,1602,1609,T2
7754,March 27,2018,United States,Paraguay,1,0,Friendly,in the United States,7,-7,1755,1746,3,-2,26,29,1748,1753,T1
7755,March 27,2018,Japan,Ukraine,1,2,Friendly,in Belgium,-9,9,1692,1741,-1,1,44,32,1701,1732,T1
7756,March 27,2018,Malawi,Uganda,0,0,Friendly,in Uganda,6,-6,1310,1457,-1,-1,130,92,1304,1463,draw
7757,March 27,2018,Costa Rica,Tunisia,0,1,Friendly,in France,-13,13,1745,1649,-5,1,30,51,1758,1636,T1
7758,March 27,2018,Tanzania,Democratic Republic of Congo,2,0,Friendly,in Tanzania,23,-23,1318,1583,8,-5,125,66,1295,1606,T1
7759,March 27,2018,Panama,Switzerland,0,6,Friendly,in Switzerland,-6,6,1663,1879,-1,0,49,14,1669,1873,T1
7760,March 27,2018,Spain,Argentina,6,1,Friendly,in Spain,12,-12,2049,1985,0,0,3,4,2037,1997,T1
7761,March 27,2018,Belarus,Slovenia,2,0,Friendly,in Slovenia,23,-23,1531,1606,7,-5,75,58,1508,1629,T2
7762,March 27,2018,Seychelles,Swaziland,0,0,Friendly,in the Seychelles,6,-6,945,1290,0,-4,197,136,939,1296,draw
7763,March 27,2018,Serbia,Nigeria,2,0,Friendly,in England,13,-13,1770,1699,2,-4,24,43,1757,1712,T1
7764,March 27,2018,Russia,France,1,3,Friendly,in Russia,-8,8,1685,1984,0,0,45,5,1693,1976,T2
7765,March 27,2018,Sweden,Romania,0,1,Friendly,in Romania,-10,10,1796,1706,0,2,20,42,1806,1696,T1
7766,March 27,2018,South Korea,Poland,2,3,Friendly,in Poland,-5,5,1745,1831,-2,0,30,19,1750,1826,T1
7767,March 27,2018,Iceland,Peru,1,3,Friendly,in the United States,-11,11,1787,1906,-1,0,22,11,1798,1895,T1
7768,March 27,2018,Namibia,Lesotho,2,1,Friendly,in Namibia,4,-4,1381,1258,2,-3,113,146,1377,1262,T1
7769,March 27,2018,Uzbekistan,Morocco,0,2,Friendly,in Morocco,-8,8,1605,1711,-3,1,60,41,1613,1703,T1
7770,March 27,2018,Montenegro,Turkey,2,2,Friendly,in Montenegro,0,0,1611,1720,2,-1,56,38,1611,1720,draw
7771,March 27,2018,Mauritius,Mongolia,2,0,Friendly,in Mongolia,4,-4,1075,658,0,0,181,224,1071,662,T2
7772,March 27,2018,Luxembourg,Austria,0,4,Friendly,in Luxembourg,-6,6,1326,1726,0,2,123,35,1332,1720,T2
7773,March 27,2018,Laos,Bangladesh,2,2,Friendly,in Laos,-2,2,768,808,0,0,212,209,770,806,draw
7774,March 27,2018,Burkina Faso,Kosovo,0,2,Friendly,in France,-24,24,1585,1405,-4,6,64,107,1609,1381,T1
7775,March 27,2018,Moldova,Ivory Coast,1,2,Friendly,in France,-3,3,1325,1602,0,2,124,62,1328,1599,T1
7776,March 27,2018,Iraq,Syria,1,1,Friendly tournament,in Iraq,-2,2,1556,1606,-1,4,70,58,1558,1604,draw
7777,March 27,2018,Iran,Algeria,2,1,Friendly,in Austria,4,-4,1793,1538,1,-1,21,72,1789,1542,T1
7778,March 27,2018,Hungary,Scotland,0,1,Friendly,in Hungary,-10,10,1584,1718,1,1,65,39,1594,1708,T2
7779,March 27,2018,Greece,Egypt,1,0,Friendly,in Switzerland,10,-10,1665,1646,3,-2,48,52,1655,1656,T1
7780,March 27,2018,Germany,Brazil,0,1,Friendly,in Germany,-12,12,2092,2131,0,0,2,1,2104,2119,T2
7781,March 27,2018,Estonia,Georgia,0,2,Friendly,in Georgia,-12,12,1504,1506,-4,2,83,82,1516,1494,T1
7782,March 27,2018,Italy,England,1,1,Friendly,in England,4,-4,1898,1941,0,0,12,7,1894,1945,draw
7783,March 27,2018,Chile,Denmark,0,0,Friendly,in Denmark,2,-2,1874,1843,0,-1,15,18,1872,1845,draw
7784,March 27,2018,Croatia,Mexico,1,0,Friendly,in the United States,11,-11,1853,1859,1,0,17,16,1842,1870,T1
7785,March 27,2018,Kenya,Central African Republic,2,3,Friendly,in Morocco,-13,13,1376,1312,-6,1,117,129,1389,1299,T1
7786,March 27,2018,Bosnia and Herzegovina,Senegal,0,0,Friendly,in France,1,-1,1731,1747,0,2,34,27,1730,1748,draw
7787,March 27,2018,Belgium,Saudi Arabia,4,0,Friendly,in Belgium,3,-3,1931,1567,0,0,9,67,1928,1570,T1
7788,March 27,2018,Macedonia,Azerbaijan,1,1,Friendly,in Turkey,-4,4,1518,1393,-3,0,79,111,1522,1389,draw
7789,March 27,2018,Colombia,Australia,0,0,Friendly,in England,-6,6,1935,1714,0,0,8,40,1941,1708,draw
7790,March 27,2018,Armenia,Lithuania,0,1,Friendly,in Armenia,-15,15,1464,1412,-3,1,89,106,1479,1397,T2
7791,March 27,2018,Yemen,Nepal,2,1,Asian Cup qualifier,in Qatar,6,-6,1194,894,3,0,164,202,1188,900,T1
7792,March 27,2018,Singapore,Taiwan,0,1,Asian Cup qualifier,in Taiwan,-19,19,1042,994,-3,0,186,192,1061,975,T1
7793,March 27,2018,Tajikistan,Philippines,1,2,Asian Cup qualifier,in the Philippines,-17,17,1197,1186,-3,1,163,167,1214,1169,T1
7794,March 27,2018,Palestine,Oman,0,1,Asian Cup qualifier,in Oman,-9,9,1394,1539,-4,3,109,71,1403,1530,T1
7795,March 27,2018,Hong Kong,North Korea,0,2,Asian Cup qualifier,in North Korea,-7,7,1183,1457,-4,4,168,92,1190,1450,T1
7796,March 27,2018,Myanmar,Macao,1,0,Asian Cup qualifier,in Myanmar,2,-2,1069,673,0,0,182,223,1067,675,T1
7797,March 27,2018,Bhutan,Maldives,0,7,Asian Cup qualifier,in the Maldives,-7,7,585,942,0,0,231,198,592,935,T1
7798,March 27,2018,Lebanon,Malaysia,2,1,Asian Cup qualifier,in Lebanon,2,-2,1459,1051,1,1,91,184,1457,1053,T1
7799,March 27,2018,Kyrgyzstan,India,2,1,Asian Cup qualifier,in Kyrgyzstan,11,-11,1244,1149,2,-1,152,171,1233,1160,T1
7800,March 27,2018,Jordan,Vietnam,1,1,Asian Cup qualifier,in Jordan,-14,14,1461,1285,-2,5,90,137,1475,1271,draw
7801,March 27,2018,Turkmenistan,Bahrain,0,4,Asian Cup qualifier,in Bahrain,-15,15,1239,1414,-4,2,153,104,1254,1399,T1
7802,March 27,2018,Afghanistan,Cambodia,2,1,Asian Cup qualifier,in Tajikistan,5,-5,1154,817,1,0,170,208,1149,822,T1
7803,April 1,2018,Malaysia,Bhutan,7,0,Friendly,in Malaysia,2,-2,1053,583,0,0,184,231,1051,585,T1
7804,April 1,2018,Antigua and Barbuda,Dominica,0,0,Friendly,in Antigua and Barbuda,-7,7,1214,1012,-1,0,159,189,1221,1005,draw
7805,April 17,2018,Panama,Trinidad and Tobago,1,0,Friendly,in Trinidad and Tobago,6,-6,1669,1425,1,-1,48,99,1663,1431,T2
7806,April 18,2018,Zimbabwe,Botswana,0,1,Friendly,in Zimbabwe,-17,17,1451,1278,-8,4,96,139,1468,1261,T2
7807,April 19,2018,Namibia,Swatini,0,1,Friendly,in Swatini,-10,10,1371,1300,-4,4,117,132,1381,1290,T1
7808,April 26,2018,Jamaica,Saint Kitts and Nevis,3,1,Friendly,in Saint Kitts and Nevis,7,-7,1568,1242,1,-3,67,152,1561,1249,T2
7809,April 29,2018,Jamaica,Antigua and Barbuda,2,0,Friendly,in Antigua and Barbuda,6,-6,1574,1208,0,0,67,159,1568,1214,T2
7810,April 29,2018,Saint Barthélemy,Saint Martin,3,1,Friendly,in Saint Barthélemy,18,-18,712,842,1,-2,216,206,694,860,T1
7811,May 8,2018,Iraq,Palestine,0,0,Friendly,in Iraq,-6,6,1550,1400,0,1,70,108,1556,1394,draw
7812,May 9,2018,Saudi Arabia,Algeria,2,0,Friendly,in Spain,14,-14,1581,1524,1,-4,67,76,1567,1538,T1
7813,May 11,2018,Kuwait,Palestine,2,0,Friendly,in Kuwait,10,-10,1427,1390,3,-3,99,111,1417,1400,T1
7814,May 15,2018,Saudi Arabia,Greece,2,0,Friendly,in Spain,19,-19,1600,1646,4,-2,63,51,1581,1665,T1
7815,May 19,2018,Iran,Uzbekistan,1,0,Friendly,in Iran,3,-3,1796,1602,1,-1,20,61,1793,1605,T1
7816,May 20,2018,Jordan,Cyprus,3,0,Friendly,in Jordan,10,-10,1471,1403,2,-2,87,107,1461,1413,T1
7817,May 25,2018,Kuwait,Egypt,1,1,Friendly,in Kuwait,3,-3,1430,1643,1,-1,98,52,1427,1646,draw
7818,May 25,2018,Swatini,Kenya,1,0,Friendly,in Kenya,15,-15,1315,1361,4,-2,128,118,1300,1376,T2
7819,May 26,2018,China,Myanmar,1,0,Friendly,in China,1,-1,1520,1068,0,0,77,182,1519,1069,T1
7820,May 26,2018,Saint Barthélemy,Sint Maarten,5,3,Friendly,in Saint Barthélemy,18,-18,730,868,1,0,215,203,712,886,T1
7821,May 27,2018,Central African Republic,Niger,3,3,Friendly tournament,in Niger,4,-4,1316,1291,4,-1,126,135,1312,1295,draw
7822,May 27,2018,Burkina Faso,Cameroon,1,0,Friendly,in France,12,-12,1597,1645,1,-2,64,51,1585,1657,T1
7823,May 27,2018,Mozambique,Madagascar,1,2,COSAFA Cup,in South Africa,-18,18,1297,1376,-5,3,133,116,1315,1358,T1
7824,May 27,2018,Comoros,Seychelles,1,1,COSAFA Cup,in South Africa,-6,6,1041,951,-1,4,186,193,1047,945,draw
7825,May 28,2018,Malawi,Mauritius,0,1,COSAFA Cup,in South Africa,-32,32,1278,1107,-9,7,139,174,1310,1075,T1
7826,May 28,2018,Angola,Botswana,1,2,COSAFA Cup,in South Africa,-19,19,1240,1297,-8,7,152,132,1259,1278,T1
7827,May 28,2018,United States,Bolivia,3,0,Friendly,in the United States,9,-9,1764,1673,1,0,25,47,1755,1682,T1
7828,May 28,2018,Iran,Turkey,1,2,Friendly,in Turkey,-9,9,1787,1729,-1,4,21,34,1796,1720,T1
7829,May 28,2018,Honduras,South Korea,0,2,Friendly,in South Korea,-6,6,1604,1751,-2,3,59,27,1610,1745,T1
7830,May 28,2018,Portugal,Tunisia,2,2,Friendly,in Portugal,-8,8,1967,1657,0,0,6,49,1975,1649,draw
7831,May 28,2018,Nigeria,Democratic Republic of Congo,1,1,Friendly,in Nigeria,-6,6,1693,1589,0,1,43,66,1699,1583,draw
7832,May 28,2018,Mexico,Wales,0,0,Friendly,in the United States,-2,2,1857,1777,0,0,16,23,1859,1775,draw
7833,May 28,2018,Kenya,Equatorial Guinea,1,0,Friendly,in Kenya,6,-6,1367,1327,0,0,119,122,1361,1333,T1
7834,May 28,2018,Saudi Arabia,Italy,1,2,Friendly,in Switzerland,-3,3,1597,1901,0,0,63,12,1600,1898,T1
7835,May 28,2018,France,Ireland,2,0,Friendly,in France,3,-3,1987,1721,1,-2,4,38,1984,1724,T1
7836,May 28,2018,Bosnia and Herzegovina,Montenegro,0,0,Friendly,in Bosnia and Herzegovina,-6,6,1725,1617,-2,3,36,53,1731,1611,draw
7837,May 29,2018,Madagascar,Seychelles,1,1,COSAFA Cup,in South Africa,-17,17,1359,968,-3,0,119,193,1376,951,draw
7838,May 29,2018,Mozambique,Comoros,3,0,COSAFA Cup,in South Africa,13,-13,1310,1028,2,-1,130,187,1297,1041,T1
7839,May 29,2018,Scotland,Peru,0,2,Friendly,in Peru,-5,5,1713,1911,-1,1,40,10,1718,1906,T1
7840,May 29,2018,Northern Ireland,Panama,0,0,Friendly,in Panama,2,-2,1686,1667,1,0,45,48,1684,1669,draw
7841,May 29,2018,Kosovo,Albania,3,0,Friendly,in Switzerland,26,-26,1431,1570,8,-3,98,68,1405,1596,T1
7842,May 29,2018,Azerbaijan,Kyrgyzstan,3,0,Friendly,in Azerbaijan,7,-7,1400,1237,2,-4,108,154,1393,1244,T1
7843,May 29,2018,Armenia,Malta,1,1,Friendly,in Austria,-6,6,1458,1208,-1,2,90,159,1464,1202,draw
7844,May 29,2018,Haiti,Argentina,0,4,Friendly,in Argentina,-1,1,1494,1986,0,0,84,5,1495,1985,T1
7845,May 30,2018,Malawi,Botswana,1,1,COSAFA Cup,in South Africa,1,-1,1279,1296,0,0,139,133,1278,1297,draw
7846,May 30,2018,Mauritius,Angola,0,1,COSAFA Cup,in South Africa,-13,13,1094,1253,-3,3,177,148,1107,1240,T1
7847,May 30,2018,Ghana,Japan,2,0,Friendly,in Japan,22,-22,1639,1670,0,-3,53,47,1617,1692,T2
7848,May 30,2018,Estonia,Lithuania,2,0,Baltic Cup,in Estonia,11,-11,1515,1401,3,-1,80,107,1504,1412,T1
7849,May 30,2018,Uganda,Central African Republic,0,1,Friendly tournament,in Niger,-21,21,1436,1337,-6,4,97,122,1457,1316,T1
7850,May 30,2018,Russia,Austria,0,1,Friendly,in Austria,-6,6,1679,1732,1,1,45,34,1685,1726,T1
7851,May 31,2018,Seychelles,Mozambique,1,2,COSAFA Cup,in South Africa,-5,5,963,1315,0,1,193,129,968,1310,T1
7852,May 31,2018,Madagascar,Comoros,1,0,COSAFA Cup,in South Africa,5,-5,1364,1023,0,-1,119,188,1359,1028,T1
7853,May 31,2018,Slovakia,Netherlands,1,1,Friendly,in Slovakia,1,-1,1763,1906,0,0,26,11,1762,1907,draw
7854,May 31,2018,Romania,Chile,3,2,Friendly,in Austria,14,-14,1720,1860,3,0,39,15,1706,1874,T1
7855,May 31,2018,Morocco,Ukraine,0,0,Friendly,in Switzerland,1,-1,1712,1740,-1,1,42,31,1711,1741,draw
7856,May 31,2018,Senegal,Luxembourg,0,0,Friendly,in Luxembourg,-7,7,1740,1333,-3,1,31,123,1747,1326,draw
7857,June 1,2018,Botswana,Mauritius,6,0,COSAFA Cup,in South Africa,20,-20,1316,1074,6,-4,127,181,1296,1094,T1
7858,June 1,2018,Angola,Malawi,0,0,COSAFA Cup,in South Africa,1,-1,1254,1278,0,0,148,139,1253,1279,draw
7859,June 1,2018,Tunisia,Turkey,2,2,Friendly,in Switzerland,2,-2,1659,1727,0,-2,49,37,1657,1729,draw
7860,June 1,2018,South Korea,Bosnia and Herzegovina,1,3,Friendly,in South Korea,-20,20,1731,1745,-9,7,36,29,1751,1725,T2
7861,June 1,2018,Taiwan,India,0,5,Friendly tournament,in India,-11,11,983,1160,0,1,192,170,994,1149,T1
7862,June 1,2018,Georgia,Malta,1,0,Friendly,in Austria,3,-3,1509,1205,1,-2,82,161,1506,1208,T1
7863,June 1,2018,France,Italy,3,1,Friendly,in France,8,-8,1995,1893,0,0,4,12,1987,1901,T1
7864,June 1,2018,Egypt,Colombia,0,0,Friendly,in Italy,7,-7,1650,1928,2,-1,50,9,1643,1935,draw
7865,June 1,2018,Australia,Czechia,4,0,Friendly,in Austria,19,-19,1733,1703,6,-5,34,42,1714,1722,T1
7866,June 1,2018,Cape Verde,Algeria,3,2,Friendly,in Algeria,15,-15,1443,1509,4,-6,96,82,1428,1524,T2
7867,June 2,2018,Namibia,Zambia,0,0,COSAFA Cup,in South Africa,6,-6,1377,1464,1,-1,115,89,1371,1470,draw
7868,June 2,2018,Lesotho,Swatini,1,0,COSAFA Cup,in South Africa,23,-23,1281,1292,6,-5,139,135,1258,1315,T1
7869,June 2,2018,Thailand,China,0,2,Friendly,in Thailand,-14,14,1383,1534,-4,4,113,72,1397,1520,T2
7870,June 2,2018,Denmark,Sweden,0,0,Friendly,in Sweden,2,-2,1845,1794,0,0,18,20,1843,1796,draw
7871,June 2,2018,Tibet,Northern Cyprus,1,3,World Football Cup,in England,-1,1,630,1456,0,0,227,93,631,1455,T1
7872,June 2,2018,Niger,Uganda,2,1,Friendly tournament,in Niger,17,-17,1308,1419,4,-5,131,103,1291,1436,T1
7873,June 2,2018,Montenegro,Slovenia,0,2,Friendly,in Montenegro,-20,20,1597,1626,-7,2,61,55,1617,1606,T2
7874,June 2,2018,Scotland,Mexico,0,1,Friendly,in Mexico,-4,4,1709,1861,-1,1,41,15,1713,1857,T1
7875,June 2,2018,Estonia,Latvia,0,1,Baltic Cup,in Latvia,-18,18,1497,1361,-3,1,82,120,1515,1343,T1
7876,June 2,2018,Kenya,New Zealand,2,1,Friendly tournament,in India,21,-21,1388,1494,6,-4,112,83,1367,1515,T1
7877,June 2,2018,United States,Ireland,1,2,Friendly,in Ireland,-8,8,1756,1729,-1,1,26,37,1764,1721,T1
7878,June 2,2018,Norway,Iceland,3,2,Friendly,in Iceland,17,-17,1632,1770,1,-2,54,23,1615,1787,T2
7879,June 2,2018,Nigeria,England,1,2,Friendly,in England,-2,2,1691,1943,0,0,43,7,1693,1941,T1
7880,June 2,2018,Honduras,El Salvador,0,1,Friendly,in the United States,-14,14,1590,1471,-5,4,64,87,1604,1457,T1
7881,June 2,2018,Portugal,Belgium,0,0,Friendly,in Belgium,2,-2,1969,1929,0,0,6,8,1967,1931,draw
7882,June 2,2018,Austria,Germany,2,1,Friendly,in Austria,16,-16,1748,2076,8,0,27,2,1732,2092,T1
7883,June 3,2018,South Africa,Madagascar,0,0,COSAFA Cup,in South Africa,-14,14,1543,1378,-1,4,70,115,1557,1364,draw
7884,June 3,2018,Zimbabwe,Botswana,1,1,COSAFA Cup,in South Africa,-7,7,1444,1323,0,1,95,126,1451,1316,draw
7885,June 3,2018,Albania,Ukraine,1,4,Friendly,in France,-10,10,1560,1750,0,4,68,28,1570,1740,T1
7886,June 3,2018,Spain,Switzerland,1,1,Friendly,in Spain,-7,7,2042,1886,0,0,3,14,2049,1879,draw
7887,June 3,2018,Peru,Saudi Arabia,3,0,Friendly,in Switzerland,5,-5,1916,1592,0,-2,10,63,1911,1597,T1
7888,June 3,2018,Northern Ireland,Costa Rica,0,3,Friendly,in Costa Rica,-10,10,1676,1755,-1,3,45,27,1686,1745,T1
7889,June 3,2018,Croatia,Brazil,0,2,Friendly,in England,-5,5,1848,2136,0,0,17,1,1853,2131,T1
7890,June 3,2018,Barbados,Belize,0,0,Friendly,in Barbados,-2,2,1135,1170,0,0,173,169,1137,1168,draw
7891,June 3,2018,Andorra,Cape Verde,0,0,Friendly,in Portugal,8,-8,1034,1435,1,-1,186,97,1026,1443,draw
7892,June 4,2018,Slovakia,Morocco,1,2,Friendly,in Switzerland,-11,11,1752,1723,-2,1,27,39,1763,1712,T1
7893,June 4,2018,Italy,Netherlands,1,1,Friendly,in Italy,-2,2,1891,1908,0,0,12,11,1893,1906,draw
7894,June 4,2018,Kenya,India,0,3,Friendly tournament,in India,-36,36,1352,1196,-9,6,121,164,1388,1160,T1
7895,June 4,2018,Serbia,Chile,0,1,Friendly,in Austria,-7,7,1763,1867,-1,1,24,15,1770,1860,T1
7896,June 4,2018,Moldova,Armenia,0,0,Friendly,in Austria,4,-4,1329,1454,1,-3,124,94,1325,1458,draw
7897,June 5,2018,Namibia,South Africa,1,4,COSAFA Cup,in South Africa,-12,12,1365,1555,-4,1,119,69,1377,1543,T1
7898,June 5,2018,Swatini,Botswana,0,2,COSAFA Cup,in South Africa,-27,27,1265,1350,-9,4,144,122,1292,1323,T1
7899,June 5,2018,Russia,Turkey,1,1,Friendly,in Russia,-1,1,1678,1728,0,0,44,38,1679,1727,draw
7900,June 5,2018,Romania,Finland,2,0,Friendly,in Romania,7,-7,1727,1597,1,-2,39,60,1720,1604,T1
7901,June 5,2018,Taiwan,New Zealand,0,1,Friendly tournament,in India,-2,2,981,1496,0,0,192,83,983,1494,T1
7902,June 5,2018,Martinique,French Guiana,3,0,Friendly tournament,in Martinique,16,-16,1439,1361,6,-5,96,120,1423,1377,T1
7903,June 5,2018,Georgia,Luxembourg,0,1,Friendly,in Luxembourg,-12,12,1497,1345,-1,0,81,123,1509,1333,T1
7904,June 5,2018,Latvia,Lithuania,1,1,Baltic Cup,in Lithuania,6,-6,1367,1395,1,0,118,107,1361,1401,draw
7905,June 5,2018,Kazakhstan,Azerbaijan,3,0,Friendly,in Kazakhstan,15,-15,1369,1385,3,-3,117,111,1354,1400,T1
7906,June 6,2018,Zambia,Madagascar,1,0,COSAFA Cup,in South Africa,15,-15,1479,1363,3,-5,86,119,1464,1378,T1
7907,June 6,2018,Zimbabwe,Lesotho,0,0,COSAFA Cup,in South Africa,-9,9,1435,1290,-2,2,97,136,1444,1281,draw
7908,June 6,2018,Panama,Norway,0,1,Friendly,in Norway,-8,8,1659,1640,0,1,48,53,1667,1632,T1
7909,June 6,2018,Nigeria,Czechia,0,1,Friendly,in Austria,-10,10,1681,1713,0,1,43,41,1691,1703,T1
7910,June 6,2018,Belgium,Egypt,3,0,Friendly,in Belgium,4,-4,1933,1646,0,0,8,50,1929,1650,T1
7911,June 6,2018,Belarus,Hungary,1,1,Friendly,in Belarus,-1,1,1530,1585,0,0,75,66,1531,1584,draw
7912,June 7,2018,Uruguay,Uzbekistan,3,0,Friendly,in Uruguay,3,-3,1894,1599,0,-1,12,59,1891,1602,T1
7913,June 7,2018,Algeria,Portugal,0,3,Friendly,in Portugal,-1,1,1508,1970,0,0,80,6,1509,1969,T1
7914,June 7,2018,India,New Zealand,1,2,Friendly tournament,in India,-7,7,1189,1503,-3,2,167,81,1196,1496,T2
7915,June 7,2018,Iceland,Ghana,2,2,Friendly,in Iceland,-6,6,1764,1645,0,2,23,52,1770,1639,draw
7916,June 7,2018,Guadeloupe,French Guiana,0,2,Friendly tournament,in Martinique,-16,16,1243,1377,-5,6,150,114,1259,1361,T1
7917,June 7,2018,England,Costa Rica,2,0,Friendly,in England,5,-5,1948,1750,0,-1,7,27,1943,1755,T1
7918,June 7,2018,Bolivia,South Korea,0,0,Friendly,in Austria,2,-2,1675,1729,0,0,46,36,1673,1731,draw
7919,June 8,2018,South Africa,Botswana,3,0,COSAFA Cup,in South Africa,10,-10,1565,1340,1,0,68,122,1555,1350,T1
7920,June 8,2018,Lesotho,Madagascar,1,0,COSAFA Cup,in South Africa,24,-24,1314,1339,5,-3,131,123,1290,1363,T1
7921,June 8,2018,Switzerland,Japan,2,0,Friendly,in Switzerland,4,-4,1890,1666,0,0,14,47,1886,1670,T1
7922,June 8,2018,Chile,Poland,2,2,Friendly,in Poland,2,-2,1869,1829,0,0,15,19,1867,1831,draw
7923,June 8,2018,Taiwan,Kenya,0,4,Friendly tournament,in India,-6,6,975,1358,0,1,192,120,981,1352,T1
7924,June 8,2018,Lithuania,Iran,0,1,Friendly,in Russia,-2,2,1393,1789,-1,0,108,21,1395,1787,T1
7925,June 8,2018,Saudi Arabia,Germany,1,2,Friendly,in Germany,-1,1,1591,2077,0,0,63,2,1592,2076,T1
7926,June 8,2018,Croatia,Senegal,2,1,Friendly,in Croatia,5,-5,1853,1735,0,-1,17,34,1848,1740,T1
7927,June 9,2018,Zambia,Zimbabwe,2,4,COSAFA Cup,in South Africa,-34,34,1445,1469,-9,8,95,89,1479,1435,T1
7928,June 9,2018,Tuvalu,Chagos Islands,6,1,Friendly,in England,22,-22,780,776,3,-2,211,212,758,798,T1
7929,June 9,2018,Peru,Sweden,0,0,Friendly,in Sweden,-1,1,1915,1795,0,0,10,20,1916,1794,draw
7930,June 9,2018,Tunisia,Spain,0,1,Friendly,in Russia,-2,2,1657,2044,-1,0,49,3,1659,2042,T1
7931,June 9,2018,Serbia,Bolivia,5,1,Friendly,in Austria,14,-14,1777,1661,2,-1,22,47,1763,1675,T1
7932,June 9,2018,Azerbaijan,Latvia,3,1,Friendly,in Latvia,18,-18,1403,1349,5,-2,106,120,1385,1367,T2
7933,June 9,2018,Australia,Hungary,2,1,Friendly,in Hungary,9,-9,1742,1576,2,0,33,66,1733,1585,T2
7934,June 9,2018,United States,France,1,1,Friendly,in France,8,-8,1764,1987,1,0,24,4,1756,1995,draw
7935,June 9,2018,Finland,Belarus,2,0,Friendly,in Finland,8,-8,1605,1522,2,-1,58,76,1597,1530,T1
7936,June 9,2018,Morocco,Estonia,3,1,Friendly,in Estonia,10,-10,1733,1487,4,-2,36,84,1723,1497,T2
7937,June 9,2018,Mexico,Denmark,0,2,Friendly,in Denmark,-11,11,1850,1856,-2,2,18,16,1861,1845,T1
7938,June 10,2018,India,Kenya,2,0,Friendly tournament,in India,27,-27,1216,1331,8,-5,159,124,1189,1358,T1
7939,June 10,2018,Brazil,Austria,3,0,Friendly,in Austria,6,-6,2142,1742,0,-3,1,32,2136,1748,T2
7940,June 11,2018,Senegal,South Korea,2,0,Friendly,in Austria,15,-15,1750,1714,8,-3,27,40,1735,1729,T1
7941,June 11,2018,Costa Rica,Belgium,1,4,Friendly,in Belgium,-6,6,1744,1939,-5,0,32,8,1750,1933,T1
7942,June 12,2018,Lithuania,Poland,0,4,Friendly,in Poland,-2,2,1391,1831,0,0,109,19,1393,1829,T1
7943,June 12,2018,Japan,Paraguay,4,2,Friendly,in Austria,18,-18,1684,1728,3,-7,43,37,1666,1746,T1
7944,June 14,2018,Russia,Saudi Arabia,5,0,World Cup,in Russia,31,-31,1709,1560,3,-5,42,68,1678,1591,T1
7945,June 15,2018,Egypt,Uruguay,0,1,World Cup,in Russia,-12,12,1634,1906,-4,0,54,12,1646,1894,T1
7946,June 15,2018,Spain,Portugal,3,3,World Cup,in Russia,-6,6,2038,1976,0,0,3,6,2044,1970,draw
7947,June 15,2018,Iran,Morocco,1,0,World Cup,in Russia,25,-25,1814,1708,1,-8,20,43,1789,1733,T1
7948,June 16,2018,Australia,France,1,2,World Cup,in Russia,-12,12,1730,1999,-2,0,34,4,1742,1987,T1
7949,June 16,2018,Peru,Denmark,0,1,World Cup,in Russia,-35,35,1880,1891,-5,4,15,12,1915,1856,T1
7950,June 16,2018,Croatia,Nigeria,2,0,World Cup,in Russia,24,-24,1877,1657,1,-3,16,48,1853,1681,T1
7951,June 16,2018,Iceland,Argentina,1,1,World Cup,in Russia,17,-17,1781,1969,2,-1,22,6,1764,1986,draw
